Season,TeamID,Wins,Losses,PtsFor,PtsAgainst,WinRatio,PtsDiff,PtsForRatio
1985,1102,5,19,355,1159,0.20833333333333334,-804,0.23447820343461032
1985,1103,9,14,632,772,0.391304347826087,-140,0.45014245014245013
1985,1104,21,9,1514,541,0.7,973,0.7367396593673966
1985,1106,10,14,751,968,0.4166666666666667,-217,0.43688190808609656
1985,1108,19,6,1631,444,0.76,1187,0.7860240963855422
1985,1109,1,23,54,1238,0.041666666666666664,-1184,0.04179566563467492
1985,1110,7,18,550,1186,0.28,-636,0.31682027649769584
1985,1111,10,14,708,903,0.4166666666666667,-195,0.43947858472998136
1985,1112,18,9,1265,531,0.6666666666666666,734,0.7043429844097996
1985,1113,11,16,824,1004,0.4074074074074074,-180,0.45076586433260396
1985,1114,17,13,1306,851,0.5666666666666667,455,0.6054705609643023
1985,1116,21,12,1448,708,0.6363636363636364,740,0.6716141001855288
1985,1117,11,14,727,874,0.44,-147,0.4540911930043723
1985,1119,15,13,1039,817,0.5357142857142857,222,0.5598060344827587
1985,1120,18,11,1308,732,0.6206896551724138,576,0.6411764705882353
1985,1121,7,19,548,1115,0.2692307692307692,-567,0.3295249549007817
1985,1122,6,17,387,1081,0.2608695652173913,-694,0.26362397820163486
1985,1123,13,16,1093,1132,0.4482758620689655,-39,0.4912359550561798
1985,1124,7,17,637,1246,0.2916666666666667,-609,0.3382899628252788
1985,1126,6,19,419,1259,0.24,-840,0.2497020262216925
1985,1129,12,13,845,833,0.48,12,0.5035756853396901
1985,1130,16,10,1300,647,0.6153846153846154,653,0.6676938880328711
1985,1131,14,14,997,919,0.5,78,0.5203549060542797
1985,1132,11,15,791,961,0.4230769230769231,-170,0.4514840182648402
1985,1133,16,12,1163,806,0.5714285714285714,357,0.590655154900965
1985,1134,11,13,842,809,0.4583333333333333,33,0.5099939430648092
1985,1135,8,18,576,1160,0.3076923076923077,-584,0.3317972350230415
1985,1137,15,10,1099,676,0.6,423,0.6191549295774648
1985,1139,16,8,1117,519,0.6666666666666666,598,0.6827628361858191
1985,1140,15,14,1119,1056,0.5172413793103449,63,0.5144827586206897
1985,1141,6,18,445,1218,0.25,-773,0.2675886951292844
1985,1143,10,15,616,882,0.4,-266,0.411214953271028
1985,1144,2,21,126,1249,0.08695652173913043,-1123,0.09163636363636364
1985,1145,18,9,1384,547,0.6666666666666666,837,0.7167270844122217
1985,1147,4,20,319,1210,0.16666666666666666,-891,0.20863309352517986
1985,1149,10,13,728,794,0.43478260869565216,-66,0.4783180026281209
1985,1150,4,21,299,1385,0.16,-1086,0.17755344418052257
1985,1151,19,7,1382,429,0.7307692307692307,953,0.763114301490889
1985,1152,14,11,1046,766,0.56,280,0.5772626931567328
1985,1153,14,13,918,805,0.5185185185185185,113,0.5327916424840394
1985,1154,15,10,1162,723,0.6,439,0.6164456233421751
1985,1155,15,12,1214,797,0.5555555555555556,417,0.6036797613127797
1985,1156,18,8,1446,622,0.6923076923076923,824,0.6992263056092843
1985,1159,1,21,60,966,0.045454545454545456,-906,0.05847953216374269
1985,1160,8,17,636,1136,0.32,-500,0.35891647855530473
1985,1161,16,12,1186,729,0.5714285714285714,457,0.6193211488250653
1985,1162,12,13,769,719,0.48,50,0.5168010752688172
1985,1163,13,15,1024,967,0.4642857142857143,57,0.5143144148669011
1985,1165,12,12,767,706,0.5,61,0.5207060420909708
1985,1166,13,12,1015,787,0.52,228,0.5632630410654828
1985,1168,16,13,1162,840,0.5517241379310345,322,0.5804195804195804
1985,1171,5,20,342,1219,0.2,-877,0.2190903267136451
1985,1172,8,19,610,1187,0.2962962962962963,-577,0.3394546466332777
1985,1173,19,9,1344,603,0.6785714285714286,741,0.6902927580893683
1985,1174,11,14,776,934,0.44,-158,0.45380116959064326
1985,1175,10,15,781,938,0.4,-157,0.45433391506689935
1985,1177,18,9,1340,595,0.6666666666666666,745,0.6925064599483204
1985,1178,15,12,1133,857,0.5555555555555556,276,0.5693467336683417
1985,1179,9,15,653,912,0.375,-259,0.4172523961661342
1985,1180,10,18,755,1120,0.35714285714285715,-365,0.4026666666666667
1985,1181,22,7,1793,505,0.7586206896551724,1288,0.7802436901653612
1985,1182,9,18,599,1116,0.3333333333333333,-517,0.3492711370262391
1985,1183,17,10,1297,715,0.6296296296296297,582,0.6446322067594433
1985,1184,12,13,829,776,0.48,53,0.5165109034267913
1985,1185,14,13,1102,928,0.5185185185185185,174,0.5428571428571428
1985,1186,8,15,616,869,0.34782608695652173,-253,0.4148148148148148
1985,1187,4,21,281,1313,0.16,-1032,0.17628607277289837
1985,1190,8,18,610,1111,0.3076923076923077,-501,0.35444509006391633
1985,1191,11,16,820,1090,0.4074074074074074,-270,0.4293193717277487
1985,1192,19,9,1364,537,0.6785714285714286,827,0.7175170962651236
1985,1193,10,17,774,1227,0.37037037037037035,-453,0.3868065967016492
1985,1196,17,11,1339,688,0.6071428571428571,651,0.6605821410952146
1985,1197,8,16,712,1045,0.3333333333333333,-333,0.4052361980648833
1985,1199,10,16,839,1099,0.38461538461538464,-260,0.4329205366357069
1985,1200,19,11,1365,653,0.6333333333333333,712,0.6764122893954411
1985,1201,20,8,1211,454,0.7142857142857143,757,0.7273273273273273
1985,1202,5,21,332,1277,0.19230769230769232,-945,0.20633934120571784
1985,1203,13,14,1062,824,0.48148148148148145,238,0.5630965005302226
1985,1204,20,5,1397,323,0.8,1074,0.8122093023255814
1985,1206,17,11,1389,808,0.6071428571428571,581,0.6322257624032772
1985,1207,25,2,1917,128,0.9259259259259259,1789,0.9374083129584352
1985,1208,19,8,1541,554,0.7037037037037037,987,0.7355608591885442
1985,1209,1,25,73,1645,0.038461538461538464,-1572,0.042491268917345754
1985,1210,24,7,1754,444,0.7741935483870968,1310,0.7979981801637852
1985,1211,12,13,734,690,0.48,44,0.5154494382022472
1985,1212,6,18,422,1050,0.25,-628,0.2866847826086957
1985,1215,8,17,545,1087,0.32,-542,0.33394607843137253
1985,1216,6,20,416,1287,0.23076923076923078,-871,0.24427480916030533
1985,1217,12,9,847,513,0.5714285714285714,334,0.6227941176470588
1985,1218,10,18,732,1213,0.35714285714285715,-481,0.3763496143958869
1985,1220,11,15,857,1028,0.4230769230769231,-171,0.4546419098143236
1985,1221,8,19,611,1248,0.2962962962962963,-637,0.32867132867132864
1985,1222,13,13,1072,936,0.5,136,0.5338645418326693
1985,1223,17,8,1235,473,0.68,762,0.7230679156908665
1985,1224,16,10,1126,603,0.6153846153846154,523,0.6512434933487565
1985,1225,5,21,394,1451,0.19230769230769232,-1057,0.21355013550135502
1985,1226,10,18,871,1208,0.35714285714285715,-337,0.41895141895141896
1985,1227,13,13,940,884,0.5,56,0.5153508771929824
1985,1228,23,8,1684,431,0.7419354838709677,1253,0.7962174940898346
1985,1229,20,7,1484,449,0.7407407407407407,1035,0.7677185721676151
1985,1231,15,13,1186,779,0.5357142857142857,407,0.6035623409669211
1985,1232,11,15,912,1074,0.4230769230769231,-162,0.459214501510574
1985,1233,25,4,1868,291,0.8620689655172413,1577,0.8652153774895786
1985,1234,20,10,1525,567,0.6666666666666666,958,0.7289674952198852
1985,1235,17,12,1271,815,0.5862068965517241,456,0.6093000958772771
1985,1238,8,16,614,986,0.3333333333333333,-372,0.38375
1985,1239,13,14,983,872,0.48148148148148145,111,0.5299191374663073
1985,1241,12,14,814,800,0.46153846153846156,14,0.5043370508054523
1985,1242,23,7,1809,472,0.7666666666666667,1337,0.7930732135028496
1985,1243,12,14,902,877,0.46153846153846156,25,0.507026419336706
1985,1245,16,12,1240,783,0.5714285714285714,457,0.6129510627780524
1985,1246,16,12,1082,755,0.5714285714285714,327,0.5890038105606968
1985,1247,15,13,1169,891,0.5357142857142857,278,0.5674757281553398
1985,1248,13,13,830,808,0.5,22,0.5067155067155067
1985,1249,19,11,1546,694,0.6333333333333333,852,0.6901785714285714
1985,1250,11,18,822,1085,0.3793103448275862,-263,0.43104352385946515
1985,1253,2,23,144,1457,0.08,-1313,0.08994378513429106
1985,1254,11,13,848,928,0.4583333333333333,-80,0.4774774774774775
1985,1256,26,2,2034,136,0.9285714285714286,1898,0.9373271889400921
1985,1257,14,14,1022,901,0.5,121,0.531461258450338
1985,1258,7,16,503,1029,0.30434782608695654,-526,0.3283289817232376
1985,1259,14,13,1033,851,0.5185185185185185,182,0.5483014861995754
1985,1260,25,5,2170,405,0.8333333333333334,1765,0.8427184466019417
1985,1261,19,9,1510,564,0.6785714285714286,946,0.7280617164898746
1985,1263,10,17,692,1158,0.37037037037037035,-466,0.37405405405405406
1985,1264,8,20,613,1190,0.2857142857142857,-577,0.33998890737659454
1985,1265,16,12,1039,714,0.5714285714285714,325,0.5926982316029663
1985,1266,18,10,1257,584,0.6428571428571429,673,0.6827810972297664
1985,1267,19,12,1484,811,0.6129032258064516,673,0.6466230936819172
1985,1268,22,11,1678,694,0.6666666666666666,984,0.7074198988195616
1985,1269,12,15,864,890,0.4444444444444444,-26,0.4925883694412771
1985,1270,14,10,1105,692,0.5833333333333334,413,0.6149137451307735
1985,1271,2,23,148,1334,0.08,-1186,0.09986504723346828
1985,1272,26,3,1984,195,0.896551724137931,1789,0.9105094079853143
1985,1273,20,8,1671,542,0.7142857142857143,1129,0.755083596927248
1985,1275,18,10,1350,690,0.6428571428571429,660,0.6617647058823529
1985,1276,25,3,2036,197,0.8928571428571429,1839,0.9117778772951187
1985,1277,19,9,1389,638,0.6785714285714286,751,0.6852491366551554
1985,1278,13,15,907,947,0.4642857142857143,-40,0.4892125134843581
1985,1279,8,17,496,959,0.32,-463,0.340893470790378
1985,1280,11,15,793,876,0.4230769230769231,-83,0.4751348112642301
1985,1281,16,13,1165,892,0.5517241379310345,273,0.5663587749149247
1985,1283,13,13,1029,777,0.5,252,0.5697674418604651
1985,1284,9,15,658,1024,0.375,-366,0.3912009512485137
1985,1285,18,7,1282,458,0.72,824,0.7367816091954023
1985,1286,9,16,721,1015,0.36,-294,0.4153225806451613
1985,1287,3,20,233,1179,0.13043478260869565,-946,0.165014164305949
1985,1288,2,24,160,1639,0.07692307692307693,-1479,0.08893829905503058
1985,1290,11,11,895,844,0.5,51,0.5146635997699828
1985,1292,13,13,877,871,0.5,6,0.5017162471395881
1985,1293,16,8,1131,456,0.6666666666666666,675,0.7126654064272212
1985,1296,9,16,711,973,0.36,-262,0.42220902612826605
1985,1298,23,5,1842,348,0.8214285714285714,1494,0.8410958904109589
1985,1299,16,8,1202,501,0.6666666666666666,701,0.7058132706987669
1985,1301,20,9,1569,577,0.6896551724137931,992,0.7311276794035415
1985,1304,12,13,910,844,0.48,66,0.5188141391106044
1985,1305,19,9,1562,623,0.6785714285714286,939,0.7148741418764302
1985,1306,7,22,410,1291,0.2413793103448276,-881,0.24103468547912993
1985,1307,17,12,1226,794,0.5862068965517241,432,0.6069306930693069
1985,1308,7,20,533,1334,0.25925925925925924,-801,0.28548473486877346
1985,1309,10,19,748,1162,0.3448275862068966,-414,0.39162303664921466
1985,1310,15,12,1130,751,0.5555555555555556,379,0.6007442849548112
1985,1311,15,8,1124,534,0.6521739130434783,590,0.6779252110977081
1985,1314,23,8,1778,539,0.7419354838709677,1239,0.7673716012084593
1985,1317,4,22,283,1357,0.15384615384615385,-1074,0.17256097560975608
1985,1318,20,8,1580,579,0.7142857142857143,1001,0.7318202871699862
1985,1319,14,12,1008,767,0.5384615384615384,241,0.5678873239436619
1985,1320,8,16,550,980,0.3333333333333333,-430,0.35947712418300654
1985,1321,4,22,259,1174,0.15384615384615385,-915,0.1807397069085834
1985,1322,1,23,72,1524,0.041666666666666664,-1452,0.045112781954887216
1985,1323,20,8,1414,542,0.7142857142857143,872,0.7229038854805726
1985,1325,20,7,1349,475,0.7407407407407407,874,0.7395833333333334
1985,1326,19,9,1514,664,0.6785714285714286,850,0.6951331496786042
1985,1327,3,19,213,1229,0.13636363636363635,-1016,0.14771151178918168
1985,1328,25,5,2320,375,0.8333333333333334,1945,0.8608534322820037
1985,1329,11,15,830,1096,0.4230769230769231,-266,0.43094496365524404
1985,1330,18,11,1364,762,0.6206896551724138,602,0.6415804327375353
1985,1331,14,15,1081,1076,0.4827586206896552,5,0.5011590171534539
1985,1332,13,16,861,929,0.4482758620689655,-68,0.4810055865921788
1985,1333,21,8,1342,453,0.7241379310344828,889,0.7476323119777158
1985,1334,7,19,518,1128,0.2692307692307692,-610,0.31470230862697446
1985,1335,13,13,954,823,0.5,131,0.5368598761958356
1985,1336,5,19,351,1175,0.20833333333333334,-824,0.23001310615989515
1985,1337,20,7,1508,535,0.7407407407407407,973,0.7381302006852668
1985,1338,15,11,1129,697,0.5769230769230769,432,0.6182913472070098
1985,1339,10,14,645,829,0.4166666666666667,-184,0.43758480325644505
1985,1341,5,21,404,1367,0.19230769230769232,-963,0.22811970638057594
1985,1343,9,15,577,685,0.375,-108,0.4572107765451664
1985,1344,10,19,724,1166,0.3448275862068966,-442,0.38306878306878306
1985,1345,17,8,1191,537,0.68,654,0.6892361111111112
1985,1347,14,12,1039,692,0.5384615384615384,347,0.6002310803004044
1985,1348,6,20,421,1208,0.23076923076923078,-787,0.25844076120319215
1985,1349,8,16,515,1003,0.3333333333333333,-488,0.33926218708827405
1985,1350,19,10,1416,589,0.6551724137931034,827,0.7062344139650872
1985,1351,11,15,804,988,0.4230769230769231,-184,0.4486607142857143
1985,1352,7,19,499,1202,0.2692307692307692,-703,0.2933568489124045
1985,1353,16,14,1254,936,0.5333333333333333,318,0.5726027397260274
1985,1354,9,15,685,952,0.375,-267,0.4184483811850947
1985,1356,12,14,943,949,0.46153846153846156,-6,0.49841437632135305
1985,1359,15,11,1215,744,0.5769230769230769,471,0.6202143950995406
1985,1360,12,11,774,621,0.5217391304347826,153,0.5548387096774193
1985,1361,23,7,1911,512,0.7666666666666667,1399,0.7886917044985555
1985,1363,14,13,1087,796,0.5185185185185185,291,0.5772703133297928
1985,1364,10,16,760,1000,0.38461538461538464,-240,0.4318181818181818
1985,1365,16,8,1207,523,0.6666666666666666,684,0.6976878612716763
1985,1368,15,8,1143,521,0.6521739130434783,622,0.6868990384615384
1985,1371,7,18,544,1249,0.28,-705,0.3034021193530396
1985,1373,20,7,1465,447,0.7407407407407407,1018,0.766213389121339
1985,1374,22,8,1733,546,0.7333333333333333,1187,0.7604212373848179
1985,1375,14,13,1152,902,0.5185185185185185,250,0.560856864654333
1985,1376,13,13,1037,871,0.5,166,0.5435010482180294
1985,1378,17,11,1227,685,0.6071428571428571,542,0.6417364016736402
1985,1379,5,20,365,1320,0.2,-955,0.2166172106824926
1985,1380,18,10,1640,734,0.6428571428571429,906,0.6908171861836563
1985,1382,12,15,872,866,0.4444444444444444,6,0.5017261219792866
1985,1383,3,21,174,1184,0.125,-1010,0.12812960235640647
1985,1384,8,18,662,1314,0.3076923076923077,-652,0.3350202429149798
1985,1385,27,3,2076,208,0.9,1868,0.9089316987740805
1985,1386,18,11,1234,645,0.6206896551724138,589,0.6567323044172432
1985,1387,10,15,701,876,0.4,-175,0.4445149017121116
1985,1388,11,12,811,690,0.4782608695652174,121,0.5403064623584277
1985,1389,14,14,979,804,0.5,175,0.5490745933819405
1985,1390,7,17,493,1067,0.2916666666666667,-574,0.316025641025641
1985,1391,10,14,709,864,0.4166666666666667,-155,0.4507310870947235
1985,1393,21,8,1576,564,0.7241379310344828,1012,0.7364485981308411
1985,1395,13,12,907,763,0.52,144,0.5431137724550898
1985,1396,24,5,1599,304,0.8275862068965517,1295,0.8402522333158171
1985,1397,18,14,1463,930,0.5625,533,0.6113664855829503
1985,1398,7,19,477,1204,0.2692307692307692,-727,0.28375966686496135
1985,1399,15,8,1043,562,0.6521739130434783,481,0.6498442367601246
1985,1400,12,13,836,774,0.48,62,0.5192546583850932
1985,1401,17,9,1220,558,0.6538461538461539,662,0.6861642294713161
1985,1402,6,19,393,1191,0.24,-798,0.2481060606060606
1985,1403,22,7,1596,408,0.7586206896551724,1188,0.7964071856287425
1985,1405,15,12,1102,771,0.5555555555555556,331,0.5883609183128671
1985,1406,5,20,368,1259,0.2,-891,0.22618315918869084
1985,1408,14,13,955,721,0.5185185185185185,234,0.5698090692124105
1985,1409,22,7,1807,520,0.7586206896551724,1287,0.776536312849162
1985,1410,8,16,555,1030,0.3333333333333333,-475,0.3501577287066246
1985,1411,10,16,731,1110,0.38461538461538464,-379,0.39706681151548073
1985,1412,22,8,1487,494,0.7333333333333333,993,0.7506309944472489
1985,1414,11,17,914,1243,0.39285714285714285,-329,0.4237366713027353
1985,1416,9,17,577,1006,0.34615384615384615,-429,0.3644977890082123
1985,1417,15,12,1086,768,0.5555555555555556,318,0.5857605177993528
1985,1418,14,13,1125,886,0.5185185185185185,239,0.5594231725509696
1985,1419,15,12,1119,846,0.5555555555555556,273,0.5694656488549619
1985,1423,9,16,607,1024,0.36,-417,0.37216431637032493
1985,1424,27,3,2293,187,0.9,2106,0.9245967741935484
1985,1425,19,9,1386,529,0.6785714285714286,857,0.7237597911227154
1985,1426,9,16,692,1114,0.36,-422,0.3831672203765227
1985,1427,16,9,1256,625,0.64,631,0.6677299308878256
1985,1428,14,16,1013,1119,0.4666666666666667,-106,0.475140712945591
1985,1429,16,11,1402,863,0.5925925925925926,539,0.6189845474613687
1985,1431,20,9,1535,599,0.6896551724137931,936,0.7193064667291471
1985,1432,11,12,756,704,0.4782608695652174,52,0.5178082191780822
1985,1433,25,5,1860,313,0.8333333333333334,1547,0.8559595029912563
1985,1434,5,19,356,1159,0.20833333333333334,-803,0.23498349834983498
1985,1435,11,17,850,1123,0.39285714285714285,-273,0.4308160162189559
1985,1436,6,19,371,1091,0.24,-720,0.25376196990424077
1985,1437,19,10,1416,657,0.6551724137931034,759,0.683068017366136
1985,1438,13,15,827,863,0.4642857142857143,-36,0.4893491124260355
1985,1439,19,8,1612,579,0.7037037037037037,1033,0.7357371063441351
1985,1440,12,14,709,831,0.46153846153846156,-122,0.4603896103896104
1985,1441,11,14,834,968,0.44,-134,0.462819089900111
1985,1442,11,13,833,799,0.4583333333333333,34,0.5104166666666666
1985,1443,13,14,1007,882,0.48148148148148145,125,0.5330862890418211
1985,1444,9,16,744,1118,0.36,-374,0.3995703544575725
1985,1446,7,17,506,1168,0.2916666666666667,-662,0.3022700119474313
1985,1447,8,16,673,1087,0.3333333333333333,-414,0.38238636363636364
1985,1448,14,13,1080,863,0.5185185185185185,217,0.5558414822439527
1985,1449,22,9,1509,510,0.7096774193548387,999,0.7473997028231798
1985,1450,11,15,769,887,0.4230769230769231,-118,0.4643719806763285
1985,1451,17,9,1444,592,0.6538461538461539,852,0.7092337917485265
1985,1452,18,8,1287,497,0.6923076923076923,790,0.7214125560538116
1985,1453,2,22,129,1309,0.08333333333333333,-1180,0.08970792767732963
1985,1455,17,12,1431,805,0.5862068965517241,626,0.6399821109123435
1985,1456,15,12,1054,723,0.5555555555555556,331,0.5931344963421497
1985,1458,12,14,879,904,0.46153846153846156,-25,0.4929893438025799
1985,1461,12,14,823,830,0.46153846153846156,-7,0.49788263762855417
1985,1462,15,13,1153,856,0.5357142857142857,297,0.5739173718267795
1985,1463,11,12,746,804,0.4782608695652174,-58,0.48129032258064514
1985,1464,16,11,1166,694,0.5925925925925926,472,0.6268817204301075
1986,1102,6,19,399,1065,0.24,-666,0.2725409836065574
1986,1103,18,7,1335,490,0.72,845,0.7315068493150685
1986,1104,22,8,1728,529,0.7333333333333333,1199,0.765618077093487
1986,1106,8,16,686,1206,0.3333333333333333,-520,0.36257928118393234
1986,1108,14,11,1132,761,0.56,371,0.5979926043317485
1986,1109,5,19,456,1713,0.20833333333333334,-1257,0.21023513139695713
1986,1110,7,18,537,1148,0.28,-611,0.31869436201780416
1986,1111,13,12,853,708,0.52,145,0.5464445868033312
1986,1112,21,8,1476,496,0.7241379310344828,980,0.7484787018255578
1986,1113,11,14,798,915,0.44,-117,0.4658493870402802
1986,1114,21,9,1738,660,0.7,1078,0.7247706422018348
1986,1116,12,16,876,1079,0.42857142857142855,-203,0.44808184143222507
1986,1117,14,11,1022,690,0.56,332,0.5969626168224299
1986,1119,8,18,534,1028,0.3076923076923077,-494,0.3418693982074264
1986,1120,17,10,1309,625,0.6296296296296297,684,0.6768355739400207
1986,1121,8,17,586,1049,0.32,-463,0.3584097859327217
1986,1122,12,14,870,926,0.46153846153846156,-56,0.4844097995545657
1986,1123,20,9,1539,587,0.6896551724137931,952,0.7238946378174976
1986,1124,7,16,420,870,0.30434782608695654,-450,0.32558139534883723
1986,1126,7,22,526,1474,0.2413793103448276,-948,0.263
1986,1129,10,15,716,894,0.4,-178,0.44472049689440996
1986,1130,12,15,923,1033,0.4444444444444444,-110,0.471881390593047
1986,1131,20,9,1430,592,0.6896551724137931,838,0.7072205736894164
1986,1132,7,19,523,1244,0.2692307692307692,-721,0.29598189020939447
1986,1133,30,2,2145,134,0.9375,2011,0.9412022817025011
1986,1134,6,21,414,1427,0.2222222222222222,-1013,0.22487778381314502
1986,1135,14,10,1088,671,0.5833333333333334,417,0.6185332575326891
1986,1137,13,12,950,750,0.52,200,0.5588235294117647
1986,1139,5,19,363,1192,0.20833333333333334,-829,0.23344051446945338
1986,1140,16,13,1241,859,0.5517241379310345,382,0.590952380952381
1986,1141,8,17,568,1058,0.32,-490,0.34932349323493234
1986,1143,17,9,1215,528,0.6538461538461539,687,0.6970740103270223
1986,1144,5,18,362,972,0.21739130434782608,-610,0.27136431784107945
1986,1145,19,8,1273,484,0.7037037037037037,789,0.7245304496300512
1986,1147,10,17,749,1188,0.37037037037037035,-439,0.3866804336602994
1986,1149,15,9,1144,619,0.625,525,0.6488939307997731
1986,1150,5,20,375,1327,0.2,-952,0.22032902467685075
1986,1151,18,9,1333,555,0.6666666666666666,778,0.7060381355932204
1986,1152,18,6,1440,381,0.75,1059,0.7907742998352554
1986,1153,10,16,764,1009,0.38461538461538464,-245,0.43090806542583193
1986,1154,8,16,623,1095,0.3333333333333333,-472,0.3626309662398137
1986,1155,17,14,1367,946,0.5483870967741935,421,0.5910073497622136
1986,1156,24,3,2144,241,0.8888888888888888,1903,0.8989517819706498
1986,1160,6,20,487,1373,0.23076923076923078,-886,0.2618279569892473
1986,1161,8,18,585,1044,0.3076923076923077,-459,0.35911602209944754
1986,1162,10,14,662,897,0.4166666666666667,-235,0.4246311738293778
1986,1163,11,16,822,995,0.4074074074074074,-173,0.4523940561364887
1986,1164,8,17,545,1014,0.32,-469,0.3495830660679923
1986,1165,13,12,822,729,0.52,93,0.5299806576402321
1986,1166,9,16,589,868,0.36,-279,0.40425531914893614
1986,1168,14,15,1051,928,0.4827586206896552,123,0.5310763011622032
1986,1171,8,14,542,808,0.36363636363636365,-266,0.4014814814814815
1986,1172,16,10,1150,623,0.6153846153846154,527,0.6486181613085167
1986,1173,17,12,1281,786,0.5862068965517241,495,0.6197387518142236
1986,1174,8,15,560,1124,0.34782608695652173,-564,0.332541567695962
1986,1175,10,17,743,1041,0.37037037037037035,-298,0.4164798206278027
1986,1177,16,12,1203,737,0.5714285714285714,466,0.6201030927835052
1986,1178,11,15,802,901,0.4230769230769231,-99,0.4709336465061656
1986,1179,16,10,1077,604,0.6153846153846154,473,0.6406900654372397
1986,1180,16,10,1317,633,0.6153846153846154,684,0.6753846153846154
1986,1181,32,2,2560,172,0.9411764705882353,2388,0.9370424597364568
1986,1182,14,14,1040,930,0.5,110,0.5279187817258884
1986,1183,15,13,1118,931,0.5357142857142857,187,0.5456320156173743
1986,1184,6,18,444,1101,0.25,-657,0.287378640776699
1986,1185,8,18,633,1180,0.3076923076923077,-547,0.3491450634307777
1986,1186,16,8,1172,492,0.6666666666666666,680,0.7043269230769231
1986,1187,8,16,494,950,0.3333333333333333,-456,0.34210526315789475
1986,1190,11,16,861,1159,0.4074074074074074,-298,0.4262376237623762
1986,1191,7,19,483,1141,0.2692307692307692,-658,0.2974137931034483
1986,1192,18,8,1406,505,0.6923076923076923,901,0.7357404500261643
1986,1193,23,6,1529,373,0.7931034482758621,1156,0.8038906414300736
1986,1196,16,12,1196,788,0.5714285714285714,408,0.6028225806451613
1986,1197,9,16,779,1095,0.36,-316,0.41568836712913554
1986,1199,9,17,728,1251,0.34615384615384615,-523,0.3678625568468924
1986,1200,13,16,873,916,0.4482758620689655,-43,0.4879821129122415
1986,1201,13,15,805,783,0.4642857142857143,22,0.506926952141058
1986,1202,6,17,452,1009,0.2608695652173913,-557,0.30937713894592744
1986,1203,9,16,692,1033,0.36,-341,0.4011594202898551
1986,1204,11,13,758,778,0.4583333333333333,-20,0.4934895833333333
1986,1206,18,11,1303,743,0.6206896551724138,560,0.636852394916911
1986,1207,20,7,1591,496,0.7407407407407407,1095,0.7623382846190704
1986,1208,16,12,1330,846,0.5714285714285714,484,0.6112132352941176
1986,1209,7,17,535,1264,0.2916666666666667,-729,0.2973874374652585
1986,1210,24,6,1855,381,0.8,1474,0.8296064400715564
1986,1211,12,12,865,728,0.5,137,0.5430006277463905
1986,1212,10,12,670,685,0.45454545454545453,-15,0.4944649446494465
1986,1215,12,12,887,812,0.5,75,0.5220718069452619
1986,1216,12,16,788,960,0.42857142857142855,-172,0.45080091533180777
1986,1217,4,18,256,1028,0.18181818181818182,-772,0.19937694704049844
1986,1218,4,23,327,1465,0.14814814814814814,-1138,0.18247767857142858
1986,1220,17,11,1241,781,0.6071428571428571,460,0.6137487636003957
1986,1221,12,17,943,1125,0.41379310344827586,-182,0.4559961315280464
1986,1222,11,14,914,985,0.44,-71,0.4813059505002633
1986,1223,10,14,760,811,0.4166666666666667,-51,0.48376830044557606
1986,1224,17,9,1197,580,0.6538461538461539,617,0.6736072031513787
1986,1225,8,18,601,1135,0.3076923076923077,-534,0.34619815668202764
1986,1226,12,12,821,699,0.5,122,0.5401315789473684
1986,1227,11,16,883,1149,0.4074074074074074,-266,0.4345472440944882
1986,1228,20,9,1584,539,0.6896551724137931,1045,0.7461139896373057
1986,1229,14,14,902,811,0.5,91,0.5265615878575598
1986,1231,21,7,1681,453,0.75,1228,0.7877225866916588
1986,1232,9,17,546,985,0.34615384615384615,-439,0.356629653821032
1986,1233,14,15,931,982,0.4827586206896552,-51,0.4866701515943544
1986,1234,16,11,1262,718,0.5925925925925926,544,0.6373737373737374
1986,1235,17,10,1354,671,0.6296296296296297,683,0.668641975308642
1986,1238,13,15,1006,963,0.4642857142857143,43,0.5109192483494159
1986,1239,19,9,1326,554,0.6785714285714286,772,0.7053191489361702
1986,1241,5,23,357,1364,0.17857142857142858,-1007,0.2074375363160953
1986,1242,30,3,2436,240,0.9090909090909091,2196,0.9103139013452914
1986,1243,11,14,798,935,0.44,-137,0.4604731679169071
1986,1245,10,16,719,1004,0.38461538461538464,-285,0.4172954149738828
1986,1246,28,3,2133,175,0.9032258064516129,1958,0.9241767764298093
1986,1247,14,14,1144,859,0.5,285,0.5711432850723914
1986,1248,12,15,901,889,0.4444444444444444,12,0.5033519553072626
1986,1249,16,11,1246,657,0.5925925925925926,589,0.6547556489753021
1986,1250,10,15,788,1022,0.4,-234,0.4353591160220994
1986,1253,6,22,393,1442,0.21428571428571427,-1049,0.21416893732970027
1986,1254,6,19,477,1301,0.24,-824,0.26827896512935884
1986,1256,16,12,1203,715,0.5714285714285714,488,0.627215849843587
1986,1257,26,7,2073,507,0.7878787878787878,1566,0.8034883720930233
1986,1258,15,10,1213,717,0.6,496,0.6284974093264248
1986,1259,15,11,1206,737,0.5769230769230769,469,0.6206896551724138
1986,1260,13,16,1039,1164,0.4482758620689655,-125,0.4716295960054471
1986,1261,18,11,1419,738,0.6206896551724138,681,0.6578581363004172
1986,1263,7,19,455,1175,0.2692307692307692,-720,0.2791411042944785
1986,1264,2,26,173,1588,0.07142857142857142,-1415,0.0982396365701306
1986,1265,17,11,1180,694,0.6071428571428571,486,0.6296691568836713
1986,1266,18,10,1365,675,0.6428571428571429,690,0.6691176470588235
1986,1267,17,10,1307,722,0.6296296296296297,585,0.6441596845736817
1986,1268,16,13,1197,826,0.5517241379310345,371,0.5916955017301038
1986,1269,8,19,558,1104,0.2962962962962963,-546,0.33574007220216606
1986,1270,17,10,1269,641,0.6296296296296297,628,0.6643979057591624
1986,1271,5,23,369,1340,0.17857142857142858,-971,0.21591574019894674
1986,1272,26,5,2166,366,0.8387096774193549,1800,0.8554502369668247
1986,1273,13,14,925,860,0.48148148148148145,65,0.5182072829131653
1986,1274,14,14,1088,918,0.5,170,0.5423728813559322
1986,1275,22,6,1701,429,0.7857142857142857,1272,0.7985915492957747
1986,1276,25,4,1958,280,0.8620689655172413,1678,0.8748882931188561
1986,1277,21,7,1799,539,0.75,1260,0.7694610778443114
1986,1278,11,15,835,936,0.4230769230769231,-101,0.47148503670242803
1986,1279,9,17,616,1077,0.34615384615384615,-461,0.3638511518015357
1986,1280,7,21,448,1273,0.25,-825,0.26031377106333525
1986,1281,19,12,1474,819,0.6129032258064516,655,0.6428259921500218
1986,1283,18,7,1244,449,0.72,795,0.7347903130537508
1986,1284,7,19,493,1282,0.2692307692307692,-789,0.27774647887323944
1986,1285,18,10,1394,665,0.6428571428571429,729,0.6770276833414279
1986,1286,12,15,992,1118,0.4444444444444444,-126,0.47014218009478675
1986,1287,4,19,311,1184,0.17391304347826086,-873,0.2080267558528428
1986,1288,7,20,502,1112,0.25925925925925924,-610,0.3110285006195787
1986,1290,18,8,1370,518,0.6923076923076923,852,0.725635593220339
1986,1292,18,9,1522,630,0.6666666666666666,892,0.7072490706319703
1986,1293,13,12,949,770,0.52,179,0.5520651541593949
1986,1296,12,12,873,833,0.5,40,0.5117233294255569
1986,1298,25,4,1957,250,0.8620689655172413,1707,0.8867240598096964
1986,1299,18,7,1169,415,0.72,754,0.7380050505050505
1986,1301,16,12,1204,762,0.5714285714285714,442,0.612410986775178
1986,1304,17,10,1249,647,0.6296296296296297,602,0.6587552742616034
1986,1305,11,15,838,1009,0.4230769230769231,-171,0.45370871683811587
1986,1306,11,17,714,1023,0.39285714285714285,-309,0.4110535405872193
1986,1307,17,13,1255,770,0.5666666666666667,485,0.6197530864197531
1986,1308,14,12,1001,760,0.5384615384615384,241,0.5684270300965361
1986,1309,14,12,1115,790,0.5384615384615384,325,0.5853018372703412
1986,1310,14,14,1071,910,0.5,161,0.5406360424028268
1986,1311,8,12,577,774,0.4,-197,0.42709104367135453
1986,1314,26,5,2346,359,0.8387096774193549,1987,0.8672828096118299
1986,1317,8,18,570,1140,0.3076923076923077,-570,0.3333333333333333
1986,1318,25,4,1902,252,0.8620689655172413,1650,0.883008356545961
1986,1319,15,9,1106,596,0.625,510,0.6498237367802585
1986,1320,5,18,383,1215,0.21739130434782608,-832,0.23967459324155194
1986,1321,4,20,283,1164,0.16666666666666666,-881,0.19557705597788527
1986,1322,10,13,717,751,0.43478260869565216,-34,0.4884196185286104
1986,1323,22,5,1782,343,0.8148148148148148,1439,0.8385882352941176
1986,1325,20,7,1559,502,0.7407407407407407,1057,0.7564289180009705
1986,1326,14,14,1130,985,0.5,145,0.5342789598108747
1986,1328,22,8,1969,632,0.7333333333333333,1337,0.7570165321030373
1986,1329,12,12,926,776,0.5,150,0.5440658049353702
1986,1330,20,7,1346,444,0.7407407407407407,902,0.7519553072625699
1986,1331,9,18,720,1120,0.3333333333333333,-400,0.391304347826087
1986,1332,11,16,849,991,0.4074074074074074,-142,0.46141304347826084
1986,1333,12,15,780,864,0.4444444444444444,-84,0.4744525547445255
1986,1334,15,13,1011,857,0.5357142857142857,154,0.541220556745182
1986,1335,15,11,1145,626,0.5769230769230769,519,0.6465273856578204
1986,1336,10,17,674,948,0.37037037037037035,-274,0.4155363748458693
1986,1337,24,4,1953,238,0.8571428571428571,1715,0.8913738019169329
1986,1338,13,13,1095,877,0.5,218,0.5552738336713996
1986,1339,10,15,632,838,0.4,-206,0.42993197278911566
1986,1341,4,24,329,1481,0.14285714285714285,-1152,0.18176795580110497
1986,1343,12,13,736,640,0.48,96,0.5348837209302325
1986,1344,14,13,1219,919,0.5185185185185185,300,0.5701590271281571
1986,1345,20,9,1593,610,0.6896551724137931,983,0.7231048570131638
1986,1347,9,15,632,904,0.375,-272,0.4114583333333333
1986,1348,7,19,485,1215,0.2692307692307692,-730,0.2852941176470588
1986,1349,5,19,301,1064,0.20833333333333334,-763,0.2205128205128205
1986,1350,23,6,1544,382,0.7931034482758621,1162,0.8016614745586709
1986,1351,6,18,445,1192,0.25,-747,0.27183872938301773
1986,1352,9,17,626,1066,0.34615384615384615,-440,0.36997635933806144
1986,1353,8,21,585,1239,0.27586206896551724,-654,0.3207236842105263
1986,1354,9,18,656,1164,0.3333333333333333,-508,0.36043956043956044
1986,1356,6,20,411,1178,0.23076923076923078,-767,0.25865324103209564
1986,1359,12,13,884,821,0.48,63,0.518475073313783
1986,1360,17,9,1275,537,0.6538461538461539,738,0.7036423841059603
1986,1361,10,19,790,1377,0.3448275862068966,-587,0.36455929856945085
1986,1362,3,21,242,1243,0.125,-1001,0.16296296296296298
1986,1363,14,12,968,726,0.5384615384615384,242,0.5714285714285714
1986,1364,10,15,740,1033,0.4,-293,0.4173716864072194
1986,1365,9,15,636,902,0.375,-266,0.4135240572171652
1986,1368,9,15,706,980,0.375,-274,0.41874258600237246
1986,1371,10,18,790,1171,0.35714285714285715,-381,0.4028556858745538
1986,1373,20,7,1448,460,0.7407407407407407,988,0.7589098532494759
1986,1374,18,10,1261,569,0.6428571428571429,692,0.6890710382513662
1986,1375,13,16,882,949,0.4482758620689655,-67,0.4817039868924085
1986,1376,12,16,985,1086,0.42857142857142855,-101,0.4756156446161275
1986,1378,13,14,896,717,0.48148148148148145,179,0.555486670799752
1986,1379,13,11,1068,753,0.5416666666666666,315,0.586490939044481
1986,1380,19,8,1445,566,0.7037037037037037,879,0.7185479860765788
1986,1382,12,13,906,863,0.48,43,0.5121537591859808
1986,1383,6,18,400,1104,0.25,-704,0.26595744680851063
1986,1384,9,18,703,1286,0.3333333333333333,-583,0.3534439416792358
1986,1385,30,4,2345,283,0.8823529411764706,2062,0.8923135464231354
1986,1386,25,5,1804,287,0.8333333333333334,1517,0.8627450980392157
1986,1387,15,12,1055,729,0.5555555555555556,326,0.5913677130044843
1986,1388,6,17,482,1077,0.2608695652173913,-595,0.30917254650416937
1986,1389,15,12,976,572,0.5555555555555556,404,0.6304909560723514
1986,1390,11,16,857,1070,0.4074074074074074,-213,0.44473274519979245
1986,1391,9,18,704,1117,0.3333333333333333,-413,0.38660076880834704
1986,1393,24,5,2026,372,0.8275862068965517,1654,0.8448707256046706
1986,1395,18,8,1249,501,0.6923076923076923,748,0.7137142857142857
1986,1396,24,5,1678,314,0.8275862068965517,1364,0.8423694779116466
1986,1397,12,16,908,972,0.42857142857142855,-64,0.4829787234042553
1986,1398,12,14,800,840,0.46153846153846156,-40,0.4878048780487805
1986,1399,11,15,768,974,0.4230769230769231,-206,0.44087256027554533
1986,1400,16,11,1043,675,0.5925925925925926,368,0.6071012805587893
1986,1401,19,11,1367,679,0.6333333333333333,688,0.6681329423264907
1986,1402,6,18,441,1153,0.25,-712,0.2766624843161857
1986,1403,16,13,1040,759,0.5517241379310345,281,0.5780989438576987
1986,1405,11,16,879,1007,0.4074074074074074,-128,0.4660657476139979
1986,1406,8,20,635,1194,0.2857142857142857,-559,0.3471842536905413
1986,1409,21,8,1418,465,0.7241379310344828,953,0.7530536378120021
1986,1410,16,8,1159,518,0.6666666666666666,641,0.6911150864639237
1986,1411,8,17,589,1104,0.32,-515,0.3479031305375074
1986,1412,22,10,1554,620,0.6875,934,0.7148114075436982
1986,1414,16,12,1398,826,0.5714285714285714,572,0.6285971223021583
1986,1416,4,20,292,1281,0.16666666666666666,-989,0.1856325492689129
1986,1417,15,13,1240,860,0.5357142857142857,380,0.5904761904761905
1986,1418,14,13,1028,840,0.5185185185185185,188,0.550321199143469
1986,1419,19,9,1392,617,0.6785714285714286,775,0.692882030861125
1986,1423,13,13,979,846,0.5,133,0.5364383561643835
1986,1424,31,4,2467,313,0.8857142857142857,2154,0.887410071942446
1986,1425,11,17,831,1113,0.39285714285714285,-282,0.42746913580246915
1986,1426,9,16,679,1112,0.36,-433,0.3791178112786153
1986,1427,4,23,325,1418,0.14814814814814814,-1093,0.18646012621916236
1986,1428,19,9,1416,601,0.6785714285714286,815,0.7020327218641547
1986,1429,12,16,971,1180,0.42857142857142855,-209,0.4514179451417945
1986,1431,27,5,1845,317,0.84375,1528,0.8533765032377428
1986,1432,9,14,665,814,0.391304347826087,-149,0.4496281271129141
1986,1433,12,16,853,958,0.42857142857142855,-105,0.4710104914411927
1986,1434,5,19,378,1094,0.20833333333333334,-716,0.25679347826086957
1986,1435,13,15,945,1003,0.4642857142857143,-58,0.4851129363449692
1986,1436,6,19,362,1209,0.24,-847,0.23042647994907703
1986,1437,21,13,1554,824,0.6176470588235294,730,0.6534903280067283
1986,1438,19,10,1412,631,0.6551724137931034,781,0.6911404796867352
1986,1439,21,8,1702,606,0.7241379310344828,1096,0.7374350086655113
1986,1440,7,17,519,1170,0.2916666666666667,-651,0.30728241563055064
1986,1441,12,14,869,947,0.46153846153846156,-78,0.4785242290748899
1986,1442,9,15,617,956,0.375,-339,0.3922441195168468
1986,1443,20,7,1408,427,0.7407407407407407,981,0.7673024523160763
1986,1444,9,16,658,1079,0.36,-421,0.3788140472078296
1986,1446,7,17,450,875,0.2916666666666667,-425,0.33962264150943394
1986,1447,13,12,1136,823,0.52,313,0.5798876978050026
1986,1448,7,21,478,1199,0.25,-721,0.28503279666070364
1986,1449,19,11,1423,742,0.6333333333333333,681,0.6572748267898383
1986,1450,15,16,1058,1067,0.4838709677419355,-9,0.4978823529411765
1986,1451,15,11,1218,743,0.5769230769230769,475,0.6211116777154513
1986,1452,21,10,1551,617,0.6774193548387096,934,0.7154059040590406
1986,1453,3,22,176,1183,0.12,-1007,0.12950699043414277
1986,1455,13,14,881,835,0.48148148148148145,46,0.5134032634032634
1986,1456,7,20,460,1020,0.25925925925925924,-560,0.3108108108108108
1986,1458,9,16,647,1073,0.36,-426,0.37616279069767444
1986,1461,18,11,1290,699,0.6206896551724138,591,0.6485671191553545
1986,1462,23,4,1847,269,0.8518518518518519,1578,0.8728733459357277
1986,1463,12,11,849,797,0.5217391304347826,52,0.5157958687727825
1986,1464,10,16,691,1045,0.38461538461538464,-354,0.3980414746543779
1987,1102,8,15,661,972,0.34782608695652173,-311,0.40477648499693814
1987,1103,18,8,1442,530,0.6923076923076923,912,0.731237322515213
1987,1104,26,4,2083,287,0.8666666666666667,1796,0.8789029535864978
1987,1106,12,13,1009,1039,0.48,-30,0.49267578125
1987,1108,5,20,395,1340,0.2,-945,0.2276657060518732
1987,1109,9,15,761,1213,0.375,-452,0.38551165146909827
1987,1110,9,14,689,990,0.391304347826087,-301,0.4103633114949375
1987,1111,4,21,280,1304,0.16,-1024,0.17676767676767677
1987,1112,17,11,1282,790,0.6071428571428571,492,0.6187258687258688
1987,1113,11,17,836,1180,0.39285714285714285,-344,0.4146825396825397
1987,1114,20,9,1490,569,0.6896551724137931,921,0.7236522583778533
1987,1116,18,13,1572,868,0.5806451612903226,704,0.6442622950819672
1987,1117,17,12,1221,713,0.5862068965517241,508,0.6313340227507755
1987,1118,6,21,399,1348,0.2222222222222222,-949,0.22839152833428736
1987,1119,12,15,853,905,0.4444444444444444,-52,0.4852104664391354
1987,1120,17,12,1432,893,0.5862068965517241,539,0.6159139784946237
1987,1121,6,18,430,1192,0.25,-762,0.2651048088779285
1987,1122,16,10,1304,733,0.6153846153846154,571,0.6401570937653411
1987,1123,8,18,661,1261,0.3076923076923077,-600,0.34391259105098854
1987,1124,16,12,1113,796,0.5714285714285714,317,0.5830277632268204
1987,1126,9,19,610,1161,0.32142857142857145,-551,0.34443817052512704
1987,1129,18,7,1348,456,0.72,892,0.7472283813747228
1987,1130,11,18,801,1065,0.3793103448275862,-264,0.4292604501607717
1987,1131,17,12,1312,818,0.5862068965517241,494,0.615962441314554
1987,1132,14,13,996,771,0.5185185185185185,225,0.5636672325976231
1987,1133,16,12,1416,921,0.5714285714285714,495,0.6059050064184852
1987,1134,8,18,647,1190,0.3076923076923077,-543,0.35220468154599893
1987,1135,8,18,681,1349,0.3076923076923077,-668,0.3354679802955665
1987,1137,19,8,1564,547,0.7037037037037037,1017,0.7408810990052108
1987,1139,11,15,845,1045,0.4230769230769231,-200,0.4470899470899471
1987,1140,21,10,1802,763,0.6774193548387096,1039,0.7025341130604289
1987,1141,19,7,1449,455,0.7307692307692307,994,0.7610294117647058
1987,1143,17,14,1251,901,0.5483870967741935,350,0.5813197026022305
1987,1144,13,13,993,916,0.5,77,0.5201676270298585
1987,1145,15,12,1201,729,0.5555555555555556,472,0.622279792746114
1987,1147,6,17,455,1258,0.2608695652173913,-803,0.2656158785755984
1987,1148,8,19,605,1172,0.2962962962962963,-567,0.3404614518851998
1987,1149,18,8,1474,590,0.6923076923076923,884,0.7141472868217055
1987,1150,13,14,1047,960,0.48148148148148145,87,0.5216741405082213
1987,1151,21,7,1565,515,0.75,1050,0.7524038461538461
1987,1152,7,17,574,1181,0.2916666666666667,-607,0.32706552706552705
1987,1153,10,16,734,1013,0.38461538461538464,-279,0.42014882655981683
1987,1154,10,14,797,986,0.4166666666666667,-189,0.44699943914750423
1987,1155,23,5,2002,400,0.8214285714285714,1602,0.8334721065778518
1987,1156,23,7,1933,518,0.7666666666666667,1415,0.7886576907384741
1987,1157,10,16,751,1041,0.38461538461538464,-290,0.41908482142857145
1987,1159,3,21,196,1342,0.125,-1146,0.12743823146944083
1987,1160,9,19,611,1165,0.32142857142857145,-554,0.34403153153153154
1987,1161,11,15,795,940,0.4230769230769231,-145,0.45821325648414984
1987,1162,9,14,720,952,0.391304347826087,-232,0.430622009569378
1987,1163,9,19,604,1135,0.32142857142857145,-531,0.34732604945370904
1987,1164,8,19,625,1280,0.2962962962962963,-655,0.32808398950131235
1987,1165,13,11,1053,705,0.5416666666666666,348,0.5989761092150171
1987,1166,7,19,515,1228,0.2692307692307692,-713,0.29546758462421113
1987,1168,15,12,1069,781,0.5555555555555556,288,0.5778378378378378
1987,1171,13,10,1024,733,0.5652173913043478,291,0.5828116107000569
1987,1172,16,10,1273,665,0.6153846153846154,608,0.6568627450980392
1987,1173,12,15,895,967,0.4444444444444444,-72,0.4806659505907626
1987,1174,8,16,623,1042,0.3333333333333333,-419,0.3741741741741742
1987,1175,4,21,291,1181,0.16,-890,0.19769021739130435
1987,1177,26,2,2010,133,0.9285714285714286,1877,0.9379374708352777
1987,1178,5,21,338,1364,0.19230769230769232,-1026,0.19858989424206816
1987,1179,14,14,986,829,0.5,157,0.5432506887052342
1987,1180,14,13,1134,993,0.5185185185185185,141,0.5331452750352609
1987,1181,21,8,1705,552,0.7241379310344828,1153,0.7554275587062472
1987,1182,10,17,749,1105,0.37037037037037035,-356,0.4039913700107875
1987,1183,6,18,382,1103,0.25,-721,0.2572390572390572
1987,1184,16,11,1391,869,0.5925925925925926,522,0.6154867256637168
1987,1185,10,15,815,1054,0.4,-239,0.4360620652755484
1987,1186,4,20,285,1218,0.16666666666666666,-933,0.18962075848303392
1987,1187,10,16,730,1004,0.38461538461538464,-274,0.4209919261822376
1987,1190,4,20,274,1340,0.16666666666666666,-1066,0.1697645600991326
1987,1191,15,12,1133,757,0.5555555555555556,376,0.5994708994708995
1987,1192,15,10,1160,685,0.6,475,0.6287262872628726
1987,1193,14,15,955,965,0.4827586206896552,-10,0.4973958333333333
1987,1196,21,10,1873,738,0.6774193548387096,1135,0.7173496744542321
1987,1197,9,15,754,1045,0.375,-291,0.4191217342968316
1987,1199,16,10,1408,721,0.6153846153846154,687,0.6613433536871771
1987,1200,13,16,1040,1178,0.4482758620689655,-138,0.4688908926961226
1987,1201,7,20,448,1089,0.25925925925925924,-641,0.291476903057905
1987,1202,13,12,1014,790,0.52,224,0.5620842572062085
1987,1203,8,19,684,1364,0.2962962962962963,-680,0.333984375
1987,1204,18,10,1289,658,0.6428571428571429,631,0.6620441705187468
1987,1206,13,13,956,846,0.5,110,0.5305216426193119
1987,1207,22,4,1695,262,0.8461538461538461,1433,0.8661216147164027
1987,1208,16,11,1170,758,0.5925925925925926,412,0.6068464730290456
1987,1209,7,17,551,1331,0.2916666666666667,-780,0.29277364505844844
1987,1210,16,12,1235,737,0.5714285714285714,498,0.6262677484787018
1987,1211,14,10,1101,609,0.5833333333333334,492,0.643859649122807
1987,1212,15,13,1195,836,0.5357142857142857,359,0.5883801083210242
1987,1215,11,15,896,1093,0.4230769230769231,-197,0.4504776269482152
1987,1216,14,14,938,885,0.5,53,0.5145364783324191
1987,1217,7,17,614,1358,0.2916666666666667,-744,0.31135902636916835
1987,1218,7,21,514,1575,0.25,-1061,0.24605074198180948
1987,1220,9,19,714,1308,0.32142857142857145,-594,0.35311572700296734
1987,1221,8,18,537,1126,0.3076923076923077,-589,0.32291040288635
1987,1222,17,10,1243,589,0.6296296296296297,654,0.6784934497816594
1987,1223,15,11,1238,766,0.5769230769230769,472,0.6177644710578842
1987,1224,24,5,1857,333,0.8275862068965517,1524,0.8479452054794521
1987,1225,12,14,828,867,0.46153846153846156,-39,0.48849557522123893
1987,1226,12,15,913,889,0.4444444444444444,24,0.5066592674805771
1987,1227,13,14,1086,1071,0.48148148148148145,15,0.5034770514603616
1987,1228,23,7,1871,535,0.7666666666666667,1336,0.7776392352452203
1987,1229,17,12,1273,784,0.5862068965517241,489,0.6188624210014584
1987,1231,24,4,1977,294,0.8571428571428571,1683,0.8705416116248349
1987,1232,6,19,404,1142,0.24,-738,0.2613195342820181
1987,1233,15,14,1136,949,0.5172413793103449,187,0.5448441247002398
1987,1234,25,4,2202,316,0.8620689655172413,1886,0.8745035742652899
1987,1235,12,15,966,1048,0.4444444444444444,-82,0.47964250248262164
1987,1238,14,14,916,850,0.5,66,0.5186862967157417
1987,1239,18,11,1538,796,0.6206896551724138,742,0.6589545844044559
1987,1241,19,9,1477,637,0.6785714285714286,840,0.6986754966887417
1987,1242,22,10,1664,711,0.6875,953,0.7006315789473684
1987,1243,16,10,1325,698,0.6153846153846154,627,0.6549678695007415
1987,1245,17,10,1318,671,0.6296296296296297,647,0.6626445449974862
1987,1246,18,10,1277,611,0.6428571428571429,666,0.6763771186440678
1987,1247,16,12,1313,777,0.5714285714285714,536,0.6282296650717704
1987,1248,16,13,1261,911,0.5517241379310345,350,0.5805709023941068
1987,1249,12,14,863,836,0.46153846153846156,27,0.5079458505002943
1987,1250,12,14,1013,980,0.46153846153846156,33,0.5082789764174611
1987,1253,11,19,872,1282,0.36666666666666664,-410,0.40482822655524603
1987,1254,10,15,815,1066,0.4,-251,0.4332801701222754
1987,1256,20,7,1430,471,0.7407407407407407,959,0.7522356654392425
1987,1257,17,14,1373,900,0.5483870967741935,473,0.6040475142982842
1987,1258,8,16,746,1213,0.3333333333333333,-467,0.38080653394589076
1987,1259,13,13,1106,917,0.5,189,0.5467128027681661
1987,1260,16,13,1407,932,0.5517241379310345,475,0.6015391192817443
1987,1261,18,14,1306,906,0.5625,400,0.5904159132007233
1987,1263,10,17,729,1114,0.37037037037037035,-385,0.3955507325013565
1987,1264,3,20,237,1335,0.13043478260869565,-1098,0.15076335877862596
1987,1265,20,9,1472,504,0.6896551724137931,968,0.7449392712550608
1987,1266,16,12,1238,799,0.5714285714285714,439,0.6077565046637211
1987,1267,25,5,2093,351,0.8333333333333334,1742,0.8563829787234043
1987,1268,9,17,725,1140,0.34615384615384615,-415,0.38873994638069703
1987,1269,10,16,684,967,0.38461538461538464,-283,0.41429436705027256
1987,1270,12,14,906,899,0.46153846153846156,7,0.5019390581717451
1987,1272,26,8,1995,554,0.7647058823529411,1441,0.7826598666143586
1987,1273,10,16,749,1054,0.38461538461538464,-305,0.4154187465335552
1987,1274,12,16,984,1061,0.42857142857142855,-77,0.4811735941320293
1987,1275,13,14,1014,876,0.48148148148148145,138,0.5365079365079365
1987,1276,17,11,1557,858,0.6071428571428571,699,0.6447204968944099
1987,1277,11,17,919,1187,0.39285714285714285,-268,0.43637226970560306
1987,1278,7,19,541,1235,0.2692307692307692,-694,0.30461711711711714
1987,1279,13,13,984,837,0.5,147,0.5403624382207578
1987,1280,3,21,189,1109,0.125,-920,0.14560862865947613
1987,1281,23,9,1754,622,0.71875,1132,0.7382154882154882
1987,1283,23,5,1680,279,0.8214285714285714,1401,0.8575803981623277
1987,1284,5,19,342,1228,0.20833333333333334,-886,0.2178343949044586
1987,1285,14,11,1073,785,0.56,288,0.577502691065662
1987,1286,18,7,1595,512,0.72,1083,0.757000474608448
1987,1287,10,14,837,985,0.4166666666666667,-148,0.4593852908891328
1987,1288,8,20,569,1219,0.2857142857142857,-650,0.3182326621923937
1987,1290,12,15,1085,1057,0.4444444444444444,28,0.5065359477124183
1987,1292,19,6,1600,496,0.76,1104,0.7633587786259542
1987,1293,9,15,661,981,0.375,-320,0.402557856272838
1987,1296,7,18,552,1313,0.28,-761,0.29597855227882036
1987,1298,25,5,1920,374,0.8333333333333334,1546,0.8369659982563208
1987,1299,21,4,1611,264,0.84,1347,0.8592
1987,1301,20,13,1662,920,0.6060606060606061,742,0.6436870642912471
1987,1304,15,11,1094,796,0.5769230769230769,298,0.5788359788359788
1987,1305,14,15,1147,1155,0.4827586206896552,-8,0.498262380538662
1987,1306,4,24,248,1535,0.14285714285714285,-1287,0.13909141895681434
1987,1307,24,9,2027,623,0.7272727272727273,1404,0.7649056603773585
1987,1308,13,14,974,872,0.48148148148148145,102,0.5276273022751896
1987,1309,23,3,1909,215,0.8846153846153846,1694,0.8987758945386064
1987,1310,19,9,1790,604,0.6785714285714286,1186,0.747702589807853
1987,1311,9,18,669,1183,0.3333333333333333,-514,0.36123110151187904
1987,1314,28,3,2587,209,0.9032258064516129,2378,0.9252503576537912
1987,1317,8,17,676,1275,0.32,-599,0.34648898001025114
1987,1318,24,6,1961,501,0.8,1460,0.7965069049553208
1987,1319,9,16,722,1001,0.36,-279,0.4190365641323273
1987,1320,11,13,871,826,0.4583333333333333,45,0.5132586918090748
1987,1321,5,20,350,1193,0.2,-843,0.22683084899546338
1987,1322,11,13,806,812,0.4583333333333333,-6,0.49814585908529047
1987,1323,22,7,1464,409,0.7586206896551724,1055,0.7816337426588361
1987,1325,12,14,880,916,0.46153846153846156,-36,0.48997772828507796
1987,1326,18,12,1584,946,0.6,638,0.6260869565217392
1987,1328,22,9,2039,728,0.7096774193548387,1311,0.7368991687748464
1987,1329,7,19,537,1242,0.2692307692307692,-705,0.30185497470489037
1987,1330,6,22,414,1425,0.21428571428571427,-1011,0.22512234910277323
1987,1331,11,17,760,1113,0.39285714285714285,-353,0.40576615056059795
1987,1332,15,14,1045,874,0.5172413793103449,171,0.5445544554455446
1987,1333,17,10,1230,602,0.6296296296296297,628,0.6713973799126638
1987,1334,8,17,500,1057,0.32,-557,0.32113037893384716
1987,1335,13,13,1128,920,0.5,208,0.55078125
1987,1336,13,12,1004,781,0.52,223,0.5624649859943978
1987,1337,12,18,953,1266,0.4,-313,0.42947273546642634
1987,1338,23,7,1975,513,0.7666666666666667,1462,0.7938102893890675
1987,1339,11,14,796,833,0.44,-37,0.4886433394720687
1987,1341,6,22,398,1366,0.21428571428571427,-968,0.2256235827664399
1987,1343,14,9,959,534,0.6086956521739131,425,0.6423308774279973
1987,1344,21,8,1915,599,0.7241379310344828,1316,0.7617342879872713
1987,1345,23,4,1908,293,0.8518518518518519,1615,0.8668786915038619
1987,1347,11,14,839,935,0.44,-96,0.47294250281848926
1987,1348,17,9,1353,675,0.6538461538461539,678,0.6671597633136095
1987,1349,5,19,332,1092,0.20833333333333334,-760,0.23314606741573032
1987,1350,15,14,1097,859,0.5172413793103449,238,0.560838445807771
1987,1351,9,15,781,1113,0.375,-332,0.4123548046462513
1987,1352,10,14,666,874,0.4166666666666667,-208,0.43246753246753245
1987,1353,8,20,646,1322,0.2857142857142857,-676,0.3282520325203252
1987,1354,13,15,920,975,0.4642857142857143,-55,0.48548812664907653
1987,1356,9,17,721,1222,0.34615384615384615,-501,0.37107565620174987
1987,1358,14,12,1085,796,0.5384615384615384,289,0.5768208399787347
1987,1359,2,22,152,1459,0.08333333333333333,-1307,0.09435133457479826
1987,1360,23,5,1658,311,0.8214285714285714,1347,0.8420518029456577
1987,1361,4,25,337,1810,0.13793103448275862,-1473,0.15696320447135537
1987,1362,12,12,949,759,0.5,190,0.5556206088992974
1987,1363,16,13,1119,836,0.5517241379310345,283,0.5723785166240409
1987,1364,15,13,1145,902,0.5357142857142857,243,0.5593551538837322
1987,1365,15,13,1080,807,0.5357142857142857,273,0.5723370429252782
1987,1368,7,19,509,1156,0.2692307692307692,-647,0.3057057057057057
1987,1371,14,13,1114,982,0.5185185185185185,132,0.5314885496183206
1987,1372,19,7,1356,430,0.7307692307692307,926,0.7592385218365062
1987,1373,15,12,1167,822,0.5555555555555556,345,0.5867269984917044
1987,1374,15,13,1252,803,0.5357142857142857,449,0.6092457420924574
1987,1375,13,14,1049,1048,0.48148148148148145,1,0.5002384358607534
1987,1376,13,14,951,830,0.48148148148148145,121,0.5339696799550814
1987,1378,7,19,475,1190,0.2692307692307692,-715,0.2852852852852853
1987,1379,14,11,1155,820,0.56,335,0.5848101265822785
1987,1380,16,11,1534,821,0.5925925925925926,713,0.651380042462845
1987,1382,3,23,196,1447,0.11538461538461539,-1251,0.11929397443700548
1987,1383,8,15,580,890,0.34782608695652173,-310,0.3945578231292517
1987,1384,7,16,583,1194,0.30434782608695654,-611,0.3280810354530107
1987,1385,20,8,1469,513,0.7142857142857143,956,0.7411705348133198
1987,1386,16,13,1292,937,0.5517241379310345,355,0.5796321220278151
1987,1387,22,9,1622,589,0.7096774193548387,1033,0.7336047037539575
1987,1388,12,13,807,669,0.48,138,0.5467479674796748
1987,1389,20,7,1415,402,0.7407407407407407,1013,0.7787561915244909
1987,1390,14,13,1074,845,0.5185185185185185,229,0.559666492965086
1987,1391,17,13,1309,861,0.5666666666666667,448,0.603225806451613
1987,1393,25,6,2109,430,0.8064516129032258,1679,0.8306419850334777
1987,1395,23,6,1656,408,0.7931034482758621,1248,0.8023255813953488
1987,1396,31,3,2362,201,0.9117647058823529,2161,0.9215762777994537
1987,1397,14,15,1156,1045,0.4827586206896552,111,0.5252158109950023
1987,1398,11,12,847,722,0.4782608695652174,125,0.5398342893562779
1987,1399,3,20,253,1436,0.13043478260869565,-1183,0.1497927767910006
1987,1400,13,16,932,882,0.4482758620689655,50,0.5137816979051819
1987,1401,17,13,1198,827,0.5666666666666667,371,0.591604938271605
1987,1402,10,15,790,1025,0.4,-235,0.43526170798898073
1987,1403,13,14,892,813,0.48148148148148145,79,0.52316715542522
1987,1405,8,17,645,1164,0.32,-519,0.35655058043117743
1987,1406,11,16,808,1031,0.4074074074074074,-223,0.43936922240348014
1987,1409,22,7,1567,459,0.7586206896551724,1108,0.7734452122408687
1987,1410,12,12,1025,805,0.5,220,0.5601092896174863
1987,1411,10,18,696,1249,0.35714285714285715,-553,0.357840616966581
1987,1412,17,10,1351,676,0.6296296296296297,675,0.6665022200296004
1987,1414,14,14,1315,1111,0.5,204,0.5420445177246497
1987,1416,9,14,726,861,0.391304347826087,-135,0.45746691871455575
1987,1417,24,6,1900,432,0.8,1468,0.8147512864493996
1987,1418,9,17,680,1144,0.34615384615384615,-464,0.37280701754385964
1987,1419,11,15,766,943,0.4230769230769231,-177,0.44821533060269164
1987,1420,11,15,840,888,0.4230769230769231,-48,0.4861111111111111
1987,1421,13,11,1007,720,0.5416666666666666,287,0.5830920671685003
1987,1423,18,11,1293,716,0.6206896551724138,577,0.6436037829766053
1987,1424,33,1,3077,88,0.9705882352941176,2989,0.9721958925750395
1987,1425,8,19,524,1120,0.2962962962962963,-596,0.31873479318734793
1987,1426,6,18,485,1330,0.25,-845,0.26721763085399447
1987,1427,12,14,1070,996,0.46153846153846156,74,0.5179090029041626
1987,1428,15,12,1139,756,0.5555555555555556,383,0.6010554089709762
1987,1429,15,16,1266,1300,0.4838709677419355,-34,0.49337490257209665
1987,1431,23,6,1820,422,0.7931034482758621,1398,0.8117752007136485
1987,1432,8,15,582,983,0.34782608695652173,-401,0.3718849840255591
1987,1433,17,14,1231,970,0.5483870967741935,261,0.5592912312585189
1987,1434,8,16,539,983,0.3333333333333333,-444,0.35413929040735875
1987,1435,16,15,1214,1014,0.5161290322580645,200,0.5448833034111311
1987,1436,4,22,353,1622,0.15384615384615385,-1269,0.17873417721518986
1987,1437,15,15,1086,1071,0.5,15,0.5034770514603616
1987,1438,21,9,1575,665,0.7,910,0.703125
1987,1439,11,16,868,1068,0.4074074074074074,-200,0.44834710743801653
1987,1440,7,17,512,1139,0.2916666666666667,-627,0.31011508176862507
1987,1441,7,19,499,1246,0.2692307692307692,-747,0.2859598853868195
1987,1442,8,16,700,1091,0.3333333333333333,-391,0.3908431044109436
1987,1443,25,8,2039,560,0.7575757575757576,1479,0.7845325125048095
1987,1444,11,15,896,1061,0.4230769230769231,-165,0.457843638221768
1987,1447,12,13,1011,947,0.48,64,0.5163432073544433
1987,1448,13,16,955,1043,0.4482758620689655,-88,0.477977977977978
1987,1449,18,13,1402,900,0.5806451612903226,502,0.6090356211989574
1987,1450,10,18,746,1081,0.35714285714285715,-335,0.40831964969896006
1987,1451,5,21,434,1398,0.19230769230769232,-964,0.2368995633187773
1987,1452,23,7,1660,408,0.7666666666666667,1252,0.8027079303675049
1987,1453,13,13,882,703,0.5,179,0.5564668769716088
1987,1455,21,10,1466,658,0.6774193548387096,808,0.6902071563088512
1987,1456,3,22,203,1299,0.12,-1096,0.13515312916111852
1987,1457,6,20,452,1256,0.23076923076923078,-804,0.2646370023419204
1987,1458,11,17,764,1175,0.39285714285714285,-411,0.39401753481175866
1987,1461,21,9,1507,608,0.7,899,0.7125295508274232
1987,1462,14,12,1113,895,0.5384615384615384,218,0.5542828685258964
1987,1463,13,12,1027,861,0.52,166,0.5439618644067796
1987,1464,8,17,622,1192,0.32,-570,0.3428886438809261
1988,1102,7,17,504,1038,0.2916666666666667,-534,0.32684824902723736
1988,1103,18,7,1474,502,0.72,972,0.7459514170040485
1988,1104,13,17,974,991,0.43333333333333335,-17,0.4956743002544529
1988,1106,6,19,538,1539,0.24,-1001,0.2590274434280212
1988,1108,7,19,557,1341,0.2692307692307692,-784,0.2934668071654373
1988,1109,9,15,813,1160,0.375,-347,0.41206284845413077
1988,1110,13,14,961,970,0.48148148148148145,-9,0.49766960124287934
1988,1111,12,13,970,884,0.48,86,0.52319309600863
1988,1112,31,2,2670,133,0.9393939393939394,2537,0.952550838387442
1988,1113,12,16,979,1168,0.42857142857142855,-189,0.455985095482068
1988,1114,24,6,1970,396,0.8,1574,0.8326289095519864
1988,1116,21,8,1673,517,0.7241379310344828,1156,0.7639269406392694
1988,1117,15,13,1060,793,0.5357142857142857,267,0.5720453318942256
1988,1119,8,19,646,1180,0.2962962962962963,-534,0.3537787513691128
1988,1120,17,10,1334,712,0.6296296296296297,622,0.6520039100684262
1988,1121,5,18,350,1170,0.21739130434782608,-820,0.23026315789473684
1988,1122,14,13,1143,938,0.5185185185185185,205,0.54925516578568
1988,1123,10,14,683,837,0.4166666666666667,-154,0.4493421052631579
1988,1124,22,10,1649,608,0.6875,1041,0.7306158617634028
1988,1126,6,21,466,1272,0.2222222222222222,-806,0.2681242807825086
1988,1129,22,5,1581,295,0.8148148148148148,1286,0.8427505330490405
1988,1130,14,13,1182,826,0.5185185185185185,356,0.5886454183266933
1988,1131,23,7,1868,465,0.7666666666666667,1403,0.8006858122588941
1988,1132,10,16,737,1020,0.38461538461538464,-283,0.4194649971542402
1988,1133,26,4,2434,354,0.8666666666666667,2080,0.8730272596843616
1988,1134,7,17,559,1079,0.2916666666666667,-520,0.3412698412698413
1988,1135,4,19,337,1417,0.17391304347826086,-1080,0.19213226909920184
1988,1137,13,12,1104,903,0.52,201,0.5500747384155455
1988,1139,12,13,835,808,0.48,27,0.5082166768107121
1988,1140,25,5,2195,366,0.8333333333333334,1829,0.857087075361187
1988,1141,17,13,1282,863,0.5666666666666667,419,0.5976689976689976
1988,1143,9,20,723,1126,0.3103448275862069,-403,0.3910221741481882
1988,1144,7,16,553,985,0.30434782608695654,-432,0.35955786736020806
1988,1145,7,20,500,1364,0.25925925925925924,-864,0.26824034334763946
1988,1147,10,15,851,1128,0.4,-277,0.4300151591712986
1988,1148,9,18,694,1274,0.3333333333333333,-580,0.35264227642276424
1988,1149,13,12,1085,794,0.52,291,0.5774348057477382
1988,1150,21,7,1714,492,0.75,1222,0.7769718948322756
1988,1151,17,12,1312,868,0.5862068965517241,444,0.6018348623853211
1988,1152,6,20,472,1252,0.23076923076923078,-780,0.2737819025522042
1988,1153,9,17,777,1352,0.34615384615384615,-575,0.36496007515265383
1988,1154,6,18,428,1305,0.25,-877,0.24697057126370456
1988,1155,14,14,1133,954,0.5,179,0.5428845232390992
1988,1156,20,7,1722,541,0.7407407407407407,1181,0.760936809544852
1988,1157,13,11,1084,686,0.5416666666666666,398,0.6124293785310735
1988,1159,3,20,211,1252,0.13043478260869565,-1041,0.1442241968557758
1988,1160,7,21,531,1394,0.25,-863,0.27584415584415584
1988,1161,15,12,999,660,0.5555555555555556,339,0.6021699819168174
1988,1162,4,20,316,1190,0.16666666666666666,-874,0.2098273572377158
1988,1163,15,14,1151,879,0.5172413793103449,272,0.5669950738916256
1988,1164,10,14,799,966,0.4166666666666667,-167,0.4526912181303116
1988,1165,16,9,1253,649,0.64,604,0.6587802313354364
1988,1166,12,16,986,1054,0.42857142857142855,-68,0.48333333333333334
1988,1168,12,17,910,1051,0.41379310344827586,-141,0.46404895461499235
1988,1171,17,8,1427,571,0.68,856,0.7142142142142142
1988,1172,12,13,912,883,0.48,29,0.5080779944289694
1988,1173,10,18,808,1250,0.35714285714285715,-442,0.39261418853255586
1988,1174,15,9,1187,611,0.625,576,0.6601779755283649
1988,1175,2,23,142,1588,0.08,-1446,0.08208092485549133
1988,1177,21,7,1750,475,0.75,1275,0.7865168539325843
1988,1178,5,22,382,1593,0.18518518518518517,-1211,0.19341772151898734
1988,1179,13,14,974,997,0.48148148148148145,-23,0.4941653982749873
1988,1180,16,10,1323,765,0.6153846153846154,558,0.6336206896551724
1988,1181,24,6,2088,470,0.8,1618,0.8162627052384676
1988,1182,9,21,756,1508,0.3,-752,0.3339222614840989
1988,1183,13,11,988,772,0.5416666666666666,216,0.5613636363636364
1988,1184,16,11,1388,752,0.5925925925925926,636,0.6485981308411215
1988,1185,19,7,1581,490,0.7307692307692307,1091,0.7633993239980685
1988,1186,3,21,211,1308,0.125,-1097,0.13890717577353523
1988,1187,6,20,398,1277,0.23076923076923078,-879,0.23761194029850746
1988,1190,12,14,971,986,0.46153846153846156,-15,0.4961676034747062
1988,1191,20,7,1679,548,0.7407407407407407,1131,0.7539290525370453
1988,1192,21,6,1659,392,0.7777777777777778,1267,0.8088737201365188
1988,1193,8,20,573,1210,0.2857142857142857,-637,0.3213684800897364
1988,1196,22,11,1667,745,0.6666666666666666,922,0.6911276948590381
1988,1197,18,8,1482,591,0.6923076923076923,891,0.7149059334298119
1988,1198,9,17,793,1235,0.34615384615384615,-442,0.391025641025641
1988,1199,19,10,1697,733,0.6551724137931034,964,0.6983539094650206
1988,1200,16,14,1130,951,0.5333333333333333,179,0.5430081691494474
1988,1201,8,19,591,1183,0.2962962962962963,-592,0.33314543404735064
1988,1202,14,10,1120,661,0.5833333333333334,459,0.6288601909039865
1988,1203,11,15,857,975,0.4230769230769231,-118,0.46779475982532753
1988,1204,21,6,1367,351,0.7777777777777778,1016,0.7956926658905704
1988,1206,18,10,1563,672,0.6428571428571429,891,0.6993288590604027
1988,1207,16,9,1203,586,0.64,617,0.6724427054220234
1988,1208,18,15,1389,1057,0.5454545454545454,332,0.5678659035159443
1988,1209,5,19,450,1405,0.20833333333333334,-955,0.24258760107816713
1988,1210,21,9,1774,642,0.7,1132,0.734271523178808
1988,1211,12,12,901,794,0.5,107,0.5315634218289086
1988,1212,13,17,1062,1131,0.43333333333333335,-69,0.4842681258549932
1988,1215,13,11,1129,781,0.5416666666666666,348,0.5910994764397905
1988,1216,15,16,1107,1118,0.4838709677419355,-11,0.49752808988764047
1988,1217,10,14,760,950,0.4166666666666667,-190,0.4444444444444444
1988,1218,4,25,340,1605,0.13793103448275862,-1265,0.17480719794344474
1988,1220,3,20,213,1232,0.13043478260869565,-1019,0.14740484429065745
1988,1221,13,15,1278,1185,0.4642857142857143,93,0.5188794153471377
1988,1222,17,12,1283,845,0.5862068965517241,438,0.6029135338345865
1988,1223,5,18,345,1092,0.21739130434782608,-747,0.24008350730688935
1988,1224,12,13,823,900,0.48,-77,0.477655252466628
1988,1225,16,11,1100,599,0.5925925925925926,501,0.6474396703943496
1988,1226,12,13,913,773,0.48,140,0.5415183867141162
1988,1227,6,20,440,1280,0.23076923076923078,-840,0.2558139534883721
1988,1228,22,9,1937,644,0.7096774193548387,1293,0.750484308407594
1988,1229,18,12,1372,706,0.6,666,0.6602502406159769
1988,1231,19,9,1580,635,0.6785714285714286,945,0.7133182844243793
1988,1232,4,21,304,1374,0.16,-1070,0.18116805721096543
1988,1233,11,16,886,1206,0.4074074074074074,-320,0.4235181644359465
1988,1234,22,9,2148,750,0.7096774193548387,1398,0.7412008281573499
1988,1235,19,11,1839,874,0.6333333333333333,965,0.6778474014006635
1988,1238,11,15,772,1028,0.4230769230769231,-256,0.4288888888888889
1988,1239,6,21,499,1361,0.2222222222222222,-862,0.2682795698924731
1988,1241,10,18,673,1195,0.35714285714285715,-522,0.3602783725910064
1988,1242,18,11,1370,771,0.6206896551724138,599,0.6398879028491359
1988,1243,20,8,1504,626,0.7142857142857143,878,0.7061032863849765
1988,1245,7,17,509,1064,0.2916666666666667,-555,0.32358550540368725
1988,1246,24,5,1955,320,0.8275862068965517,1635,0.8593406593406593
1988,1247,23,9,1854,635,0.71875,1219,0.7448774608276416
1988,1248,17,10,1246,623,0.6296296296296297,623,0.6666666666666666
1988,1249,19,11,1410,689,0.6333333333333333,721,0.6717484516436398
1988,1250,19,9,1554,691,0.6785714285714286,863,0.6922048997772828
1988,1253,15,11,1287,801,0.5769230769230769,486,0.6163793103448276
1988,1254,11,14,925,1096,0.44,-171,0.4576942107867392
1988,1256,18,8,1320,514,0.6923076923076923,806,0.7197382769901853
1988,1257,22,10,1895,733,0.6875,1162,0.7210806697108066
1988,1258,24,3,2682,267,0.8888888888888888,2415,0.9094608341810784
1988,1259,6,21,461,1371,0.2222222222222222,-910,0.25163755458515286
1988,1260,13,16,1076,1194,0.4482758620689655,-118,0.47400881057268723
1988,1261,16,13,1233,817,0.5517241379310345,416,0.6014634146341463
1988,1263,12,14,1009,946,0.46153846153846156,63,0.5161125319693095
1988,1264,6,22,464,1652,0.21428571428571427,-1188,0.21928166351606806
1988,1265,17,9,1281,587,0.6538461538461539,694,0.6857601713062098
1988,1266,10,18,746,1147,0.35714285714285715,-401,0.3940834653988378
1988,1267,24,7,2063,540,0.7741935483870968,1523,0.7925470610833654
1988,1268,16,12,1236,859,0.5714285714285714,377,0.5899761336515513
1988,1269,7,16,519,1108,0.30434782608695654,-589,0.3189920098340504
1988,1270,7,22,518,1494,0.2413793103448276,-976,0.25745526838966204
1988,1271,6,21,462,1521,0.2222222222222222,-1059,0.2329803328290469
1988,1272,19,11,1585,777,0.6333333333333333,808,0.6710414902624894
1988,1273,13,14,969,928,0.48148148148148145,41,0.510806536636795
1988,1274,16,13,1383,922,0.5517241379310345,461,0.6
1988,1275,9,18,703,1208,0.3333333333333333,-505,0.36787022501308214
1988,1276,23,7,2104,518,0.7666666666666667,1586,0.8024408848207475
1988,1277,10,18,730,1221,0.35714285714285715,-491,0.3741670937980523
1988,1278,10,18,787,1237,0.35714285714285715,-450,0.38883399209486164
1988,1279,11,16,787,1022,0.4074074074074074,-235,0.4350469872857933
1988,1280,12,15,816,817,0.4444444444444444,-1,0.49969381506429883
1988,1281,19,10,1722,799,0.6551724137931034,923,0.6830622768742562
1988,1283,20,6,1513,358,0.7692307692307693,1155,0.8086584714056654
1988,1284,14,13,1006,829,0.5185185185185185,177,0.5482288828337875
1988,1285,15,11,1050,713,0.5769230769230769,337,0.5955757231990925
1988,1286,16,11,1233,735,0.5925925925925926,498,0.6265243902439024
1988,1287,3,21,301,1564,0.125,-1263,0.1613941018766756
1988,1288,9,17,666,1212,0.34615384615384615,-546,0.3546325878594249
1988,1290,6,19,521,1318,0.24,-797,0.2833061446438282
1988,1292,18,10,1549,682,0.6428571428571429,867,0.6943074854325415
1988,1293,18,8,1447,506,0.6923076923076923,941,0.7409114183307731
1988,1296,7,19,617,1404,0.2692307692307692,-787,0.3052944087085601
1988,1298,11,15,786,915,0.4230769230769231,-129,0.4620811287477954
1988,1299,22,2,1878,129,0.9166666666666666,1749,0.9357249626307922
1988,1301,23,7,1983,513,0.7666666666666667,1470,0.7944711538461539
1988,1304,11,18,795,1236,0.3793103448275862,-441,0.3914327917282127
1988,1305,12,13,992,1017,0.48,-25,0.49377799900447983
1988,1306,4,25,277,1668,0.13793103448275862,-1391,0.1424164524421594
1988,1307,19,13,1458,944,0.59375,514,0.6069941715237303
1988,1308,13,16,938,1050,0.4482758620689655,-112,0.47183098591549294
1988,1309,21,10,1623,784,0.6774193548387096,839,0.6742833402575821
1988,1310,15,15,1117,1100,0.5,17,0.5038340099233198
1988,1311,8,17,585,1120,0.32,-535,0.34310850439882695
1988,1314,24,6,2020,433,0.8,1587,0.8234814512841419
1988,1317,17,12,1395,823,0.5862068965517241,572,0.6289449954914337
1988,1318,15,13,1219,871,0.5357142857142857,348,0.5832535885167464
1988,1319,8,17,618,1089,0.32,-471,0.36203866432337434
1988,1320,6,18,542,1261,0.25,-719,0.30061009428729896
1988,1321,6,20,417,1255,0.23076923076923078,-838,0.2494019138755981
1988,1322,16,12,1141,761,0.5714285714285714,380,0.599894847528917
1988,1323,19,8,1411,538,0.7037037037037037,873,0.72396100564392
1988,1325,15,13,1171,999,0.5357142857142857,172,0.53963133640553
1988,1326,15,12,1159,880,0.5555555555555556,279,0.5684158901422266
1988,1328,30,3,3231,229,0.9090909090909091,3002,0.9338150289017341
1988,1329,12,15,1004,974,0.4444444444444444,30,0.5075834175935288
1988,1330,17,11,1358,806,0.6071428571428571,552,0.6275415896487985
1988,1331,8,21,672,1580,0.27586206896551724,-908,0.2984014209591474
1988,1332,14,13,1017,782,0.5185185185185185,235,0.5653140633685381
1988,1333,20,10,1440,592,0.6666666666666666,848,0.7086614173228346
1988,1334,3,24,240,1705,0.1111111111111111,-1465,0.12339331619537275
1988,1335,10,16,771,984,0.38461538461538464,-213,0.4393162393162393
1988,1336,11,14,769,875,0.44,-106,0.4677615571776156
1988,1337,17,12,1463,920,0.5862068965517241,543,0.6139320184641208
1988,1338,23,6,1858,435,0.7931034482758621,1423,0.8102921936327955
1988,1339,3,22,213,1568,0.12,-1355,0.11959573273441887
1988,1341,5,20,371,1389,0.2,-1018,0.21079545454545454
1988,1343,15,9,1028,508,0.625,520,0.6692708333333334
1988,1344,11,17,959,1179,0.39285714285714285,-220,0.44855004677268473
1988,1345,27,3,2292,235,0.9,2057,0.9070043529877325
1988,1347,14,14,1094,901,0.5,193,0.5483709273182957
1988,1348,25,6,2261,434,0.8064516129032258,1827,0.8389610389610389
1988,1349,4,21,311,1404,0.16,-1093,0.18134110787172011
1988,1350,24,6,1732,379,0.8,1353,0.8204642349597348
1988,1351,7,18,647,1313,0.28,-666,0.33010204081632655
1988,1352,11,14,807,910,0.44,-103,0.47000582411182296
1988,1353,7,22,554,1392,0.2413793103448276,-838,0.2846865364850976
1988,1354,12,13,894,865,0.48,29,0.5082433200682206
1988,1356,11,16,949,1311,0.4074074074074074,-362,0.41991150442477876
1988,1358,14,14,1050,857,0.5,193,0.5506030414263241
1988,1359,7,20,503,1322,0.25925925925925924,-819,0.2756164383561644
1988,1360,9,17,641,1123,0.34615384615384615,-482,0.3633786848072562
1988,1361,11,17,840,1053,0.39285714285714285,-213,0.4437400950871632
1988,1362,12,15,995,1064,0.4444444444444444,-69,0.4832442933462846
1988,1363,12,15,910,1014,0.4444444444444444,-104,0.47297297297297297
1988,1364,21,7,1541,459,0.75,1082,0.7705
1988,1365,19,10,1354,769,0.6551724137931034,585,0.6377767310409798
1988,1368,3,21,188,1186,0.125,-998,0.13682678311499272
1988,1371,20,12,1690,839,0.625,851,0.6682483194938711
1988,1372,10,18,728,1147,0.35714285714285715,-419,0.38826666666666665
1988,1373,22,5,1908,335,0.8148148148148148,1573,0.8506464556397682
1988,1374,27,6,2302,415,0.8181818181818182,1887,0.847258005152742
1988,1375,13,13,1147,960,0.5,187,0.5443758898908401
1988,1376,18,10,1467,642,0.6428571428571429,825,0.6955903271692745
1988,1378,6,21,452,1381,0.2222222222222222,-929,0.24659028914348063
1988,1379,17,10,1564,896,0.6296296296296297,668,0.6357723577235772
1988,1380,21,6,2047,476,0.7777777777777778,1571,0.8113357114546175
1988,1382,13,15,976,926,0.4642857142857143,50,0.5131440588853838
1988,1383,8,17,573,1027,0.32,-454,0.358125
1988,1384,4,20,326,1268,0.16666666666666666,-942,0.20451693851944794
1988,1385,17,11,1279,728,0.6071428571428571,551,0.6372695565520677
1988,1386,15,14,1072,916,0.5172413793103449,156,0.5392354124748491
1988,1387,14,14,1013,892,0.5,121,0.531758530183727
1988,1388,15,9,986,544,0.625,442,0.6444444444444445
1988,1389,18,9,1284,564,0.6666666666666666,720,0.6948051948051948
1988,1390,18,11,1469,793,0.6206896551724138,676,0.6494252873563219
1988,1391,11,15,918,1034,0.4230769230769231,-116,0.4702868852459016
1988,1393,24,8,2138,569,0.75,1569,0.7898042113040266
1988,1395,9,19,579,1090,0.32142857142857145,-511,0.3469143199520671
1988,1396,29,1,2270,58,0.9666666666666667,2212,0.9750859106529209
1988,1397,16,12,1248,784,0.5714285714285714,464,0.6141732283464567
1988,1398,9,17,689,1272,0.34615384615384615,-583,0.35135135135135137
1988,1399,8,16,640,1119,0.3333333333333333,-479,0.36384309266628767
1988,1400,16,13,1184,865,0.5517241379310345,319,0.577842850170815
1988,1401,16,14,1141,923,0.5333333333333333,218,0.5528100775193798
1988,1402,9,21,730,1504,0.3,-774,0.3267681289167413
1988,1403,8,19,571,1175,0.2962962962962963,-604,0.3270332187857961
1988,1405,14,12,1013,802,0.5384615384615384,211,0.5581267217630854
1988,1406,11,14,817,957,0.44,-140,0.4605411499436302
1988,1409,8,20,563,1305,0.2857142857142857,-742,0.3013918629550321
1988,1410,12,13,907,740,0.48,167,0.5506982392228293
1988,1411,19,8,1624,604,0.7037037037037037,1020,0.7289048473967684
1988,1412,15,15,1119,1047,0.5,72,0.5166204986149584
1988,1414,16,14,1318,1154,0.5333333333333333,164,0.5331715210355987
1988,1416,7,17,570,1264,0.2916666666666667,-694,0.3107960741548528
1988,1417,16,14,1377,1037,0.5333333333333333,340,0.5704225352112676
1988,1418,8,16,598,1147,0.3333333333333333,-549,0.34269340974212037
1988,1419,21,8,1679,510,0.7241379310344828,1169,0.7670169026952947
1988,1420,13,14,1077,983,0.48148148148148145,94,0.5228155339805826
1988,1421,10,15,750,1029,0.4,-279,0.42158516020236086
1988,1423,14,14,1008,848,0.5,160,0.5431034482758621
1988,1424,24,5,2028,352,0.8275862068965517,1676,0.8521008403361344
1988,1425,6,21,380,1291,0.2222222222222222,-911,0.22740873728306404
1988,1426,7,22,507,1476,0.2413793103448276,-969,0.2556732223903177
1988,1427,19,8,1559,568,0.7037037037037037,991,0.7329572167371885
1988,1428,18,10,1280,589,0.6428571428571429,691,0.6848582129481006
1988,1429,21,9,1768,747,0.7,1021,0.7029821073558649
1988,1431,21,9,1533,577,0.7,956,0.7265402843601896
1988,1433,20,11,1616,823,0.6451612903225806,793,0.6625666256662567
1988,1434,8,16,549,975,0.3333333333333333,-426,0.36023622047244097
1988,1435,18,10,1534,683,0.6428571428571429,851,0.6919260261614795
1988,1436,2,23,152,1606,0.08,-1454,0.08646188850967008
1988,1437,21,12,1569,804,0.6363636363636364,765,0.661188369152971
1988,1438,12,18,897,1109,0.4,-212,0.44715852442671983
1988,1439,19,10,1757,889,0.6551724137931034,868,0.6640211640211641
1988,1440,10,16,726,1061,0.38461538461538464,-335,0.4062674874090655
1988,1441,4,19,296,1303,0.17391304347826086,-1007,0.18511569731081925
1988,1442,11,12,833,808,0.4782608695652174,25,0.5076173065204144
1988,1443,13,13,977,895,0.5,82,0.5219017094017094
1988,1444,11,17,841,1240,0.39285714285714285,-399,0.40413262854396925
1988,1447,6,18,470,1172,0.25,-702,0.2862362971985384
1988,1448,10,18,769,1259,0.35714285714285715,-490,0.3791913214990138
1988,1449,10,19,753,1279,0.3448275862068966,-526,0.3705708661417323
1988,1450,13,16,844,917,0.4482758620689655,-73,0.4792731402612152
1988,1451,8,21,642,1370,0.27586206896551724,-728,0.3190854870775348
1988,1452,16,13,1171,870,0.5517241379310345,301,0.5737383635472807
1988,1453,16,9,1121,484,0.64,637,0.6984423676012461
1988,1455,19,9,1544,577,0.6785714285714286,967,0.727958510136728
1988,1456,8,19,615,1277,0.2962962962962963,-662,0.3250528541226216
1988,1457,13,13,893,764,0.5,129,0.5389257694628847
1988,1458,12,16,895,1038,0.42857142857142855,-143,0.463010863942059
1988,1460,14,11,1275,818,0.56,457,0.6091734352603918
1988,1461,25,5,1957,319,0.8333333333333334,1638,0.8598418277680141
1988,1462,24,3,2360,221,0.8888888888888888,2139,0.9143742735373886
1988,1463,12,14,942,872,0.46153846153846156,70,0.5192943770672547
1988,1464,6,21,375,1349,0.2222222222222222,-974,0.21751740139211137
1989,1102,10,14,700,943,0.4166666666666667,-243,0.426049908703591
1989,1103,21,7,1877,527,0.75,1350,0.7807820299500832
1989,1104,23,7,1794,477,0.7666666666666667,1317,0.7899603698811096
1989,1106,11,15,971,1244,0.4230769230769231,-273,0.4383747178329571
1989,1108,4,20,343,1263,0.16666666666666666,-920,0.21357409713574096
1989,1109,8,16,736,1326,0.3333333333333333,-590,0.3569350145489816
1989,1110,14,11,1169,779,0.56,390,0.6001026694045175
1989,1111,17,8,1282,585,0.68,697,0.6866630958757365
1989,1112,27,3,2303,230,0.9,2073,0.9091985787603633
1989,1113,12,16,1065,1162,0.42857142857142855,-97,0.4782218230803772
1989,1114,23,7,2185,597,0.7666666666666667,1588,0.7854061826024443
1989,1116,24,6,2228,437,0.8,1791,0.8360225140712946
1989,1117,17,9,1248,616,0.6538461538461539,632,0.6695278969957081
1989,1119,11,15,851,1046,0.4230769230769231,-195,0.448603057459146
1989,1120,9,19,760,1362,0.32142857142857145,-602,0.3581526861451461
1989,1121,3,22,276,1578,0.12,-1302,0.1488673139158576
1989,1122,15,12,1346,929,0.5555555555555556,417,0.5916483516483516
1989,1123,27,2,1974,103,0.9310344827586207,1871,0.9504092441020703
1989,1124,5,22,386,1357,0.18518518518518517,-971,0.2214572576018359
1989,1126,12,16,886,1039,0.42857142857142855,-153,0.46025974025974026
1989,1129,22,6,1503,348,0.7857142857142857,1155,0.8119935170178282
1989,1130,12,16,978,1066,0.42857142857142855,-88,0.47847358121330724
1989,1131,21,9,1699,622,0.7,1077,0.7320120637656182
1989,1132,10,16,712,979,0.38461538461538464,-267,0.42105263157894735
1989,1133,13,14,1115,1078,0.48148148148148145,37,0.5084359325125399
1989,1134,1,23,65,1451,0.041666666666666664,-1386,0.04287598944591029
1989,1135,5,19,387,1270,0.20833333333333334,-883,0.23355461677730838
1989,1137,20,7,1673,507,0.7407407407407407,1166,0.7674311926605505
1989,1139,11,17,832,1093,0.39285714285714285,-261,0.4322077922077922
1989,1140,14,15,1198,1140,0.4827586206896552,58,0.5124037639007699
1989,1141,11,16,815,1027,0.4074074074074074,-212,0.44245385450597174
1989,1143,19,12,1476,789,0.6129032258064516,687,0.6516556291390728
1989,1144,14,12,1008,806,0.5384615384615384,202,0.5556780595369349
1989,1145,12,15,886,955,0.4444444444444444,-69,0.4812601846822379
1989,1147,14,14,1213,1073,0.5,140,0.5306211723534558
1989,1148,6,18,453,1143,0.25,-690,0.28383458646616544
1989,1149,8,16,659,1132,0.3333333333333333,-473,0.36795086543830263
1989,1150,16,11,1235,823,0.5925925925925926,412,0.6000971817298348
1989,1151,17,12,1342,890,0.5862068965517241,452,0.6012544802867383
1989,1152,8,16,594,1099,0.3333333333333333,-505,0.35085646780862373
1989,1153,14,11,1128,779,0.56,349,0.5915049816465653
1989,1154,12,12,1008,826,0.5,182,0.549618320610687
1989,1155,18,10,1503,733,0.6428571428571429,770,0.6721824686940966
1989,1156,15,9,1358,689,0.625,669,0.6634098680996581
1989,1157,12,13,945,871,0.48,74,0.5203744493392071
1989,1159,6,21,412,1342,0.2222222222222222,-930,0.2348916761687571
1989,1160,7,21,559,1586,0.25,-1027,0.2606060606060606
1989,1161,21,9,1430,504,0.7,926,0.7394002068252327
1989,1162,6,18,436,1113,0.25,-677,0.2814719173660426
1989,1163,16,12,1232,804,0.5714285714285714,428,0.6051080550098232
1989,1164,18,11,1418,784,0.6206896551724138,634,0.6439600363306085
1989,1165,8,16,595,978,0.3333333333333333,-383,0.3782581055308328
1989,1166,20,10,1574,671,0.6666666666666666,903,0.7011135857461025
1989,1168,15,13,1149,854,0.5357142857142857,295,0.5736395406889665
1989,1171,17,9,1348,622,0.6538461538461539,726,0.6842639593908629
1989,1172,5,23,378,1434,0.17857142857142858,-1056,0.20860927152317882
1989,1173,12,17,935,1235,0.41379310344827586,-300,0.4308755760368664
1989,1174,10,14,779,959,0.4166666666666667,-180,0.4482163406214039
1989,1175,9,15,820,1180,0.375,-360,0.41
1989,1177,19,11,1606,737,0.6333333333333333,869,0.6854460093896714
1989,1178,7,21,589,1387,0.25,-798,0.2980769230769231
1989,1179,12,17,894,1111,0.41379310344827586,-217,0.4458852867830424
1989,1180,12,16,965,1213,0.42857142857142855,-248,0.4430670339761249
1989,1181,24,7,2190,514,0.7741935483870968,1676,0.8099112426035503
1989,1182,12,16,1080,1166,0.42857142857142855,-86,0.4808548530721282
1989,1183,13,16,1123,1178,0.4482758620689655,-55,0.48804867448935246
1989,1184,5,22,344,1391,0.18518518518518517,-1047,0.19827089337175793
1989,1185,13,13,1042,934,0.5,108,0.5273279352226721
1989,1186,6,21,467,1453,0.2222222222222222,-986,0.24322916666666666
1989,1187,13,14,961,893,0.48148148148148145,68,0.5183387270765911
1989,1190,16,10,1391,779,0.6153846153846154,612,0.6410138248847926
1989,1191,24,5,2037,356,0.8275862068965517,1681,0.8512327622231508
1989,1192,15,12,1176,774,0.5555555555555556,402,0.6030769230769231
1989,1193,6,21,441,1242,0.2222222222222222,-801,0.2620320855614973
1989,1196,20,12,1591,862,0.625,729,0.6485935589074603
1989,1197,16,10,1447,628,0.6153846153846154,819,0.6973493975903614
1989,1198,9,17,832,1346,0.34615384615384615,-514,0.3820018365472911
1989,1199,22,7,2105,562,0.7586206896551724,1543,0.7892763404574428
1989,1200,13,15,951,907,0.4642857142857143,44,0.5118406889128094
1989,1201,15,14,1095,843,0.5172413793103449,252,0.565015479876161
1989,1202,14,11,1083,752,0.56,331,0.5901907356948229
1989,1203,1,27,103,1816,0.03571428571428571,-1713,0.053673788431474724
1989,1204,23,5,1822,349,0.8214285714285714,1473,0.8392445877475817
1989,1206,19,10,1543,678,0.6551724137931034,865,0.694732102656461
1989,1207,22,4,1709,316,0.8461538461538461,1393,0.8439506172839506
1989,1208,15,16,1213,1158,0.4838709677419355,55,0.5115984816533108
1989,1209,10,14,828,1158,0.4166666666666667,-330,0.4169184290030212
1989,1210,20,11,1695,801,0.6451612903225806,894,0.6790865384615384
1989,1211,10,14,755,1006,0.4166666666666667,-251,0.4287336740488359
1989,1212,13,13,1069,936,0.5,133,0.5331670822942643
1989,1215,4,19,242,1229,0.17391304347826086,-987,0.16451393609789258
1989,1216,15,13,1028,831,0.5357142857142857,197,0.5529854760623991
1989,1217,9,15,716,1006,0.375,-290,0.41579558652729387
1989,1218,17,12,1316,763,0.5862068965517241,553,0.632996632996633
1989,1220,14,14,1009,909,0.5,100,0.5260688216892596
1989,1221,12,15,1061,1135,0.4444444444444444,-74,0.4831511839708561
1989,1222,17,14,1425,1013,0.5483870967741935,412,0.5844954881050041
1989,1223,8,19,655,1227,0.2962962962962963,-572,0.3480340063761955
1989,1224,6,18,444,1126,0.25,-682,0.28280254777070063
1989,1225,21,5,1648,333,0.8076923076923077,1315,0.8319030792529025
1989,1226,6,18,445,1122,0.25,-677,0.2839821314613912
1989,1227,12,17,1031,1252,0.41379310344827586,-221,0.451598773543583
1989,1228,26,4,2354,268,0.8666666666666667,2086,0.8977879481311976
1989,1229,13,17,962,979,0.43333333333333335,-17,0.49562081401339514
1989,1231,25,7,1969,522,0.78125,1447,0.7904456041750301
1989,1232,3,24,255,1685,0.1111111111111111,-1430,0.13144329896907217
1989,1233,14,15,1049,988,0.4827586206896552,61,0.5149729995090819
1989,1234,22,8,1995,690,0.7333333333333333,1305,0.7430167597765364
1989,1235,17,11,1546,892,0.6071428571428571,654,0.6341263330598852
1989,1238,12,13,922,962,0.48,-40,0.4893842887473461
1989,1239,12,16,1023,1217,0.42857142857142855,-194,0.45669642857142856
1989,1241,13,14,1049,928,0.48148148148148145,121,0.5306019221041983
1989,1242,16,12,1505,949,0.5714285714285714,556,0.6132844335778321
1989,1243,17,10,1370,719,0.6296296296296297,651,0.6558161799904261
1989,1245,20,10,1586,646,0.6666666666666666,940,0.7105734767025089
1989,1246,13,19,985,1235,0.40625,-250,0.4436936936936937
1989,1247,26,5,2213,359,0.8387096774193549,1854,0.8604199066874028
1989,1248,19,10,1341,610,0.6551724137931034,731,0.6873398257303946
1989,1249,10,16,765,1231,0.38461538461538464,-466,0.3832665330661323
1989,1250,9,18,784,1260,0.3333333333333333,-476,0.3835616438356164
1989,1251,8,17,598,1182,0.32,-584,0.3359550561797753
1989,1253,13,15,953,980,0.4642857142857143,-27,0.49301603724780135
1989,1254,8,19,643,1344,0.2962962962962963,-701,0.3236034222445898
1989,1256,22,8,1835,586,0.7333333333333333,1249,0.7579512598099959
1989,1257,22,8,1888,588,0.7333333333333333,1300,0.7625201938610663
1989,1258,19,10,2229,992,0.6551724137931034,1237,0.6920211114560696
1989,1259,8,18,759,1317,0.3076923076923077,-558,0.36560693641618497
1989,1260,11,17,957,1408,0.39285714285714285,-451,0.4046511627906977
1989,1261,18,11,1677,994,0.6206896551724138,683,0.6278547360539124
1989,1263,9,18,633,1106,0.3333333333333333,-473,0.36400230017251295
1989,1264,7,20,532,1155,0.25925925925925924,-623,0.3153526970954357
1989,1265,11,15,929,1101,0.4230769230769231,-172,0.4576354679802956
1989,1266,12,15,951,1043,0.4444444444444444,-92,0.4769307923771314
1989,1267,14,15,1270,1138,0.4827586206896552,132,0.5274086378737541
1989,1268,9,20,708,1288,0.3103448275862069,-580,0.35470941883767537
1989,1269,8,17,674,1259,0.32,-585,0.3486808070356958
1989,1270,16,13,1191,951,0.5517241379310345,240,0.5560224089635855
1989,1271,1,26,80,1923,0.037037037037037035,-1843,0.0399400898652022
1989,1272,20,10,1622,770,0.6666666666666666,852,0.6780936454849499
1989,1273,11,14,880,950,0.44,-70,0.4808743169398907
1989,1274,17,12,1629,994,0.5862068965517241,635,0.6210446054136485
1989,1275,13,15,947,1024,0.4642857142857143,-77,0.480466768138001
1989,1276,21,6,2010,450,0.7777777777777778,1560,0.8170731707317073
1989,1277,15,13,1229,837,0.5357142857142857,392,0.5948693126815101
1989,1278,16,11,1330,696,0.5925925925925926,634,0.6564659427443238
1989,1279,14,14,1153,953,0.5,200,0.5474833808167141
1989,1280,13,15,1041,1027,0.4642857142857143,14,0.503384912959381
1989,1281,26,7,2332,554,0.7878787878787878,1778,0.808038808038808
1989,1283,20,9,1435,583,0.6896551724137931,852,0.7111000991080277
1989,1284,13,13,1031,897,0.5,134,0.5347510373443983
1989,1285,16,11,1225,731,0.5925925925925926,494,0.626278118609407
1989,1286,11,15,933,1012,0.4230769230769231,-79,0.47969151670951155
1989,1287,11,15,973,1024,0.4230769230769231,-51,0.4872308462694041
1989,1288,14,13,1100,904,0.5185185185185185,196,0.5489021956087824
1989,1290,6,20,504,1412,0.23076923076923078,-908,0.2630480167014614
1989,1291,10,15,907,1085,0.4,-178,0.45532128514056225
1989,1292,20,7,1843,546,0.7407407407407407,1297,0.7714524905818334
1989,1293,17,10,1368,679,0.6296296296296297,689,0.668295065950171
1989,1296,9,17,729,1299,0.34615384615384615,-570,0.3594674556213018
1989,1298,6,22,476,1360,0.21428571428571427,-884,0.25925925925925924
1989,1299,7,16,631,1095,0.30434782608695654,-464,0.36558516801853996
1989,1301,20,8,1825,552,0.7142857142857143,1273,0.7677745056794278
1989,1304,15,15,1196,1098,0.5,98,0.5213600697471665
1989,1305,15,12,1452,972,0.5555555555555556,480,0.599009900990099
1989,1306,4,22,344,1512,0.15384615384615385,-1168,0.1853448275862069
1989,1307,19,10,1612,676,0.6551724137931034,936,0.7045454545454546
1989,1308,19,10,1375,638,0.6551724137931034,737,0.6830601092896175
1989,1309,19,10,1410,595,0.6551724137931034,815,0.7032418952618454
1989,1310,9,19,681,1200,0.32142857142857145,-519,0.3620414673046252
1989,1311,8,16,610,1068,0.3333333333333333,-458,0.3635280095351609
1989,1314,27,7,2472,591,0.7941176470588235,1881,0.8070519098922625
1989,1317,14,15,1118,1165,0.4827586206896552,-47,0.489706526500219
1989,1318,17,11,1433,797,0.6071428571428571,636,0.6426008968609865
1989,1319,2,25,113,1515,0.07407407407407407,-1402,0.06941031941031942
1989,1320,16,9,1440,658,0.64,782,0.6863679694947569
1989,1321,7,19,590,1287,0.2692307692307692,-697,0.3143313798614811
1989,1322,13,16,1154,1397,0.4482758620689655,-243,0.4523716189729518
1989,1323,20,8,1562,609,0.7142857142857143,953,0.7194841087056656
1989,1325,11,17,895,1225,0.39285714285714285,-330,0.4221698113207547
1989,1326,17,14,1511,968,0.5483870967741935,543,0.6095199677289229
1989,1328,28,5,2990,414,0.8484848484848485,2576,0.8783783783783784
1989,1329,15,12,1316,947,0.5555555555555556,369,0.5815289438798056
1989,1330,14,13,1194,1024,0.5185185185185185,170,0.5383228133453561
1989,1331,8,20,792,1631,0.2857142857142857,-839,0.32686751960379695
1989,1332,7,21,491,1370,0.25,-879,0.26383664696399783
1989,1333,22,7,1768,455,0.7586206896551724,1313,0.7953216374269005
1989,1334,5,21,415,1436,0.19230769230769232,-1021,0.22420313344138304
1989,1335,13,13,926,800,0.5,126,0.5365005793742758
1989,1336,18,11,1491,747,0.6206896551724138,744,0.6662198391420912
1989,1337,19,12,1548,869,0.6129032258064516,679,0.6404633843607779
1989,1338,17,12,1425,879,0.5862068965517241,546,0.6184895833333334
1989,1339,2,25,144,1521,0.07407407407407407,-1377,0.08648648648648649
1989,1341,9,16,685,1127,0.36,-442,0.3780353200883002
1989,1343,17,7,1034,350,0.7083333333333334,684,0.7471098265895953
1989,1344,18,10,1602,774,0.6428571428571429,828,0.6742424242424242
1989,1345,15,16,1171,1104,0.4838709677419355,67,0.5147252747252747
1989,1347,11,13,925,907,0.4583333333333333,18,0.5049126637554585
1989,1348,12,15,984,1078,0.4444444444444444,-94,0.4772065955383123
1989,1349,11,16,881,1046,0.4074074074074074,-165,0.4571873378308251
1989,1350,20,9,1480,556,0.6896551724137931,924,0.7269155206286837
1989,1351,4,21,307,1459,0.16,-1152,0.1738391845979615
1989,1352,19,8,1467,622,0.7037037037037037,845,0.7022498803255146
1989,1353,18,12,1457,854,0.6,603,0.6304630030289918
1989,1354,24,7,2040,499,0.7741935483870968,1541,0.8034659314690823
1989,1356,19,13,1507,1011,0.59375,496,0.5984908657664814
1989,1358,12,16,990,1173,0.42857142857142855,-183,0.4576976421636616
1989,1359,7,17,535,1029,0.2916666666666667,-494,0.3420716112531969
1989,1360,6,20,407,1314,0.23076923076923078,-907,0.23649041255084252
1989,1361,12,17,985,1145,0.41379310344827586,-160,0.4624413145539906
1989,1362,14,12,1085,821,0.5384615384615384,264,0.5692549842602308
1989,1363,4,23,334,1401,0.14814814814814814,-1067,0.192507204610951
1989,1364,21,8,1586,541,0.7241379310344828,1045,0.7456511518570756
1989,1365,19,10,1339,630,0.6551724137931034,709,0.6800406297613002
1989,1368,2,22,138,1277,0.08333333333333333,-1139,0.09752650176678446
1989,1371,25,6,2072,444,0.8064516129032258,1628,0.8235294117647058
1989,1372,10,18,706,1245,0.35714285714285715,-539,0.3618657098923629
1989,1373,23,4,2012,303,0.8518518518518519,1709,0.8691144708423326
1989,1374,12,16,850,1110,0.42857142857142855,-260,0.4336734693877551
1989,1375,21,8,1970,685,0.7241379310344828,1285,0.7419962335216572
1989,1376,18,10,1447,665,0.6428571428571429,782,0.6851325757575758
1989,1378,6,21,522,1513,0.2222222222222222,-991,0.2565110565110565
1989,1379,10,17,864,1261,0.37037037037037035,-397,0.40658823529411764
1989,1380,16,10,1584,911,0.6153846153846154,673,0.6348697394789579
1989,1381,8,18,679,1228,0.3076923076923077,-549,0.35605663345568955
1989,1382,13,15,966,1014,0.4642857142857143,-48,0.48787878787878786
1989,1383,9,16,683,1172,0.36,-489,0.3681940700808625
1989,1384,11,16,969,1161,0.4074074074074074,-192,0.45492957746478874
1989,1385,15,13,1096,859,0.5357142857142857,237,0.560613810741688
1989,1386,8,21,638,1323,0.27586206896551724,-685,0.325344212136665
1989,1387,22,9,1720,600,0.7096774193548387,1120,0.7413793103448276
1989,1388,23,4,1783,240,0.8518518518518519,1543,0.8813643104300544
1989,1389,22,7,1569,440,0.7586206896551724,1129,0.7809855649576904
1989,1390,26,6,2054,386,0.8125,1668,0.8418032786885246
1989,1391,17,12,1410,855,0.5862068965517241,555,0.6225165562913907
1989,1393,26,7,2470,494,0.7878787878787878,1976,0.8333333333333334
1989,1395,16,13,1066,905,0.5517241379310345,161,0.5408422120750888
1989,1396,18,11,1413,684,0.6206896551724138,729,0.6738197424892703
1989,1397,19,10,1673,779,0.6551724137931034,894,0.682300163132137
1989,1398,3,22,232,1523,0.12,-1291,0.1321937321937322
1989,1399,6,20,419,1519,0.23076923076923078,-1100,0.21620227038183695
1989,1400,24,8,2347,693,0.75,1654,0.7720394736842106
1989,1401,15,14,1179,1000,0.5172413793103449,179,0.5410738871041763
1989,1402,12,17,938,1196,0.41379310344827586,-258,0.4395501405810684
1989,1403,12,15,870,999,0.4444444444444444,-129,0.4654895666131621
1989,1405,14,15,1021,926,0.4827586206896552,95,0.5243965074473549
1989,1406,17,10,1500,724,0.6296296296296297,776,0.6744604316546763
1989,1409,17,13,1181,842,0.5666666666666667,339,0.5837864557587741
1989,1410,11,13,797,842,0.4583333333333333,-45,0.4862721171446004
1989,1411,15,12,1315,900,0.5555555555555556,415,0.5936794582392777
1989,1412,17,11,1465,903,0.6071428571428571,562,0.6186655405405406
1989,1414,12,17,1023,1342,0.41379310344827586,-319,0.4325581395348837
1989,1416,4,19,300,1395,0.17391304347826086,-1095,0.17699115044247787
1989,1417,20,9,1640,711,0.6896551724137931,929,0.6975754997873246
1989,1418,14,12,1206,965,0.5384615384615384,241,0.5555043758636573
1989,1419,17,12,1358,785,0.5862068965517241,573,0.6336910872608493
1989,1420,13,11,1033,765,0.5416666666666666,268,0.5745272525027809
1989,1421,12,14,1030,955,0.46153846153846156,75,0.5188916876574308
1989,1423,16,14,1175,916,0.5333333333333333,259,0.5619320899091343
1989,1424,26,7,2278,595,0.7878787878787878,1683,0.7928994082840237
1989,1425,9,22,754,1472,0.2903225806451613,-718,0.3387241689128482
1989,1426,7,21,536,1322,0.25,-786,0.2884822389666308
1989,1427,11,13,923,953,0.4583333333333333,-30,0.4920042643923241
1989,1428,15,17,1216,1060,0.46875,156,0.5342706502636204
1989,1429,12,16,1019,1150,0.42857142857142855,-131,0.4698017519594283
1989,1431,24,6,1904,421,0.8,1483,0.8189247311827957
1989,1433,13,15,1107,1108,0.4642857142857143,-1,0.4997742663656885
1989,1434,9,19,682,1285,0.32142857142857145,-603,0.3467208947635994
1989,1435,18,13,1455,930,0.5806451612903226,525,0.610062893081761
1989,1436,5,20,344,1338,0.2,-994,0.20451843043995244
1989,1437,15,15,1136,998,0.5,138,0.5323336457357076
1989,1438,19,10,1664,685,0.6551724137931034,979,0.7083865474670072
1989,1439,10,17,921,1419,0.37037037037037035,-498,0.3935897435897436
1989,1440,7,17,508,1285,0.2916666666666667,-777,0.2833240379252649
1989,1441,9,15,690,994,0.375,-304,0.40973871733966744
1989,1442,7,19,485,1216,0.2692307692307692,-731,0.28512639623750735
1989,1443,14,15,1134,1070,0.4827586206896552,64,0.514519056261343
1989,1444,9,16,729,1034,0.36,-305,0.41349971639251276
1989,1447,9,16,752,1122,0.36,-370,0.4012806830309498
1989,1448,13,15,1000,1135,0.4642857142857143,-135,0.468384074941452
1989,1449,12,16,971,1146,0.42857142857142855,-175,0.4586679263108172
1989,1450,10,19,743,1110,0.3448275862068966,-367,0.4009713977334053
1989,1451,14,11,1108,735,0.56,373,0.6011937059142702
1989,1452,25,4,2030,255,0.8620689655172413,1775,0.888402625820569
1989,1453,11,14,819,880,0.44,-61,0.4820482636845203
1989,1455,18,10,1513,673,0.6428571428571429,840,0.692131747483989
1989,1456,4,22,293,1417,0.15384615384615385,-1124,0.17134502923976608
1989,1457,12,13,868,818,0.48,50,0.5148279952550415
1989,1458,15,11,1063,729,0.5769230769230769,334,0.5931919642857143
1989,1460,13,11,1121,817,0.5416666666666666,304,0.5784313725490197
1989,1461,14,17,1123,1134,0.45161290322580644,-11,0.49756313690739923
1989,1462,20,11,1726,810,0.6451612903225806,916,0.6805993690851735
1989,1463,9,17,710,1098,0.34615384615384615,-388,0.3926991150442478
1989,1464,3,21,231,1546,0.125,-1315,0.12999437253798538
1990,1102,9,19,665,1119,0.32142857142857145,-454,0.3727578475336323
1990,1103,14,12,1064,812,0.5384615384615384,252,0.5671641791044776
1990,1104,24,8,1751,549,0.75,1202,0.7613043478260869
1990,1106,13,12,1202,1054,0.52,148,0.5328014184397163
1990,1108,7,18,584,1285,0.28,-701,0.3124665596575709
1990,1109,8,16,808,1494,0.3333333333333333,-686,0.3509991311902693
1990,1110,18,9,1259,593,0.6666666666666666,666,0.6798056155507559
1990,1111,17,11,1425,876,0.6071428571428571,549,0.6192959582790091
1990,1112,24,6,1944,446,0.8,1498,0.8133891213389122
1990,1113,14,15,959,921,0.4827586206896552,38,0.5101063829787233
1990,1114,20,9,1787,747,0.6896551724137931,1040,0.7052091554853985
1990,1116,26,4,2587,337,0.8666666666666667,2250,0.8847469220246238
1990,1117,15,13,1227,868,0.5357142857142857,359,0.5856801909307876
1990,1119,9,19,633,1300,0.32142857142857145,-667,0.3274702534919814
1990,1120,13,17,1081,1245,0.43333333333333335,-164,0.4647463456577816
1990,1121,6,18,450,1222,0.25,-772,0.26913875598086123
1990,1122,9,18,707,1169,0.3333333333333333,-462,0.376865671641791
1990,1123,22,6,1659,336,0.7857142857142857,1323,0.8315789473684211
1990,1124,16,13,1265,936,0.5517241379310345,329,0.574738755111313
1990,1126,10,18,834,1351,0.35714285714285715,-517,0.3816933638443936
1990,1129,11,15,664,782,0.4230769230769231,-118,0.45919778699861685
1990,1130,8,20,714,1312,0.2857142857142857,-598,0.35241855873642647
1990,1131,18,11,1358,759,0.6206896551724138,599,0.6414737836561172
1990,1132,16,10,1330,677,0.6153846153846154,653,0.6626806178375685
1990,1133,10,20,783,1388,0.3333333333333333,-605,0.3606632888070014
1990,1134,4,20,313,1396,0.16666666666666666,-1083,0.1831480397893505
1990,1135,8,15,583,909,0.34782608695652173,-326,0.39075067024128685
1990,1137,12,14,954,1010,0.46153846153846156,-56,0.48574338085539714
1990,1139,6,22,436,1330,0.21428571428571427,-894,0.24688561721404303
1990,1140,21,8,1550,511,0.7241379310344828,1039,0.7520621057738962
1990,1141,12,17,906,1084,0.41379310344827586,-178,0.4552763819095477
1990,1143,20,9,1584,629,0.6896551724137931,955,0.7157704473565296
1990,1144,13,12,983,749,0.52,234,0.5675519630484989
1990,1145,10,18,692,1213,0.35714285714285715,-521,0.363254593175853
1990,1147,19,8,1890,639,0.7037037037037037,1251,0.7473309608540926
1990,1148,3,21,233,1317,0.125,-1084,0.1503225806451613
1990,1149,7,17,566,1079,0.2916666666666667,-513,0.34407294832826746
1990,1150,16,14,1339,1022,0.5333333333333333,317,0.5671325709445151
1990,1151,12,14,931,1035,0.46153846153846156,-104,0.4735503560528993
1990,1152,4,22,304,1443,0.15384615384615385,-1139,0.17401259301659988
1990,1153,19,13,1419,917,0.59375,502,0.6074486301369864
1990,1154,9,15,723,1060,0.375,-337,0.40549635445877735
1990,1155,23,8,1968,524,0.7419354838709677,1444,0.7897271268057785
1990,1156,13,12,1123,945,0.52,178,0.543036750483559
1990,1157,20,5,1560,352,0.8,1208,0.8158995815899581
1990,1159,7,21,565,1472,0.25,-907,0.2773686794305351
1990,1160,11,18,969,1376,0.3793103448275862,-407,0.41321961620469083
1990,1161,20,8,1454,433,0.7142857142857143,1021,0.7705352411234764
1990,1162,4,22,293,1415,0.15384615384615385,-1122,0.1715456674473068
1990,1163,27,5,2177,350,0.84375,1827,0.8614958448753463
1990,1164,23,5,1800,330,0.8214285714285714,1470,0.8450704225352113
1990,1165,10,16,778,1001,0.38461538461538464,-223,0.43732433951658234
1990,1166,21,11,1771,754,0.65625,1017,0.7013861386138613
1990,1168,11,16,931,1104,0.4074074074074074,-173,0.4574938574938575
1990,1171,12,14,879,837,0.46153846153846156,42,0.5122377622377622
1990,1172,1,24,83,1459,0.04,-1376,0.05382619974059663
1990,1173,21,9,1916,781,0.7,1135,0.710418984056359
1990,1174,12,13,903,885,0.48,18,0.5050335570469798
1990,1175,14,14,1252,1094,0.5,158,0.5336743393009378
1990,1177,18,14,1235,890,0.5625,345,0.5811764705882353
1990,1178,10,18,844,1228,0.35714285714285715,-384,0.40733590733590735
1990,1179,13,18,975,1271,0.41935483870967744,-296,0.43410507569011575
1990,1180,13,15,1069,1076,0.4642857142857143,-7,0.4983682983682984
1990,1181,24,8,2266,624,0.75,1642,0.784083044982699
1990,1182,7,22,575,1461,0.2413793103448276,-886,0.2824165029469548
1990,1183,9,18,691,1143,0.3333333333333333,-452,0.3767720828789531
1990,1184,10,17,714,1046,0.37037037037037035,-332,0.4056818181818182
1990,1185,17,13,1355,866,0.5666666666666667,489,0.610085547050878
1990,1186,17,11,1388,736,0.6071428571428571,652,0.6534839924670434
1990,1187,11,17,782,996,0.39285714285714285,-214,0.4398200224971879
1990,1190,23,6,2062,468,0.7931034482758621,1594,0.8150197628458498
1990,1191,16,15,1199,949,0.5161290322580645,250,0.5581936685288641
1990,1192,15,13,1129,904,0.5357142857142857,225,0.5553369404820462
1990,1193,10,19,579,1093,0.3448275862068966,-514,0.34629186602870815
1990,1196,7,21,582,1304,0.25,-722,0.30858960763520676
1990,1197,17,11,1433,716,0.6071428571428571,717,0.6668217775709633
1990,1198,6,20,469,1466,0.23076923076923078,-997,0.24237726098191215
1990,1199,15,15,1285,1017,0.5,268,0.5582102519548219
1990,1200,19,12,1482,811,0.6129032258064516,671,0.6463148713475796
1990,1201,10,18,690,1160,0.35714285714285715,-470,0.372972972972973
1990,1202,11,16,919,1140,0.4074074074074074,-221,0.4463331714424478
1990,1203,14,16,1179,1121,0.4666666666666667,58,0.5126086956521739
1990,1204,17,11,1409,804,0.6071428571428571,605,0.6366922729326706
1990,1206,18,12,1341,882,0.6,459,0.6032388663967612
1990,1207,19,6,1556,440,0.76,1116,0.779559118236473
1990,1208,20,8,1722,589,0.7142857142857143,1133,0.7451319774989182
1990,1209,3,23,205,1701,0.11538461538461539,-1496,0.10755508919202518
1990,1210,24,6,2152,496,0.8,1656,0.8126888217522659
1990,1211,4,20,269,1327,0.16666666666666666,-1058,0.16854636591478697
1990,1212,7,19,604,1442,0.2692307692307692,-838,0.29521016617790813
1990,1215,6,19,424,1353,0.24,-929,0.2386043894203714
1990,1216,17,11,1236,696,0.6071428571428571,540,0.639751552795031
1990,1217,10,14,836,1019,0.4166666666666667,-183,0.45067385444743935
1990,1218,21,9,1607,587,0.7,1020,0.7324521422060164
1990,1220,12,15,882,947,0.4444444444444444,-65,0.4822307271733188
1990,1221,23,5,1977,416,0.8214285714285714,1561,0.8261596322607605
1990,1222,24,7,2003,507,0.7741935483870968,1496,0.7980079681274901
1990,1224,8,20,633,1297,0.2857142857142857,-664,0.327979274611399
1990,1225,22,5,1723,345,0.8148148148148148,1378,0.8331721470019342
1990,1226,4,21,328,1342,0.16,-1014,0.19640718562874251
1990,1227,14,12,1021,746,0.5384615384615384,275,0.577815506508206
1990,1228,20,7,1685,501,0.7407407407407407,1184,0.7708142726440989
1990,1229,18,12,1360,805,0.6,555,0.628175519630485
1990,1231,18,10,1526,676,0.6428571428571429,850,0.6930063578564941
1990,1232,7,20,454,1189,0.25925925925925924,-735,0.27632379793061473
1990,1233,13,15,892,881,0.4642857142857143,11,0.503102086858432
1990,1234,12,16,907,1205,0.42857142857142855,-298,0.42945075757575757
1990,1235,10,18,951,1436,0.35714285714285715,-485,0.3984080435693339
1990,1238,6,19,473,1458,0.24,-985,0.24495080269290523
1990,1239,13,16,1056,1162,0.4482758620689655,-106,0.47610459873760147
1990,1241,20,10,1551,729,0.6666666666666666,822,0.6802631578947368
1990,1242,27,4,2526,313,0.8709677419354839,2213,0.8897499119408242
1990,1243,17,14,1316,920,0.5483870967741935,396,0.5885509838998211
1990,1245,20,7,1526,445,0.7407407407407407,1081,0.7742262810755961
1990,1246,14,14,1309,1179,0.5,130,0.5261254019292605
1990,1247,29,1,2484,116,0.9666666666666667,2368,0.9553846153846154
1990,1248,14,13,1073,804,0.5185185185185185,269,0.5716568993074055
1990,1249,6,21,421,1446,0.2222222222222222,-1025,0.225495447241564
1990,1250,16,12,1322,808,0.5714285714285714,514,0.6206572769953052
1990,1251,8,16,603,1118,0.3333333333333333,-515,0.35037768739105174
1990,1253,22,8,1797,588,0.7333333333333333,1209,0.7534591194968554
1990,1254,2,23,158,1743,0.08,-1585,0.08311415044713309
1990,1256,20,7,1626,534,0.7407407407407407,1092,0.7527777777777778
1990,1257,25,7,2178,528,0.78125,1650,0.8048780487804879
1990,1258,23,5,2906,589,0.8214285714285714,2317,0.8314735336194564
1990,1259,3,24,204,1561,0.1111111111111111,-1357,0.11558073654390935
1990,1260,7,22,496,1403,0.2413793103448276,-907,0.2611901000526593
1990,1261,21,8,2049,629,0.7241379310344828,1420,0.7651232262882748
1990,1263,11,17,837,1062,0.39285714285714285,-225,0.44075829383886256
1990,1264,11,17,805,1103,0.39285714285714285,-298,0.4219077568134172
1990,1265,16,11,1225,738,0.5925925925925926,487,0.6240448293428426
1990,1266,15,13,1180,895,0.5357142857142857,285,0.5686746987951807
1990,1267,13,13,1018,917,0.5,101,0.5260981912144703
1990,1268,17,13,1518,962,0.5666666666666667,556,0.6120967741935484
1990,1269,17,12,1321,843,0.5862068965517241,478,0.6104436229205176
1990,1270,14,13,1048,802,0.5185185185185185,246,0.5664864864864865
1990,1271,9,15,699,1140,0.375,-441,0.3800978792822186
1990,1272,18,11,1498,797,0.6206896551724138,701,0.6527233115468409
1990,1273,5,20,331,1200,0.2,-869,0.2161985630306989
1990,1274,13,15,1057,957,0.4642857142857143,100,0.5248262164846077
1990,1275,14,15,1230,1038,0.4827586206896552,192,0.5423280423280423
1990,1276,21,7,1875,499,0.75,1376,0.7898062342038753
1990,1277,26,5,2038,337,0.8387096774193549,1701,0.8581052631578947
1990,1278,20,8,1741,601,0.7142857142857143,1140,0.7433817250213492
1990,1279,13,16,1027,1175,0.4482758620689655,-148,0.466394187102634
1990,1280,14,13,1171,917,0.5185185185185185,254,0.560823754789272
1990,1281,23,5,2007,396,0.8214285714285714,1611,0.8352059925093633
1990,1282,10,15,877,1029,0.4,-152,0.4601259181532004
1990,1283,22,6,1758,401,0.7857142857142857,1357,0.8142658638258453
1990,1284,17,12,1211,733,0.5862068965517241,478,0.6229423868312757
1990,1285,15,11,1147,665,0.5769230769230769,482,0.6330022075055187
1990,1286,15,12,1183,855,0.5555555555555556,328,0.5804710500490677
1990,1287,14,13,1157,930,0.5185185185185185,227,0.5543842836607571
1990,1288,7,19,596,1358,0.2692307692307692,-762,0.30501535312180145
1990,1290,9,17,855,1294,0.34615384615384615,-439,0.39785946952070733
1990,1291,16,12,1333,828,0.5714285714285714,505,0.6168440536788524
1990,1292,10,15,871,1037,0.4,-166,0.45649895178197064
1990,1293,19,8,1414,579,0.7037037037037037,835,0.7094831911690919
1990,1296,16,11,1048,630,0.5925925925925926,418,0.6245530393325387
1990,1298,5,23,362,1540,0.17857142857142858,-1178,0.19032597266035753
1990,1299,10,16,796,1100,0.38461538461538464,-304,0.41983122362869196
1990,1301,18,12,1498,972,0.6,526,0.6064777327935222
1990,1304,10,18,928,1331,0.35714285714285715,-403,0.41080123948649844
1990,1305,14,13,1113,951,0.5185185185185185,162,0.5392441860465116
1990,1306,5,23,336,1367,0.17857142857142858,-1031,0.19729888432178508
1990,1307,16,12,1263,832,0.5714285714285714,431,0.6028639618138425
1990,1308,24,4,1928,299,0.8571428571428571,1629,0.8657386618769646
1990,1309,18,10,1371,617,0.6428571428571429,754,0.6896378269617707
1990,1310,6,22,441,1474,0.21428571428571427,-1033,0.23028720626631854
1990,1311,2,22,150,1503,0.08333333333333333,-1353,0.09074410163339383
1990,1314,19,12,1643,930,0.6129032258064516,713,0.6385542168674698
1990,1317,5,25,390,1786,0.16666666666666666,-1396,0.1792279411764706
1990,1318,15,12,1218,847,0.5555555555555556,371,0.5898305084745763
1990,1319,5,20,341,1250,0.2,-909,0.2143306096794469
1990,1320,20,8,1616,516,0.7142857142857143,1100,0.7579737335834896
1990,1321,7,19,616,1389,0.2692307692307692,-773,0.30723192019950124
1990,1322,10,19,948,1337,0.3448275862068966,-389,0.4148796498905908
1990,1323,16,12,1368,868,0.5714285714285714,500,0.6118067978533095
1990,1325,11,16,789,1080,0.4074074074074074,-291,0.42215088282504015
1990,1326,16,12,1299,820,0.5714285714285714,479,0.6130250117980179
1990,1328,23,4,2423,289,0.8518518518518519,2134,0.8934365781710915
1990,1329,15,13,1259,1017,0.5357142857142857,242,0.5531634446397188
1990,1330,14,14,1173,1005,0.5,168,0.5385674931129476
1990,1332,15,13,1129,861,0.5357142857142857,268,0.5673366834170854
1990,1333,22,6,1762,457,0.7857142857142857,1305,0.7940513744930149
1990,1334,13,14,888,927,0.48148148148148145,-39,0.48925619834710743
1990,1335,12,14,900,937,0.46153846153846156,-37,0.4899292324442025
1990,1336,20,8,1472,467,0.7142857142857143,1005,0.7591542031975245
1990,1337,16,11,1454,817,0.5925925925925926,637,0.6402465874064289
1990,1338,12,17,1130,1297,0.41379310344827586,-167,0.46559538524927896
1990,1339,10,17,738,1176,0.37037037037037035,-438,0.38557993730407525
1990,1341,6,18,452,1313,0.25,-861,0.25609065155807365
1990,1343,18,6,1161,326,0.75,835,0.7807666442501682
1990,1344,17,11,1456,893,0.6071428571428571,563,0.6198382290336313
1990,1345,21,7,1537,471,0.75,1066,0.7654382470119522
1990,1347,6,19,435,1269,0.24,-834,0.25528169014084506
1990,1348,14,13,1139,937,0.5185185185185185,202,0.5486512524084779
1990,1349,10,17,723,1263,0.37037037037037035,-540,0.3640483383685801
1990,1350,22,9,1645,549,0.7096774193548387,1096,0.7497721057429353
1990,1351,10,17,770,1093,0.37037037037037035,-323,0.4133118625872249
1990,1352,21,7,1660,470,0.75,1190,0.7793427230046949
1990,1353,15,16,1188,1136,0.4838709677419355,52,0.5111876075731497
1990,1354,10,15,817,1083,0.4,-266,0.43
1990,1356,24,7,1965,516,0.7741935483870968,1449,0.7920193470374849
1990,1358,10,18,843,1321,0.35714285714285715,-478,0.38955637707948243
1990,1359,5,21,377,1521,0.19230769230769232,-1144,0.19863013698630136
1990,1360,15,12,1194,940,0.5555555555555556,254,0.5595126522961574
1990,1361,11,18,823,1034,0.3793103448275862,-211,0.44318793753365643
1990,1362,8,20,639,1467,0.2857142857142857,-828,0.3034188034188034
1990,1363,8,20,559,1370,0.2857142857142857,-811,0.2897874546397097
1990,1364,20,8,1555,584,0.7142857142857143,971,0.7269752220663862
1990,1365,8,19,568,1214,0.2962962962962963,-646,0.31874298540965207
1990,1371,11,16,841,1067,0.4074074074074074,-226,0.44077568134171907
1990,1372,2,25,144,1699,0.07407407407407407,-1555,0.0781334780249593
1990,1373,15,13,1180,1002,0.5357142857142857,178,0.5407882676443629
1990,1374,10,18,631,1020,0.35714285714285715,-389,0.3821926105390672
1990,1375,11,17,908,1295,0.39285714285714285,-387,0.41216522923286425
1990,1376,14,14,943,879,0.5,64,0.5175631174533479
1990,1378,20,10,1674,692,0.6666666666666666,982,0.7075232459847844
1990,1379,20,11,1714,824,0.6451612903225806,890,0.6753349093774625
1990,1380,21,5,2141,397,0.8076923076923077,1744,0.8435776201733649
1990,1381,10,14,953,1118,0.4166666666666667,-165,0.460164171897634
1990,1382,8,20,628,1339,0.2857142857142857,-711,0.31926792069140825
1990,1383,8,18,650,1260,0.3076923076923077,-610,0.3403141361256545
1990,1384,16,11,1336,767,0.5925925925925926,569,0.635282929148835
1990,1385,23,9,1711,576,0.71875,1135,0.7481416703104504
1990,1386,7,21,550,1375,0.25,-825,0.2857142857142857
1990,1387,17,10,1307,682,0.6296296296296297,625,0.657114127702363
1990,1388,7,20,520,1280,0.25925925925925924,-760,0.28888888888888886
1990,1389,12,14,846,848,0.46153846153846156,-2,0.49940968122786306
1990,1390,17,11,1199,688,0.6071428571428571,511,0.6354001059883413
1990,1391,14,17,1191,1310,0.45161290322580644,-119,0.4762095161935226
1990,1393,23,6,1969,415,0.7931034482758621,1554,0.8259228187919463
1990,1395,15,13,1176,882,0.5357142857142857,294,0.5714285714285714
1990,1396,20,10,1431,632,0.6666666666666666,799,0.6936500242365488
1990,1397,15,13,1219,1080,0.5357142857142857,139,0.530230535015224
1990,1398,6,20,522,1557,0.23076923076923078,-1035,0.2510822510822511
1990,1399,16,9,1383,673,0.64,710,0.6726653696498055
1990,1400,21,9,1993,804,0.7,1189,0.7125491598140865
1990,1401,14,16,1224,1228,0.4666666666666667,-4,0.499184339314845
1990,1402,13,15,1231,1065,0.4642857142857143,166,0.5361498257839721
1990,1403,2,22,173,1421,0.08333333333333333,-1248,0.10853199498117942
1990,1405,12,16,950,1028,0.42857142857142855,-78,0.48028311425682507
1990,1406,17,12,1436,873,0.5862068965517241,563,0.6219142485924642
1990,1408,4,24,341,1679,0.14285714285714285,-1338,0.16881188118811882
1990,1409,17,12,1355,814,0.5862068965517241,541,0.6247118487782388
1990,1410,19,9,1607,598,0.6785714285714286,1009,0.7287981859410431
1990,1411,17,11,1524,847,0.6071428571428571,677,0.6427667650780261
1990,1412,22,8,1820,608,0.7333333333333333,1212,0.7495881383855024
1990,1414,5,23,432,1575,0.17857142857142858,-1143,0.21524663677130046
1990,1416,6,18,470,1168,0.25,-698,0.2869352869352869
1990,1417,20,10,1643,783,0.6666666666666666,860,0.6772464962901896
1990,1418,20,9,1861,762,0.6896551724137931,1099,0.7094929470072436
1990,1419,22,7,1848,483,0.7586206896551724,1365,0.7927927927927928
1990,1420,9,16,709,1144,0.36,-435,0.3826227738801943
1990,1421,15,11,1210,767,0.5769230769230769,443,0.6120384420839656
1990,1423,7,20,509,1220,0.25925925925925924,-711,0.2943898207056102
1990,1424,29,5,2753,415,0.8529411764705882,2338,0.8690025252525253
1990,1425,12,16,958,1128,0.42857142857142855,-170,0.4592521572387344
1990,1426,13,16,919,950,0.4482758620689655,-31,0.4917067950775816
1990,1427,20,7,1848,619,0.7407407407407407,1229,0.7490879610863397
1990,1428,12,14,798,901,0.46153846153846156,-103,0.46968805179517364
1990,1429,12,16,890,1208,0.42857142857142855,-318,0.4242135367016206
1990,1431,20,10,1488,600,0.6666666666666666,888,0.7126436781609196
1990,1433,10,17,751,1039,0.37037037037037035,-288,0.4195530726256983
1990,1434,3,23,257,1439,0.11538461538461539,-1182,0.15153301886792453
1990,1435,15,14,1201,1029,0.5172413793103449,172,0.5385650224215247
1990,1436,11,17,824,1105,0.39285714285714285,-281,0.42716433385173663
1990,1437,18,14,1345,916,0.5625,429,0.5948695267580717
1990,1438,19,11,1478,706,0.6333333333333333,772,0.6767399267399268
1990,1439,13,18,1028,1353,0.41935483870967744,-325,0.43175136497270056
1990,1440,11,15,885,1096,0.4230769230769231,-211,0.44674406865219585
1990,1441,6,18,477,1255,0.25,-778,0.2754041570438799
1990,1442,13,13,980,843,0.5,137,0.5375754251234229
1990,1443,12,17,874,1088,0.41379310344827586,-214,0.4454638124362895
1990,1444,6,18,477,1236,0.25,-759,0.27845884413309985
1990,1447,10,17,800,1132,0.37037037037037035,-332,0.4140786749482402
1990,1448,12,16,876,1051,0.42857142857142855,-175,0.4545926310326933
1990,1449,9,17,651,974,0.34615384615384615,-323,0.4006153846153846
1990,1450,5,22,364,1419,0.18518518518518517,-1055,0.2041503084688727
1990,1451,12,15,864,930,0.4444444444444444,-66,0.4816053511705686
1990,1452,16,12,1334,856,0.5714285714285714,478,0.6091324200913242
1990,1453,22,7,1520,369,0.7586206896551724,1151,0.8046585494970884
1990,1455,10,19,739,1265,0.3448275862068966,-526,0.3687624750499002
1990,1456,4,21,290,1385,0.16,-1095,0.17313432835820897
1990,1457,16,9,1199,566,0.64,633,0.6793201133144476
1990,1458,12,17,846,1036,0.41379310344827586,-190,0.4495217853347503
1990,1460,18,7,1716,542,0.72,1174,0.7599645704162976
1990,1461,15,14,1173,915,0.5172413793103449,258,0.5617816091954023
1990,1462,25,4,2079,338,0.8620689655172413,1741,0.8601572196938353
1990,1463,17,7,1148,423,0.7083333333333334,725,0.7307447485677913
1990,1464,6,18,520,1313,0.25,-793,0.28368794326241137
1991,1102,5,20,368,1082,0.2,-714,0.2537931034482759
1991,1103,14,13,1035,795,0.5185185185185185,240,0.5655737704918032
1991,1104,21,9,1677,648,0.7,1029,0.7212903225806452
1991,1106,15,11,1422,952,0.5769230769230769,470,0.598989048020219
1991,1108,7,19,617,1486,0.2692307692307692,-869,0.29339039467427486
1991,1109,2,23,170,1957,0.08,-1787,0.07992477668077104
1991,1110,12,14,966,997,0.46153846153846156,-31,0.49210392256749874
1991,1111,15,14,1308,1088,0.5172413793103449,220,0.5459098497495827
1991,1112,26,6,2354,413,0.8125,1941,0.8507408745934225
1991,1113,19,9,1591,618,0.6785714285714286,973,0.7202354006337709
1991,1114,9,20,679,1402,0.3103448275862069,-723,0.32628543969245555
1991,1116,30,3,3031,268,0.9090909090909091,2763,0.9187632615944226
1991,1117,20,8,1515,488,0.7142857142857143,1027,0.7563654518222666
1991,1119,6,22,421,1317,0.21428571428571427,-896,0.2422324510932106
1991,1120,13,16,1022,1162,0.4482758620689655,-140,0.46794871794871795
1991,1121,13,15,962,939,0.4642857142857143,23,0.5060494476591267
1991,1122,13,14,1154,1097,0.48148148148148145,57,0.5126610395379831
1991,1123,17,9,1299,566,0.6538461538461539,733,0.696514745308311
1991,1124,12,15,1022,1126,0.4444444444444444,-104,0.4757914338919926
1991,1126,5,24,401,1780,0.1724137931034483,-1379,0.18386061439706555
1991,1129,18,10,1302,625,0.6428571428571429,677,0.6756616502335236
1991,1130,11,19,963,1302,0.36666666666666664,-339,0.4251655629139073
1991,1131,11,18,803,1170,0.3793103448275862,-367,0.40699442473390773
1991,1132,16,12,1293,841,0.5714285714285714,452,0.6059044048734771
1991,1133,8,20,666,1366,0.2857142857142857,-700,0.327755905511811
1991,1134,8,15,614,862,0.34782608695652173,-248,0.4159891598915989
1991,1135,9,15,712,966,0.375,-254,0.42431466030989273
1991,1137,17,13,1382,993,0.5666666666666667,389,0.5818947368421052
1991,1139,18,10,1514,865,0.6428571428571429,649,0.6364018495166036
1991,1140,20,12,1479,853,0.625,626,0.6342195540308748
1991,1141,12,14,953,830,0.46153846153846156,123,0.5344924284913067
1991,1143,13,14,1087,1019,0.48148148148148145,68,0.5161443494776828
1991,1144,6,18,445,1029,0.25,-584,0.3018995929443691
1991,1145,9,19,659,1220,0.32142857142857145,-561,0.35071846726982436
1991,1147,17,12,1529,924,0.5862068965517241,605,0.6233183856502242
1991,1148,4,24,342,1893,0.14285714285714285,-1551,0.15302013422818792
1991,1149,7,17,561,1176,0.2916666666666667,-615,0.3229706390328152
1991,1150,14,14,1320,1160,0.5,160,0.532258064516129
1991,1151,17,10,1451,717,0.6296296296296297,734,0.669280442804428
1991,1152,3,23,312,1835,0.11538461538461539,-1523,0.14531904983698182
1991,1153,17,11,1309,746,0.6071428571428571,563,0.6369829683698297
1991,1154,3,21,277,1433,0.125,-1156,0.16198830409356726
1991,1155,10,17,839,1125,0.37037037037037035,-286,0.4271894093686354
1991,1156,11,16,865,1051,0.4074074074074074,-186,0.4514613778705637
1991,1157,23,6,1750,407,0.7931034482758621,1343,0.8113120074177098
1991,1159,5,23,372,1633,0.17857142857142858,-1261,0.1855361596009975
1991,1160,15,13,1402,904,0.5357142857142857,498,0.6079791847354726
1991,1161,14,14,965,751,0.5,214,0.5623543123543123
1991,1162,6,19,448,1164,0.24,-716,0.27791563275434245
1991,1163,17,10,1332,659,0.6296296296296297,673,0.6690105474635861
1991,1164,18,10,1604,695,0.6428571428571429,909,0.6976946498477599
1991,1165,12,12,928,733,0.5,195,0.5586995785671283
1991,1166,23,7,1835,494,0.7666666666666667,1341,0.7878917990553885
1991,1168,13,14,1111,1039,0.48148148148148145,72,0.5167441860465116
1991,1169,7,19,675,1388,0.2692307692307692,-713,0.3271934076587494
1991,1171,8,17,574,1103,0.32,-529,0.3422778771615981
1991,1172,9,18,624,1145,0.3333333333333333,-521,0.3527416619559073
1991,1173,14,15,1289,1185,0.4827586206896552,104,0.521018593371059
1991,1174,15,13,1266,865,0.5357142857142857,401,0.5940872829657438
1991,1175,16,11,1605,851,0.5925925925925926,754,0.6535016286644951
1991,1177,20,8,1647,584,0.7142857142857143,1063,0.7382339757956073
1991,1178,9,18,715,1221,0.3333333333333333,-506,0.3693181818181818
1991,1179,8,21,631,1442,0.27586206896551724,-811,0.3043897732754462
1991,1180,12,16,979,1202,0.42857142857142855,-223,0.4488766620816139
1991,1181,26,7,2362,562,0.7878787878787878,1800,0.8077975376196991
1991,1182,13,15,1108,1041,0.4642857142857143,67,0.5155886458818055
1991,1183,15,12,1151,773,0.5555555555555556,378,0.5982328482328483
1991,1184,16,10,1274,693,0.6153846153846154,581,0.6476868327402135
1991,1185,22,6,1734,433,0.7857142857142857,1301,0.8001845869866174
1991,1186,11,16,984,1200,0.4074074074074074,-216,0.45054945054945056
1991,1187,10,16,729,1056,0.38461538461538464,-327,0.4084033613445378
1991,1190,25,4,2367,349,0.8620689655172413,2018,0.8715022091310751
1991,1191,14,14,1139,888,0.5,251,0.5619141588554514
1991,1192,22,8,1787,551,0.7333333333333333,1236,0.7643284858853722
1991,1193,8,20,691,1312,0.2857142857142857,-621,0.344982526210684
1991,1196,10,17,804,1160,0.37037037037037035,-356,0.4093686354378819
1991,1197,16,14,1373,958,0.5333333333333333,415,0.589017589017589
1991,1198,5,21,423,1478,0.19230769230769232,-1055,0.22251446607048922
1991,1199,20,10,1660,742,0.6666666666666666,918,0.6910907577019151
1991,1200,23,7,1802,447,0.7666666666666667,1355,0.8012449977767897
1991,1201,14,16,1246,1261,0.4666666666666667,-15,0.4970083765456721
1991,1202,17,8,1452,556,0.68,896,0.7231075697211156
1991,1203,19,11,1569,776,0.6333333333333333,793,0.6690831556503198
1991,1204,14,13,1128,930,0.5185185185185185,198,0.5481049562682215
1991,1206,14,16,1145,1153,0.4666666666666667,-8,0.49825935596170584
1991,1207,14,12,965,712,0.5384615384615384,253,0.5754323196183662
1991,1208,16,12,1421,892,0.5714285714285714,529,0.6143536532641591
1991,1209,16,14,1307,1069,0.5333333333333333,238,0.5500841750841751
1991,1210,16,12,1457,869,0.5714285714285714,588,0.6263972484952709
1991,1211,13,14,1117,916,0.48148148148148145,201,0.5494343334972946
1991,1212,6,22,607,1703,0.21428571428571427,-1096,0.26277056277056277
1991,1216,13,16,960,1088,0.4482758620689655,-128,0.46875
1991,1217,8,17,626,1271,0.32,-645,0.32999472851871375
1991,1218,15,13,1166,850,0.5357142857142857,316,0.5783730158730159
1991,1220,14,14,984,913,0.5,71,0.5187137585661571
1991,1221,17,12,1428,882,0.5862068965517241,546,0.6181818181818182
1991,1222,18,10,1556,700,0.6428571428571429,856,0.6897163120567376
1991,1224,8,20,724,1514,0.2857142857142857,-790,0.32350312779267204
1991,1225,17,11,1297,719,0.6071428571428571,578,0.6433531746031746
1991,1226,10,18,874,1373,0.35714285714285715,-499,0.38896306186025814
1991,1227,13,15,1016,948,0.4642857142857143,68,0.5173116089613035
1991,1228,20,10,1645,655,0.6666666666666666,990,0.7152173913043478
1991,1229,4,23,262,1416,0.14814814814814814,-1154,0.15613825983313467
1991,1231,27,4,2323,333,0.8709677419354839,1990,0.8746234939759037
1991,1232,14,14,1036,896,0.5,140,0.5362318840579711
1991,1233,17,13,1328,906,0.5666666666666667,422,0.594449418084154
1991,1234,18,10,1452,676,0.6428571428571429,776,0.6823308270676691
1991,1235,11,19,949,1383,0.36666666666666664,-434,0.40694682675814753
1991,1238,17,13,1469,1010,0.5666666666666667,459,0.5925776522791448
1991,1239,5,22,423,1488,0.18518518518518517,-1065,0.22135007849293564
1991,1241,19,9,1503,613,0.6785714285714286,890,0.7103024574669187
1991,1242,21,7,1858,523,0.75,1335,0.7803443931121378
1991,1243,12,15,962,1086,0.4444444444444444,-124,0.4697265625
1991,1245,9,18,633,1036,0.3333333333333333,-403,0.3792690233672858
1991,1246,22,6,1900,505,0.7857142857142857,1395,0.7900207900207901
1991,1247,19,9,1658,611,0.6785714285714286,1047,0.7307183781401498
1991,1248,6,21,460,1330,0.2222222222222222,-870,0.2569832402234637
1991,1249,15,13,1425,975,0.5357142857142857,450,0.59375
1991,1250,19,10,1612,689,0.6551724137931034,923,0.7005649717514124
1991,1251,2,22,124,1415,0.08333333333333333,-1291,0.08057179987004548
1991,1253,11,17,920,1178,0.39285714285714285,-258,0.438512869399428
1991,1254,10,18,819,1291,0.35714285714285715,-472,0.3881516587677725
1991,1256,21,9,1745,680,0.7,1065,0.7195876288659794
1991,1257,14,16,1199,1113,0.4666666666666667,86,0.518598615916955
1991,1258,14,15,1518,1438,0.4827586206896552,80,0.513531799729364
1991,1259,12,16,916,1094,0.42857142857142855,-178,0.4557213930348259
1991,1260,10,19,813,1357,0.3448275862068966,-544,0.37465437788018435
1991,1261,19,9,1836,714,0.6785714285714286,1122,0.72
1991,1263,13,16,1005,1046,0.4482758620689655,-41,0.4900048756704047
1991,1264,13,15,944,1049,0.4642857142857143,-105,0.47365780230807825
1991,1265,6,22,489,1392,0.21428571428571427,-903,0.25996810207336524
1991,1266,11,18,848,1272,0.3793103448275862,-424,0.4
1991,1267,13,14,1145,1066,0.48148148148148145,79,0.5178652193577566
1991,1268,16,12,1349,896,0.5714285714285714,453,0.600890868596882
1991,1269,16,11,1295,758,0.5925925925925926,537,0.6307842182172431
1991,1270,7,18,531,1138,0.28,-607,0.3181545835829838
1991,1271,4,23,364,1650,0.14814814814814814,-1286,0.1807348560079444
1991,1272,16,14,1261,1048,0.5333333333333333,213,0.5461238631442182
1991,1273,2,25,133,1555,0.07407407407407407,-1422,0.07879146919431279
1991,1274,9,19,717,1310,0.32142857142857145,-593,0.35372471632955105
1991,1275,16,12,1381,844,0.5714285714285714,537,0.6206741573033708
1991,1276,14,14,1089,960,0.5,129,0.5314787701317716
1991,1277,18,10,1322,674,0.6428571428571429,648,0.6623246492985972
1991,1278,12,16,936,1065,0.42857142857142855,-129,0.46776611694152925
1991,1279,9,19,730,1336,0.32142857142857145,-606,0.35333978702807356
1991,1280,20,8,1702,584,0.7142857142857143,1118,0.7445319335083115
1991,1281,19,10,1596,719,0.6551724137931034,877,0.6894168466522678
1991,1282,12,13,1065,960,0.48,105,0.5259259259259259
1991,1283,21,11,1578,757,0.65625,821,0.6758029978586724
1991,1284,19,10,1333,615,0.6551724137931034,718,0.6842915811088296
1991,1285,21,7,1764,457,0.75,1307,0.7942368302566412
1991,1286,10,16,851,1200,0.38461538461538464,-349,0.41491955143832276
1991,1287,14,13,1183,846,0.5185185185185185,337,0.5830458353868901
1991,1288,7,22,580,1547,0.2413793103448276,-967,0.27268453220498357
1991,1290,6,17,559,1386,0.2608695652173913,-827,0.28740359897172235
1991,1291,8,19,674,1464,0.2962962962962963,-790,0.31524789522918617
1991,1292,19,9,1635,639,0.6785714285714286,996,0.7189973614775725
1991,1293,23,7,1877,484,0.7666666666666667,1393,0.7950021177467175
1991,1296,24,5,1708,259,0.8275862068965517,1449,0.8683274021352313
1991,1298,8,21,757,1681,0.27586206896551724,-924,0.31050041017227237
1991,1299,14,10,1152,803,0.5833333333333334,349,0.5892583120204603
1991,1301,19,10,1788,803,0.6551724137931034,985,0.6900810497877268
1991,1302,2,25,197,1806,0.07407407407407407,-1609,0.0983524712930604
1991,1304,26,7,2378,515,0.7878787878787878,1863,0.8219840995506394
1991,1305,16,14,1250,927,0.5333333333333333,323,0.574184657785944
1991,1306,3,25,201,1456,0.10714285714285714,-1255,0.12130356065178033
1991,1307,19,9,1606,570,0.6785714285714286,1036,0.7380514705882353
1991,1308,22,5,1783,399,0.8148148148148148,1384,0.8171402383134739
1991,1309,22,7,1705,463,0.7586206896551724,1242,0.7864391143911439
1991,1310,8,20,597,1275,0.2857142857142857,-678,0.3189102564102564
1991,1311,3,25,300,1922,0.10714285714285714,-1622,0.135013501350135
1991,1314,25,5,2253,388,0.8333333333333334,1865,0.853085952290799
1991,1317,17,13,1499,1149,0.5666666666666667,350,0.5660876132930514
1991,1318,22,10,1770,705,0.6875,1065,0.7151515151515152
1991,1319,3,23,232,1651,0.11538461538461539,-1419,0.12320764737121614
1991,1320,12,17,863,1061,0.41379310344827586,-198,0.44854469854469853
1991,1321,3,23,261,1567,0.11538461538461539,-1306,0.1427789934354486
1991,1322,5,21,372,1495,0.19230769230769232,-1123,0.19925013390465987
1991,1323,12,20,899,1334,0.375,-435,0.4025974025974026
1991,1325,15,12,1043,705,0.5555555555555556,338,0.5966819221967964
1991,1326,25,3,2191,197,0.8928571428571429,1994,0.9175041876046901
1991,1328,14,14,1412,1232,0.5,180,0.5340393343419062
1991,1329,22,7,1825,521,0.7586206896551724,1304,0.777919863597613
1991,1330,14,18,1153,1272,0.4375,-119,0.4754639175257732
1991,1332,13,15,1003,1125,0.4642857142857143,-122,0.47133458646616544
1991,1333,14,14,1140,944,0.5,196,0.5470249520153551
1991,1334,14,15,1098,1031,0.4827586206896552,67,0.5157350868952559
1991,1335,9,17,660,1107,0.34615384615384615,-447,0.3735144312393888
1991,1336,20,10,1558,676,0.6666666666666666,882,0.6974037600716204
1991,1337,21,8,1682,542,0.7241379310344828,1140,0.7562949640287769
1991,1338,18,11,1617,822,0.6206896551724138,795,0.6629766297662977
1991,1339,5,22,389,1647,0.18518518518518517,-1258,0.19106090373280943
1991,1341,1,21,99,1696,0.045454545454545456,-1597,0.05515320334261838
1991,1343,23,2,1466,88,0.92,1378,0.9433719433719434
1991,1344,17,12,1519,905,0.5862068965517241,614,0.6266501650165016
1991,1345,17,11,1288,658,0.6071428571428571,630,0.6618705035971223
1991,1347,18,7,1402,460,0.72,942,0.7529538131041891
1991,1348,10,17,825,1145,0.37037037037037035,-320,0.41878172588832485
1991,1349,15,13,1175,908,0.5357142857142857,267,0.5640902544407105
1991,1350,20,9,1501,585,0.6896551724137931,916,0.7195589645254075
1991,1351,14,16,1088,1012,0.4666666666666667,76,0.518095238095238
1991,1352,17,11,1462,802,0.6071428571428571,660,0.6457597173144877
1991,1353,18,9,1414,635,0.6666666666666666,779,0.690092728160078
1991,1354,13,13,1095,915,0.5,180,0.5447761194029851
1991,1356,16,13,1361,911,0.5517241379310345,450,0.5990316901408451
1991,1358,5,20,371,1486,0.2,-1115,0.19978459881529348
1991,1359,6,22,440,1488,0.21428571428571427,-1048,0.22821576763485477
1991,1360,16,12,1414,888,0.5714285714285714,526,0.6142484795829714
1991,1361,11,16,831,1014,0.4074074074074074,-183,0.4504065040650406
1991,1362,11,17,910,1209,0.39285714285714285,-299,0.4294478527607362
1991,1363,7,20,532,1306,0.25925925925925924,-774,0.28944504896626766
1991,1364,14,15,1066,1019,0.4827586206896552,47,0.5112709832134292
1991,1365,15,13,1185,851,0.5357142857142857,334,0.5820235756385069
1991,1368,9,19,709,1346,0.32142857142857145,-637,0.34501216545012164
1991,1371,21,8,1732,531,0.7241379310344828,1201,0.7653557224922669
1991,1372,11,16,808,968,0.4074074074074074,-160,0.45495495495495497
1991,1373,22,9,1858,650,0.7096774193548387,1208,0.740829346092504
1991,1374,12,17,939,1115,0.41379310344827586,-176,0.4571567672833496
1991,1375,21,8,1904,671,0.7241379310344828,1233,0.7394174757281553
1991,1376,18,12,1362,710,0.6,652,0.6573359073359073
1991,1378,19,10,1447,704,0.6551724137931034,743,0.6727103672710367
1991,1379,20,7,1717,528,0.7407407407407407,1189,0.7648106904231626
1991,1380,16,9,1797,747,0.64,1050,0.7063679245283019
1991,1381,13,12,1239,996,0.52,243,0.5543624161073826
1991,1382,4,23,379,1558,0.14814814814814814,-1179,0.1956633970056789
1991,1383,15,14,1254,1074,0.5172413793103449,180,0.538659793814433
1991,1384,24,7,2028,568,0.7741935483870968,1460,0.7812018489984591
1991,1385,20,8,1488,532,0.7142857142857143,956,0.7366336633663366
1991,1386,13,17,1121,1268,0.43333333333333335,-147,0.46923398911678527
1991,1387,18,14,1470,1048,0.5625,422,0.5837966640190627
1991,1388,13,16,1041,1139,0.4482758620689655,-98,0.4775229357798165
1991,1389,24,6,1756,366,0.8,1390,0.827521206409048
1991,1390,15,13,1263,882,0.5357142857142857,381,0.5888111888111888
1991,1391,15,16,1157,1129,0.4838709677419355,28,0.5061242344706912
1991,1393,25,5,2142,367,0.8333333333333334,1775,0.8537265842965325
1991,1395,18,10,1396,648,0.6428571428571429,748,0.6829745596868885
1991,1396,21,9,1505,583,0.7,922,0.7207854406130269
1991,1397,12,21,1050,1560,0.36363636363636365,-510,0.40229885057471265
1991,1398,4,22,344,1689,0.15384615384615385,-1345,0.16920806689621248
1991,1399,10,16,875,1277,0.38461538461538464,-402,0.4065985130111524
1991,1400,22,8,1979,649,0.7333333333333333,1330,0.7530441400304414
1991,1401,7,21,541,1441,0.25,-900,0.2729566094853683
1991,1402,8,17,666,1270,0.32,-604,0.3440082644628099
1991,1403,6,22,455,1398,0.21428571428571427,-943,0.2455477603885591
1991,1405,15,16,1197,1038,0.4838709677419355,159,0.5355704697986577
1991,1406,19,10,1516,726,0.6551724137931034,790,0.6761819803746655
1991,1408,15,13,1240,943,0.5357142857142857,297,0.5680256527714155
1991,1409,18,11,1430,782,0.6206896551724138,648,0.6464737793851718
1991,1410,7,21,613,1435,0.25,-822,0.29931640625
1991,1411,13,16,1123,1175,0.4482758620689655,-52,0.4886858137510879
1991,1412,17,12,1479,891,0.5862068965517241,588,0.6240506329113924
1991,1414,11,19,1071,1473,0.36666666666666664,-402,0.4209905660377358
1991,1416,9,16,785,1117,0.36,-332,0.4127234490010515
1991,1417,22,8,2164,641,0.7333333333333333,1523,0.7714795008912656
1991,1418,21,10,2077,747,0.6774193548387096,1330,0.7354815864022662
1991,1419,25,7,2164,532,0.78125,1632,0.8026706231454006
1991,1420,6,22,450,1430,0.21428571428571427,-980,0.2393617021276596
1991,1421,5,19,425,1293,0.20833333333333334,-868,0.24738067520372525
1991,1423,10,16,775,1037,0.38461538461538464,-262,0.42770419426048567
1991,1424,30,0,3022,0,1.0,3022,1.0
1991,1425,19,9,1608,679,0.6785714285714286,929,0.7031045037166593
1991,1426,18,9,1710,730,0.6666666666666666,980,0.7008196721311475
1991,1427,21,7,2019,567,0.75,1452,0.7807424593967517
1991,1428,25,3,1855,176,0.8928571428571429,1679,0.913343180699163
1991,1429,11,17,901,1376,0.39285714285714285,-475,0.3956960913482653
1991,1431,14,13,1009,835,0.5185185185185185,174,0.547180043383948
1991,1433,13,17,1034,1231,0.43333333333333335,-197,0.4565121412803532
1991,1434,5,22,355,1266,0.18518518518518517,-911,0.2190006169031462
1991,1435,17,12,1377,763,0.5862068965517241,614,0.6434579439252337
1991,1436,13,13,1020,872,0.5,148,0.5391120507399577
1991,1437,16,14,1229,985,0.5333333333333333,244,0.5551038843721771
1991,1438,21,11,1660,745,0.65625,915,0.6902286902286903
1991,1439,13,16,1018,1115,0.4482758620689655,-97,0.4772620721987811
1991,1440,8,18,646,1195,0.3076923076923077,-549,0.3508962520369365
1991,1441,7,17,597,1325,0.2916666666666667,-728,0.3106139438085328
1991,1442,11,15,904,1001,0.4230769230769231,-97,0.47454068241469816
1991,1443,14,14,1215,1143,0.5,72,0.5152671755725191
1991,1444,4,22,296,1429,0.15384615384615385,-1133,0.17159420289855074
1991,1447,4,26,309,1824,0.13333333333333333,-1515,0.14486638537271448
1991,1448,18,10,1474,782,0.6428571428571429,692,0.6533687943262412
1991,1449,12,14,921,820,0.46153846153846156,101,0.5290063182079264
1991,1450,12,12,1068,808,0.5,260,0.5692963752665245
1991,1451,11,16,969,1052,0.4074074074074074,-83,0.47946561108362196
1991,1452,16,13,1496,1046,0.5517241379310345,450,0.5885129819040126
1991,1453,22,6,1533,354,0.7857142857142857,1179,0.8124006359300477
1991,1454,17,10,1514,771,0.6296296296296297,743,0.662582056892779
1991,1455,14,17,1068,984,0.45161290322580644,84,0.52046783625731
1991,1456,11,15,778,1009,0.4230769230769231,-231,0.4353665360940123
1991,1457,7,17,551,949,0.2916666666666667,-398,0.36733333333333335
1991,1458,13,13,994,832,0.5,162,0.5443592552026287
1991,1460,18,8,1793,607,0.6923076923076923,1186,0.7470833333333333
1991,1461,16,11,1367,865,0.5925925925925926,502,0.6124551971326165
1991,1462,21,9,1753,699,0.7,1054,0.7149265905383361
1991,1463,14,11,991,560,0.56,431,0.6389426176660219
1991,1464,8,16,741,1235,0.3333333333333333,-494,0.375
1992,1102,5,20,355,1167,0.2,-812,0.23324572930354795
1992,1103,15,12,1093,758,0.5555555555555556,335,0.5904916261480281
1992,1104,25,8,2018,584,0.7575757575757576,1434,0.7755572636433513
1992,1106,11,13,1027,1007,0.4583333333333333,20,0.5049164208456244
1992,1108,14,14,1252,1052,0.5,200,0.5434027777777778
1992,1110,11,18,875,1265,0.3793103448275862,-390,0.4088785046728972
1992,1111,13,14,1036,995,0.48148148148148145,41,0.5100935499753816
1992,1112,24,6,2119,430,0.8,1689,0.8313063946645743
1992,1113,18,13,1314,815,0.5806451612903226,499,0.6171911695631752
1992,1114,16,13,1217,902,0.5517241379310345,315,0.5743275129778197
1992,1116,22,7,2034,546,0.7586206896551724,1488,0.7883720930232558
1992,1117,17,11,1185,674,0.6071428571428571,511,0.6374394835933297
1992,1119,4,24,241,1242,0.14285714285714285,-1001,0.16250842886041808
1992,1120,9,15,831,1163,0.375,-332,0.41675025075225675
1992,1122,9,17,807,1271,0.34615384615384615,-464,0.3883541867179981
1992,1123,20,8,1420,468,0.7142857142857143,952,0.7521186440677966
1992,1124,13,15,1026,1016,0.4642857142857143,10,0.5024485798237023
1992,1126,4,24,365,1650,0.14285714285714285,-1285,0.18114143920595532
1992,1129,15,13,1113,803,0.5357142857142857,310,0.5808977035490606
1992,1130,16,13,1271,913,0.5517241379310345,358,0.581959706959707
1992,1131,9,18,660,1183,0.3333333333333333,-523,0.3581117742810635
1992,1132,13,14,858,883,0.48148148148148145,-25,0.4928202182653647
1992,1133,7,23,480,1179,0.23333333333333334,-699,0.28933092224231466
1992,1134,5,23,422,1449,0.17857142857142858,-1027,0.2255478353821486
1992,1135,10,15,746,941,0.4,-195,0.44220509780675754
1992,1137,20,9,1682,653,0.6896551724137931,1029,0.7203426124197002
1992,1138,2,26,142,1595,0.07142857142857142,-1453,0.08175014392630973
1992,1139,21,9,1778,668,0.7,1110,0.7269010629599346
1992,1140,25,6,2018,466,0.8064516129032258,1552,0.8123993558776168
1992,1141,8,16,628,1086,0.3333333333333333,-458,0.3663943990665111
1992,1143,10,18,833,1286,0.35714285714285715,-453,0.39310995752713546
1992,1144,15,11,1016,743,0.5769230769230769,273,0.5776009096077317
1992,1145,6,22,494,1499,0.21428571428571427,-1005,0.24786753637732062
1992,1147,7,18,638,1399,0.28,-761,0.3132056946489936
1992,1148,7,21,627,1430,0.25,-803,0.3048128342245989
1992,1149,12,14,841,841,0.46153846153846156,0,0.5
1992,1150,21,8,1641,545,0.7241379310344828,1096,0.7506861848124429
1992,1151,20,7,1633,489,0.7407407407407407,1144,0.7695570216776626
1992,1152,5,20,457,1453,0.2,-996,0.23926701570680628
1992,1153,25,4,2007,284,0.8620689655172413,1723,0.876036665211698
1992,1154,7,18,518,1216,0.28,-698,0.29873125720876587
1992,1155,12,14,962,1007,0.46153846153846156,-45,0.48857287963433216
1992,1156,15,13,1112,833,0.5357142857142857,279,0.5717223650385604
1992,1157,8,19,540,1143,0.2962962962962963,-603,0.32085561497326204
1992,1158,15,8,1094,516,0.6521739130434783,578,0.6795031055900621
1992,1159,14,14,1087,896,0.5,191,0.5481593545133636
1992,1160,13,15,1017,977,0.4642857142857143,40,0.5100300902708125
1992,1161,11,17,796,996,0.39285714285714285,-200,0.44419642857142855
1992,1162,9,16,713,1047,0.36,-334,0.40511363636363634
1992,1163,19,9,1630,600,0.6785714285714286,1030,0.7309417040358744
1992,1164,14,13,1209,949,0.5185185185185185,260,0.5602409638554217
1992,1165,6,19,440,1248,0.24,-808,0.26066350710900477
1992,1166,9,19,570,1236,0.32142857142857145,-666,0.31561461794019935
1992,1168,12,16,1035,1086,0.42857142857142855,-51,0.48797736916548795
1992,1169,9,17,736,1065,0.34615384615384615,-329,0.40866185452526377
1992,1170,3,23,262,1660,0.11538461538461539,-1398,0.13631633714880334
1992,1171,9,16,575,816,0.36,-241,0.41337167505391803
1992,1172,8,17,520,1115,0.32,-595,0.3180428134556575
1992,1173,15,15,1191,959,0.5,232,0.553953488372093
1992,1174,25,3,2037,241,0.8928571428571429,1796,0.8942054433713784
1992,1175,11,15,940,1047,0.4230769230769231,-107,0.4730749874182184
1992,1177,20,8,1725,555,0.7142857142857143,1170,0.756578947368421
1992,1178,12,17,997,1272,0.41379310344827586,-275,0.43940061701189953
1992,1179,5,21,313,1223,0.19230769230769232,-910,0.20377604166666666
1992,1180,16,14,1221,949,0.5333333333333333,272,0.5626728110599079
1992,1181,28,2,2532,141,0.9333333333333333,2391,0.9472502805836139
1992,1182,12,15,1026,1065,0.4444444444444444,-39,0.49067431850789095
1992,1183,16,13,1147,825,0.5517241379310345,322,0.5816430020283976
1992,1184,16,13,1300,858,0.5517241379310345,442,0.6024096385542169
1992,1185,7,22,543,1420,0.2413793103448276,-877,0.2766174223127866
1992,1186,5,21,412,1389,0.19230769230769232,-977,0.22876179900055524
1992,1187,7,18,561,1199,0.28,-638,0.31875
1992,1190,21,5,1805,407,0.8076923076923077,1398,0.816003616636528
1992,1191,24,5,1961,359,0.8275862068965517,1602,0.8452586206896552
1992,1192,14,14,1095,846,0.5,249,0.5641421947449768
1992,1193,8,20,610,1300,0.2857142857142857,-690,0.3193717277486911
1992,1196,16,12,1155,755,0.5714285714285714,400,0.6047120418848168
1992,1197,14,13,1208,927,0.5185185185185185,281,0.565807962529274
1992,1198,7,17,561,1136,0.2916666666666667,-575,0.3305833824395993
1992,1199,19,9,1673,662,0.6785714285714286,1011,0.7164882226980728
1992,1200,18,12,1383,764,0.6,619,0.6441546343735445
1992,1201,15,16,1200,1091,0.4838709677419355,109,0.5237887385421214
1992,1202,15,10,1242,698,0.6,544,0.6402061855670103
1992,1203,16,12,1227,825,0.5714285714285714,402,0.597953216374269
1992,1204,21,5,1918,412,0.8076923076923077,1506,0.8231759656652361
1992,1206,6,21,440,1363,0.2222222222222222,-923,0.24403771491957849
1992,1207,17,9,1233,586,0.6538461538461539,647,0.6778449697636064
1992,1208,14,14,1133,984,0.5,149,0.5351913084553613
1992,1209,13,14,1042,1149,0.48148148148148145,-107,0.4755819260611593
1992,1210,21,11,1785,805,0.65625,980,0.6891891891891891
1992,1211,18,10,1335,671,0.6428571428571429,664,0.6655034895314058
1992,1212,4,21,390,1603,0.16,-1213,0.19568489713998996
1992,1216,6,21,415,1289,0.2222222222222222,-874,0.24354460093896713
1992,1217,6,19,407,1217,0.24,-810,0.25061576354679804
1992,1218,16,12,1230,763,0.5714285714285714,467,0.6171600602107375
1992,1220,20,9,1598,507,0.6896551724137931,1091,0.7591448931116389
1992,1221,17,11,1496,809,0.6071428571428571,687,0.6490238611713666
1992,1222,24,5,1926,322,0.8275862068965517,1604,0.8567615658362989
1992,1224,17,12,1259,774,0.5862068965517241,485,0.6192818494835219
1992,1225,16,13,1335,795,0.5517241379310345,540,0.6267605633802817
1992,1226,9,20,857,1490,0.3103448275862069,-633,0.36514699616531743
1992,1227,15,14,1217,998,0.5172413793103449,219,0.5494356659142212
1992,1228,13,15,1043,941,0.4642857142857143,102,0.5257056451612904
1992,1229,18,11,1211,699,0.6206896551724138,512,0.6340314136125654
1992,1231,23,6,1993,392,0.7931034482758621,1601,0.8356394129979036
1992,1232,13,15,854,843,0.4642857142857143,11,0.5032410135533294
1992,1233,14,15,1086,1062,0.4827586206896552,24,0.505586592178771
1992,1234,18,10,1550,714,0.6428571428571429,836,0.6846289752650176
1992,1235,17,12,1508,775,0.5862068965517241,733,0.6605343845816908
1992,1238,10,16,853,1171,0.38461538461538464,-318,0.4214426877470356
1992,1239,12,17,1027,1235,0.41379310344827586,-208,0.4540229885057471
1992,1241,21,10,1763,693,0.6774193548387096,1070,0.7178338762214984
1992,1242,24,4,2085,281,0.8571428571428571,1804,0.8812341504649197
1992,1243,13,13,1038,800,0.5,238,0.5647442872687704
1992,1245,8,19,561,1109,0.2962962962962963,-548,0.33592814371257484
1992,1246,26,6,2266,435,0.8125,1831,0.8389485375786746
1992,1247,20,10,1751,659,0.6666666666666666,1092,0.7265560165975103
1992,1248,7,20,513,1277,0.25925925925925924,-764,0.2865921787709497
1992,1249,11,19,1054,1399,0.36666666666666664,-345,0.4296779453730126
1992,1250,13,15,1097,1223,0.4642857142857143,-126,0.4728448275862069
1992,1251,19,7,1478,478,0.7307692307692307,1000,0.7556237218813906
1992,1253,16,11,1285,707,0.5925925925925926,578,0.6450803212851406
1992,1254,11,18,887,1432,0.3793103448275862,-545,0.382492453643812
1992,1256,21,8,1781,534,0.7241379310344828,1247,0.7693304535637149
1992,1257,18,10,1466,708,0.6428571428571429,758,0.6743330266789328
1992,1258,14,13,1352,1126,0.5185185185185185,226,0.5456012913640033
1992,1259,14,14,1056,952,0.5,104,0.5258964143426295
1992,1260,13,16,1103,1025,0.4482758620689655,78,0.5183270676691729
1992,1261,20,9,1872,668,0.6896551724137931,1204,0.7370078740157481
1992,1263,16,15,1138,936,0.5161290322580645,202,0.5486981677917069
1992,1264,23,8,1723,543,0.7419354838709677,1180,0.7603706972639012
1992,1265,10,20,850,1342,0.3333333333333333,-492,0.38777372262773724
1992,1266,16,13,1262,743,0.5517241379310345,519,0.629426433915212
1992,1267,5,21,410,1450,0.19230769230769232,-1040,0.22043010752688172
1992,1268,14,15,1212,1138,0.4827586206896552,74,0.5157446808510638
1992,1269,27,4,2279,270,0.8709677419354839,2009,0.894076108277756
1992,1270,6,21,471,1458,0.2222222222222222,-987,0.24416796267496113
1992,1271,2,24,152,1538,0.07692307692307693,-1386,0.08994082840236686
1992,1272,20,10,1561,664,0.6666666666666666,897,0.7015730337078652
1992,1273,10,18,815,1215,0.35714285714285715,-400,0.4014778325123153
1992,1274,6,24,401,1378,0.2,-977,0.22540753232152894
1992,1275,21,7,1488,405,0.75,1083,0.786053882725832
1992,1276,20,8,1651,544,0.7142857142857143,1107,0.7521640091116173
1992,1277,21,7,1630,463,0.75,1167,0.7787864309603441
1992,1278,16,15,1228,994,0.5161290322580645,234,0.5526552655265526
1992,1279,10,17,867,1301,0.37037037037037035,-434,0.39990774907749077
1992,1280,14,13,1127,942,0.5185185185185185,185,0.5447075882068633
1992,1281,19,8,1530,579,0.7037037037037037,951,0.7254623044096729
1992,1282,17,8,1393,498,0.68,895,0.7366472765732417
1992,1283,22,7,1489,379,0.7586206896551724,1110,0.7971092077087795
1992,1284,20,9,1367,504,0.6896551724137931,863,0.7306253340459647
1992,1285,25,3,1942,195,0.8928571428571429,1747,0.9087505849321479
1992,1286,12,14,998,1021,0.46153846153846156,-23,0.4943041109460129
1992,1287,11,15,969,1230,0.4230769230769231,-261,0.4406548431105048
1992,1288,6,23,527,1594,0.20689655172413793,-1067,0.24846770391324846
1992,1290,14,11,1292,798,0.56,494,0.6181818181818182
1992,1291,6,22,493,1674,0.21428571428571427,-1181,0.22750346100599908
1992,1292,12,11,915,828,0.5217391304347826,87,0.5249569707401033
1992,1293,16,12,1430,914,0.5714285714285714,516,0.6100682593856656
1992,1296,10,17,822,1184,0.37037037037037035,-362,0.4097706879361914
1992,1298,5,22,410,1558,0.18518518518518517,-1148,0.20833333333333334
1992,1299,16,9,1283,647,0.64,636,0.6647668393782383
1992,1301,11,18,949,1275,0.3793103448275862,-326,0.4267086330935252
1992,1302,6,20,495,1391,0.23076923076923078,-896,0.2624602332979852
1992,1304,19,9,1604,665,0.6785714285714286,939,0.7069193477302776
1992,1305,18,10,1599,753,0.6428571428571429,846,0.6798469387755102
1992,1306,7,21,482,1287,0.25,-805,0.2724703222159412
1992,1307,18,11,1437,676,0.6206896551724138,761,0.6800757217226692
1992,1308,22,7,1750,478,0.7586206896551724,1272,0.7854578096947935
1992,1309,17,14,1230,843,0.5483870967741935,387,0.5933429811866859
1992,1310,14,14,1077,909,0.5,168,0.5422960725075529
1992,1311,15,13,1181,855,0.5357142857142857,326,0.5800589390962672
1992,1314,21,9,1819,730,0.7,1089,0.7136131816398588
1992,1317,14,14,1160,1130,0.5,30,0.5065502183406113
1992,1318,9,19,655,1201,0.32142857142857145,-546,0.35290948275862066
1992,1319,6,20,456,1399,0.23076923076923078,-943,0.24582210242587602
1992,1320,9,18,699,1039,0.3333333333333333,-340,0.40218642117376296
1992,1321,7,19,536,1208,0.2692307692307692,-672,0.3073394495412844
1992,1322,11,13,1054,1095,0.4583333333333333,-41,0.4904606793857608
1992,1323,14,14,1079,887,0.5,192,0.5488301119023398
1992,1325,16,10,1190,649,0.6153846153846154,541,0.6470908102229472
1992,1326,23,5,1877,390,0.8214285714285714,1487,0.8279664755183062
1992,1328,18,8,1791,620,0.6923076923076923,1171,0.7428452924097885
1992,1329,23,7,1762,445,0.7666666666666667,1317,0.7983688264612596
1992,1330,14,14,1110,978,0.5,132,0.5316091954022989
1992,1332,4,21,300,1271,0.16,-971,0.19096117122851686
1992,1333,13,16,1057,1077,0.4482758620689655,-20,0.49531396438612935
1992,1334,12,16,950,1056,0.42857142857142855,-106,0.47357926221335994
1992,1335,16,10,1263,634,0.6153846153846154,629,0.6657880864522931
1992,1336,21,7,1589,475,0.75,1114,0.7698643410852714
1992,1337,23,5,1778,348,0.8214285714285714,1430,0.8363123236124177
1992,1338,17,15,1407,1043,0.53125,364,0.5742857142857143
1992,1339,8,17,683,1296,0.32,-613,0.3451237998989389
1992,1343,20,5,1206,258,0.8,948,0.8237704918032787
1992,1344,14,16,1102,1151,0.4666666666666667,-49,0.4891256102973813
1992,1345,16,14,1162,880,0.5333333333333333,282,0.5690499510284035
1992,1347,18,9,1401,661,0.6666666666666666,740,0.6794374393792435
1992,1348,20,9,1628,650,0.6896551724137931,978,0.7146619841966637
1992,1349,18,11,1444,759,0.6206896551724138,685,0.6554698138901498
1992,1350,22,7,1697,431,0.7586206896551724,1266,0.7974624060150376
1992,1351,16,12,1242,761,0.5714285714285714,481,0.6200698951572641
1992,1352,19,11,1504,746,0.6333333333333333,758,0.6684444444444444
1992,1353,15,14,1271,1034,0.5172413793103449,237,0.5514099783080261
1992,1354,13,15,1020,957,0.4642857142857143,63,0.5159332321699545
1992,1356,22,7,1687,471,0.7586206896551724,1216,0.7817423540315107
1992,1358,2,25,164,1540,0.07407407407407407,-1376,0.09624413145539906
1992,1359,10,18,646,1017,0.35714285714285715,-371,0.38845460012026456
1992,1360,13,14,1008,847,0.48148148148148145,161,0.5433962264150943
1992,1361,2,26,173,1659,0.07142857142857142,-1486,0.09443231441048035
1992,1362,13,16,1128,1200,0.4482758620689655,-72,0.4845360824742268
1992,1363,2,24,119,1529,0.07692307692307693,-1410,0.07220873786407767
1992,1364,19,8,1359,536,0.7037037037037037,823,0.7171503957783641
1992,1365,13,14,957,848,0.48148148148148145,109,0.5301939058171745
1992,1368,6,22,513,1576,0.21428571428571427,-1063,0.24557204404021063
1992,1369,10,16,787,1118,0.38461538461538464,-331,0.4131233595800525
1992,1371,20,8,1548,511,0.7142857142857143,1037,0.7518212724623604
1992,1372,13,12,904,810,0.52,94,0.5274212368728122
1992,1373,18,10,1391,660,0.6428571428571429,731,0.6782057532910776
1992,1374,9,18,591,1134,0.3333333333333333,-543,0.3426086956521739
1992,1375,14,14,1312,1098,0.5,214,0.5443983402489626
1992,1376,10,17,761,1042,0.37037037037037035,-281,0.42207432057681643
1992,1378,19,8,1549,514,0.7037037037037037,1035,0.7508482792050412
1992,1379,12,16,973,1122,0.42857142857142855,-149,0.4644391408114558
1992,1380,14,12,1395,957,0.5384615384615384,438,0.5931122448979592
1992,1381,16,8,1432,629,0.6666666666666666,803,0.6948083454633673
1992,1382,8,19,601,1214,0.2962962962962963,-613,0.33112947658402203
1992,1383,15,14,1183,887,0.5172413793103449,296,0.5714975845410628
1992,1384,12,16,987,978,0.42857142857142855,9,0.5022900763358779
1992,1385,19,10,1440,645,0.6551724137931034,795,0.6906474820143885
1992,1386,12,15,1015,1041,0.4444444444444444,-26,0.49367704280155644
1992,1387,5,23,397,1576,0.17857142857142858,-1179,0.20121642169285353
1992,1388,12,17,849,1038,0.41379310344827586,-189,0.44992050874403816
1992,1389,8,21,571,1311,0.27586206896551724,-740,0.30340063761955366
1992,1390,18,10,1421,699,0.6428571428571429,722,0.6702830188679245
1992,1391,9,17,775,1180,0.34615384615384615,-405,0.39641943734015345
1992,1393,21,9,1616,635,0.7,981,0.7179031541537094
1992,1395,22,10,1664,666,0.6875,998,0.7141630901287553
1992,1396,17,12,1307,741,0.5862068965517241,566,0.63818359375
1992,1397,17,14,1428,984,0.5483870967741935,444,0.5920398009950248
1992,1398,2,22,141,1450,0.08333333333333333,-1309,0.08862350722815839
1992,1399,11,15,998,1202,0.4230769230769231,-204,0.4536363636363636
1992,1400,22,11,2030,925,0.6666666666666666,1105,0.6869712351945855
1992,1401,6,22,420,1414,0.21428571428571427,-994,0.22900763358778625
1992,1402,5,20,386,1150,0.2,-764,0.2513020833333333
1992,1403,13,14,990,1002,0.48148148148148145,-12,0.49698795180722893
1992,1405,7,20,468,1108,0.25925925925925924,-640,0.2969543147208122
1992,1406,16,13,1434,993,0.5517241379310345,441,0.5908529048207664
1992,1408,21,8,1825,584,0.7241379310344828,1241,0.7575757575757576
1992,1409,16,13,1205,917,0.5517241379310345,288,0.5678605089538171
1992,1410,2,26,111,1560,0.07142857142857142,-1449,0.06642728904847396
1992,1411,13,14,1096,933,0.48148148148148145,163,0.5401675702316412
1992,1412,19,8,1626,511,0.7037037037037037,1115,0.7608797379503978
1992,1414,7,22,526,1454,0.2413793103448276,-928,0.26565656565656565
1992,1416,10,18,851,1257,0.35714285714285715,-406,0.40370018975332067
1992,1417,24,4,2054,297,0.8571428571428571,1757,0.8736707783921736
1992,1418,20,10,1661,746,0.6666666666666666,915,0.6900706273369339
1992,1419,16,9,1234,663,0.64,571,0.6505007907221929
1992,1420,10,19,900,1475,0.3448275862068966,-575,0.37894736842105264
1992,1421,7,18,515,1184,0.28,-669,0.30311948204826367
1992,1422,7,21,505,1199,0.25,-694,0.2963615023474178
1992,1423,11,15,890,1023,0.4230769230769231,-133,0.46523784631468895
1992,1424,25,2,1980,163,0.9259259259259259,1817,0.9239384041063929
1992,1425,22,5,1761,356,0.8148148148148148,1405,0.8318375059045819
1992,1426,14,13,1242,880,0.5185185185185185,362,0.5852968897266729
1992,1427,18,8,1503,590,0.6923076923076923,913,0.7181079789775442
1992,1428,17,10,1178,609,0.6296296296296297,569,0.6592053721320649
1992,1429,14,12,1118,858,0.5384615384615384,260,0.5657894736842105
1992,1431,21,6,1571,377,0.7777777777777778,1194,0.8064681724845996
1992,1433,14,15,1065,1102,0.4827586206896552,-37,0.49146285186894323
1992,1434,5,21,359,1256,0.19230769230769232,-897,0.22229102167182663
1992,1435,15,14,1248,932,0.5172413793103449,316,0.5724770642201835
1992,1436,14,13,995,861,0.5185185185185185,134,0.5360991379310345
1992,1437,14,14,1033,866,0.5,167,0.5439705107951553
1992,1438,15,13,1144,787,0.5357142857142857,357,0.5924391506991197
1992,1439,10,18,764,1058,0.35714285714285715,-294,0.41931942919868276
1992,1440,8,18,572,1150,0.3076923076923077,-578,0.3321718931475029
1992,1441,8,16,748,1148,0.3333333333333333,-400,0.39451476793248946
1992,1442,9,18,752,1184,0.3333333333333333,-432,0.3884297520661157
1992,1443,19,10,1579,747,0.6551724137931034,832,0.678847807394669
1992,1444,21,8,1570,480,0.7241379310344828,1090,0.7658536585365854
1992,1447,16,12,1172,839,0.5714285714285714,333,0.5827946295375435
1992,1448,17,11,1323,782,0.6071428571428571,541,0.6285035629453681
1992,1449,8,17,544,1026,0.32,-482,0.3464968152866242
1992,1450,18,10,1552,712,0.6428571428571429,840,0.6855123674911661
1992,1451,15,13,1277,942,0.5357142857142857,335,0.5754844524560613
1992,1452,20,11,1611,863,0.6451612903225806,748,0.6511721907841552
1992,1453,24,4,1663,257,0.8571428571428571,1406,0.8661458333333333
1992,1454,18,8,1477,564,0.6923076923076923,913,0.7236648701616855
1992,1455,8,20,558,1152,0.2857142857142857,-594,0.3263157894736842
1992,1456,8,19,589,1276,0.2962962962962963,-687,0.3158176943699732
1992,1457,3,21,188,1231,0.125,-1043,0.1324876673713883
1992,1458,13,18,1110,1116,0.41935483870967744,-6,0.49865229110512127
1992,1460,14,13,1183,902,0.5185185185185185,281,0.5673860911270984
1992,1461,15,13,1155,896,0.5357142857142857,259,0.5631399317406144
1992,1462,15,12,1228,907,0.5555555555555556,321,0.5751756440281031
1992,1463,16,9,1115,509,0.64,606,0.6865763546798029
1992,1464,3,21,232,1313,0.125,-1081,0.15016181229773462
1993,1102,5,19,372,1121,0.20833333333333334,-749,0.2491627595445412
1993,1103,6,18,407,1072,0.25,-665,0.27518593644354294
1993,1104,16,12,1302,833,0.5714285714285714,469,0.6098360655737705
1993,1106,12,11,1052,899,0.5217391304347826,153,0.5392106611993849
1993,1108,7,19,639,1430,0.2692307692307692,-791,0.30884485258579025
1993,1110,11,17,914,1217,0.39285714285714285,-303,0.4289066166119193
1993,1111,12,15,985,1196,0.4444444444444444,-211,0.4516276937184778
1993,1112,24,3,2062,217,0.8888888888888888,1845,0.9047827994734533
1993,1113,17,9,1522,696,0.6538461538461539,826,0.6862037871956718
1993,1114,14,12,1060,736,0.5384615384615384,324,0.5902004454342984
1993,1116,20,8,1781,666,0.7142857142857143,1115,0.7278299959133633
1993,1117,15,12,1084,805,0.5555555555555556,279,0.5738485971413446
1993,1119,4,22,276,1279,0.15384615384615385,-1003,0.17749196141479098
1993,1120,13,11,1095,829,0.5416666666666666,266,0.5691268191268192
1993,1122,6,20,424,1344,0.23076923076923078,-920,0.2398190045248869
1993,1123,24,7,1736,455,0.7741935483870968,1281,0.792332268370607
1993,1124,14,11,1271,858,0.56,413,0.5969938938468765
1993,1126,3,24,254,1478,0.1111111111111111,-1224,0.14665127020785218
1993,1129,19,7,1443,497,0.7307692307692307,946,0.7438144329896907
1993,1130,16,12,1194,775,0.5714285714285714,419,0.6063991874047739
1993,1131,6,21,460,1420,0.2222222222222222,-960,0.24468085106382978
1993,1132,10,16,729,939,0.38461538461538464,-210,0.4370503597122302
1993,1133,10,16,654,895,0.38461538461538464,-241,0.4222078760490639
1993,1135,7,19,495,1119,0.2692307692307692,-624,0.3066914498141264
1993,1137,22,6,1847,409,0.7857142857142857,1438,0.8187056737588653
1993,1138,5,22,356,1425,0.18518518518518517,-1069,0.19988770353733856
1993,1139,10,17,744,1065,0.37037037037037035,-321,0.41127694859038144
1993,1140,24,8,2033,563,0.75,1470,0.7831278890600925
1993,1141,6,18,484,1257,0.25,-773,0.27800114876507753
1993,1143,19,8,1589,567,0.7037037037037037,1022,0.737012987012987
1993,1144,11,13,890,827,0.4583333333333333,63,0.5183459522422831
1993,1145,10,18,700,1076,0.35714285714285715,-376,0.39414414414414417
1993,1147,6,17,563,1311,0.2608695652173913,-748,0.30042689434364994
1993,1148,4,19,347,1350,0.17391304347826086,-1003,0.20447849145550973
1993,1149,5,18,419,1135,0.21739130434782608,-716,0.2696267696267696
1993,1150,15,13,1178,859,0.5357142857142857,319,0.5783014236622485
1993,1151,22,6,1912,438,0.7857142857142857,1474,0.8136170212765957
1993,1152,3,23,258,1566,0.11538461538461539,-1308,0.14144736842105263
1993,1153,24,4,1809,250,0.8571428571428571,1559,0.878581835842642
1993,1154,10,17,703,1034,0.37037037037037035,-331,0.40472078295912495
1993,1155,16,12,1369,859,0.5714285714285714,510,0.6144524236983842
1993,1156,22,6,1747,391,0.7857142857142857,1356,0.8171188026192704
1993,1157,19,9,1499,630,0.6785714285714286,869,0.7040864255519023
1993,1158,15,8,1070,467,0.6521739130434783,603,0.6961613532856213
1993,1159,18,10,1412,738,0.6428571428571429,674,0.6567441860465116
1993,1160,10,17,878,1125,0.37037037037037035,-247,0.43834248627059413
1993,1161,14,12,1099,771,0.5384615384615384,328,0.5877005347593582
1993,1162,15,10,1111,680,0.6,431,0.620323841429369
1993,1163,15,12,1229,796,0.5555555555555556,433,0.6069135802469136
1993,1164,22,7,1711,437,0.7586206896551724,1274,0.7965549348230913
1993,1165,15,10,1113,628,0.6,485,0.6392877656519241
1993,1166,8,18,569,1098,0.3076923076923077,-529,0.34133173365326935
1993,1168,14,12,1041,804,0.5384615384615384,237,0.5642276422764227
1993,1169,8,17,581,1074,0.32,-493,0.3510574018126888
1993,1170,2,24,126,1473,0.07692307692307693,-1347,0.07879924953095685
1993,1171,10,15,776,902,0.4,-126,0.46245530393325385
1993,1172,11,14,868,948,0.44,-80,0.4779735682819383
1993,1173,4,24,299,1412,0.14285714285714285,-1113,0.17475160724722386
1993,1174,21,7,1633,457,0.75,1176,0.7813397129186603
1993,1175,12,16,981,1061,0.42857142857142855,-80,0.480411361410382
1993,1177,16,15,1236,1051,0.5161290322580645,185,0.540445999125492
1993,1178,13,12,1076,868,0.52,208,0.5534979423868313
1993,1179,13,14,992,978,0.48148148148148145,14,0.5035532994923858
1993,1180,22,7,1680,441,0.7586206896551724,1239,0.7920792079207921
1993,1181,23,7,2072,512,0.7666666666666667,1560,0.8018575851393189
1993,1182,13,15,1023,1073,0.4642857142857143,-50,0.4880725190839695
1993,1183,9,17,638,1085,0.34615384615384615,-447,0.3702843876958793
1993,1184,13,12,999,895,0.52,104,0.5274551214361141
1993,1185,11,17,851,1061,0.39285714285714285,-210,0.4450836820083682
1993,1186,5,20,358,1288,0.2,-930,0.2174969623329283
1993,1187,11,16,782,1051,0.4074074074074074,-269,0.4266230223677032
1993,1190,16,10,1348,749,0.6153846153846154,599,0.642823080591321
1993,1191,22,6,1723,376,0.7857142857142857,1347,0.820867079561696
1993,1192,10,17,693,1125,0.37037037037037035,-432,0.3811881188118812
1993,1193,14,13,953,837,0.5185185185185185,116,0.5324022346368715
1993,1196,16,11,1269,724,0.5925925925925926,545,0.6367285499247366
1993,1197,9,18,740,1211,0.3333333333333333,-471,0.37929267042542286
1993,1198,17,10,1165,654,0.6296296296296297,511,0.640461792193513
1993,1199,22,9,1972,710,0.7096774193548387,1262,0.7352721849366145
1993,1200,14,16,978,965,0.4666666666666667,13,0.503345342254246
1993,1201,13,15,936,932,0.4642857142857143,4,0.5010706638115632
1993,1202,10,17,792,1217,0.37037037037037035,-425,0.3942259830761573
1993,1203,19,8,1506,550,0.7037037037037037,956,0.7324902723735408
1993,1204,16,9,1295,690,0.64,605,0.6523929471032746
1993,1206,6,21,449,1370,0.2222222222222222,-921,0.2468389224848818
1993,1207,13,12,976,725,0.52,251,0.5737801293356849
1993,1208,14,13,1149,917,0.5185185185185185,232,0.5561471442400775
1993,1209,9,14,662,1008,0.391304347826087,-346,0.3964071856287425
1993,1210,19,10,1546,710,0.6551724137931034,836,0.6852836879432624
1993,1211,17,9,1300,593,0.6538461538461539,707,0.6867406233491812
1993,1212,9,14,830,1046,0.391304347826087,-216,0.44243070362473347
1993,1216,13,14,1024,932,0.48148148148148145,92,0.523517382413088
1993,1217,5,20,386,1340,0.2,-954,0.22363847045191193
1993,1218,12,16,907,1054,0.42857142857142855,-147,0.4625191228964814
1993,1220,8,18,584,1040,0.3076923076923077,-456,0.35960591133004927
1993,1221,23,6,2052,447,0.7931034482758621,1605,0.8211284513805522
1993,1222,21,8,1746,569,0.7241379310344828,1177,0.7542116630669546
1993,1224,8,18,591,1195,0.3076923076923077,-604,0.33090705487122063
1993,1225,19,7,1422,460,0.7307692307692307,962,0.7555791710945803
1993,1226,9,18,720,1185,0.3333333333333333,-465,0.3779527559055118
1993,1227,15,15,1252,1097,0.5,155,0.5329927628778204
1993,1228,18,12,1418,868,0.6,550,0.6202974628171478
1993,1229,18,10,1252,596,0.6428571428571429,656,0.6774891774891775
1993,1231,28,3,2483,224,0.9032258064516129,2259,0.9172515700036942
1993,1232,10,17,741,1070,0.37037037037037035,-329,0.40916620651573715
1993,1233,15,11,1192,766,0.5769230769230769,426,0.6087844739530133
1993,1234,21,8,1683,563,0.7241379310344828,1120,0.7493321460373998
1993,1235,19,10,1662,699,0.6551724137931034,963,0.7039390088945362
1993,1238,20,8,1796,605,0.7142857142857143,1191,0.7480216576426489
1993,1239,5,22,419,1496,0.18518518518518517,-1077,0.218798955613577
1993,1241,21,8,1807,545,0.7241379310344828,1262,0.76828231292517
1993,1242,22,6,1873,402,0.7857142857142857,1471,0.8232967032967033
1993,1243,19,10,1419,637,0.6551724137931034,782,0.6901750972762646
1993,1245,10,17,747,995,0.37037037037037035,-248,0.4288174512055109
1993,1246,26,3,2252,257,0.896551724137931,1995,0.8975687524910323
1993,1247,13,13,998,776,0.5,222,0.5625704622322435
1993,1248,6,20,485,1240,0.23076923076923078,-755,0.2811594202898551
1993,1249,14,12,1374,916,0.5384615384615384,458,0.6
1993,1250,4,22,289,1622,0.15384615384615385,-1333,0.1512297226582941
1993,1251,11,14,830,1022,0.44,-192,0.4481641468682505
1993,1253,20,9,1667,589,0.6896551724137931,1078,0.7389184397163121
1993,1254,10,17,747,1294,0.37037037037037035,-547,0.3659970602645762
1993,1256,7,21,518,1192,0.25,-674,0.30292397660818715
1993,1257,19,8,1565,603,0.7037037037037037,962,0.7218634686346863
1993,1258,5,20,352,1335,0.2,-983,0.2086544161232958
1993,1259,2,25,128,1443,0.07407407407407407,-1315,0.08147676639083386
1993,1260,5,20,340,1300,0.2,-960,0.2073170731707317
1993,1261,22,10,1841,692,0.6875,1149,0.7268061587050928
1993,1263,10,17,705,1136,0.37037037037037035,-431,0.38294405214557303
1993,1264,23,6,1711,417,0.7931034482758621,1294,0.8040413533834586
1993,1265,13,16,1018,1026,0.4482758620689655,-8,0.4980430528375734
1993,1266,20,7,1582,423,0.7407407407407407,1159,0.7890274314214464
1993,1267,14,11,1146,785,0.56,361,0.5934748834800622
1993,1268,12,16,1073,1162,0.42857142857142855,-89,0.48008948545861296
1993,1269,23,6,1786,366,0.7931034482758621,1420,0.8299256505576208
1993,1270,11,15,873,1058,0.4230769230769231,-185,0.4520973588814086
1993,1271,10,15,735,874,0.4,-139,0.45680546923555004
1993,1272,18,11,1474,716,0.6206896551724138,758,0.6730593607305936
1993,1273,10,14,809,896,0.4166666666666667,-87,0.4744868035190616
1993,1274,8,17,628,1149,0.32,-521,0.353404614518852
1993,1275,19,8,1253,461,0.7037037037037037,792,0.7310385064177363
1993,1276,26,4,2164,315,0.8666666666666667,1849,0.872932634126664
1993,1277,15,12,1190,803,0.5555555555555556,387,0.5970898143502258
1993,1278,16,10,1295,676,0.6153846153846154,619,0.6570268899036023
1993,1279,7,18,497,1225,0.28,-728,0.2886178861788618
1993,1280,11,16,842,1042,0.4074074074074074,-200,0.4469214437367304
1993,1281,16,13,1216,915,0.5517241379310345,301,0.5706241201313937
1993,1282,11,12,987,790,0.4782608695652174,197,0.5554305008441193
1993,1283,18,10,1186,593,0.6428571428571429,593,0.6666666666666666
1993,1284,11,17,782,1023,0.39285714285714285,-241,0.4332409972299169
1993,1285,14,11,900,691,0.56,209,0.5656819610307983
1993,1286,7,18,473,1155,0.28,-682,0.2905405405405405
1993,1287,6,20,496,1462,0.23076923076923078,-966,0.2533197139938713
1993,1288,8,17,642,1307,0.32,-665,0.3293996921498204
1993,1290,11,13,1005,967,0.4583333333333333,38,0.5096348884381339
1993,1291,13,15,1041,971,0.4642857142857143,70,0.5173956262425448
1993,1292,8,15,620,931,0.34782608695652173,-311,0.39974210186976145
1993,1293,16,12,1417,902,0.5714285714285714,515,0.6110392410521777
1993,1296,13,12,953,758,0.52,195,0.5569842197545295
1993,1298,7,18,468,1095,0.28,-627,0.29942418426103645
1993,1299,12,11,938,720,0.5217391304347826,218,0.5657418576598311
1993,1301,8,19,593,1242,0.2962962962962963,-649,0.3231607629427793
1993,1302,7,16,573,1160,0.30434782608695654,-587,0.3306405077899596
1993,1304,20,10,1715,703,0.6666666666666666,1012,0.7092638544251447
1993,1305,8,17,629,1234,0.32,-605,0.3376274825550188
1993,1306,6,21,420,1259,0.2222222222222222,-839,0.25014889815366287
1993,1307,23,6,1665,343,0.7931034482758621,1322,0.829183266932271
1993,1308,22,7,1762,473,0.7586206896551724,1289,0.7883668903803132
1993,1309,25,3,1876,175,0.8928571428571429,1701,0.9146757679180887
1993,1310,23,6,1890,414,0.7931034482758621,1476,0.8203125
1993,1311,12,12,1005,828,0.5,177,0.5482815057283142
1993,1314,28,4,2483,282,0.875,2201,0.8980108499095841
1993,1317,5,21,425,1624,0.19230769230769232,-1199,0.20741825280624696
1993,1318,20,8,1546,578,0.7142857142857143,968,0.7278719397363466
1993,1319,8,15,626,942,0.34782608695652173,-316,0.399234693877551
1993,1320,11,15,754,840,0.4230769230769231,-86,0.4730238393977415
1993,1321,7,19,547,1263,0.2692307692307692,-716,0.30220994475138124
1993,1322,9,13,864,1043,0.4090909090909091,-179,0.45306764551651807
1993,1323,9,18,603,1110,0.3333333333333333,-507,0.3520140105078809
1993,1325,13,13,918,889,0.5,29,0.5080243497509684
1993,1326,15,12,1157,781,0.5555555555555556,376,0.5970072239422085
1993,1328,16,11,1548,814,0.5925925925925926,734,0.655376799322608
1993,1329,15,8,1177,549,0.6521739130434783,628,0.6819235225955967
1993,1330,19,7,1665,530,0.7307692307692307,1135,0.7585421412300684
1993,1332,6,20,458,1441,0.23076923076923078,-983,0.2411795681937862
1993,1333,11,14,811,891,0.44,-80,0.4764982373678026
1993,1334,15,11,1070,664,0.5769230769230769,406,0.6170703575547867
1993,1335,22,4,1651,249,0.8461538461538461,1402,0.8689473684210526
1993,1336,7,20,465,1225,0.25925925925925924,-760,0.27514792899408286
1993,1337,19,7,1394,436,0.7307692307692307,958,0.7617486338797814
1993,1338,17,10,1419,679,0.6296296296296297,740,0.6763584366062917
1993,1339,7,18,483,1200,0.28,-717,0.28698752228163993
1993,1343,14,11,851,565,0.56,286,0.6009887005649718
1993,1344,17,11,1234,765,0.6071428571428571,469,0.6173086543271635
1993,1345,18,9,1314,618,0.6666666666666666,696,0.6801242236024845
1993,1347,11,16,971,1200,0.4074074074074074,-229,0.44725932749884845
1993,1348,18,10,1482,694,0.6428571428571429,788,0.6810661764705882
1993,1349,17,9,1371,654,0.6538461538461539,717,0.677037037037037
1993,1350,15,12,1122,814,0.5555555555555556,308,0.5795454545454546
1993,1351,19,10,1465,685,0.6551724137931034,780,0.6813953488372093
1993,1352,9,18,682,1118,0.3333333333333333,-436,0.3788888888888889
1993,1353,12,15,1009,1139,0.4444444444444444,-130,0.4697392923649907
1993,1354,14,13,1098,857,0.5185185185185185,241,0.5616368286445013
1993,1356,22,9,1775,624,0.7096774193548387,1151,0.739891621508962
1993,1358,4,19,330,1379,0.17391304347826086,-1049,0.1930953774136922
1993,1359,15,10,1171,600,0.6,571,0.6612083568605308
1993,1360,11,13,791,889,0.4583333333333333,-98,0.4708333333333333
1993,1361,4,21,254,1330,0.16,-1076,0.16035353535353536
1993,1362,17,12,1385,857,0.5862068965517241,528,0.6177520071364853
1993,1363,7,19,473,1204,0.2692307692307692,-731,0.28205128205128205
1993,1364,18,10,1278,668,0.6428571428571429,610,0.656731757451182
1993,1365,16,11,1168,684,0.5925925925925926,484,0.6306695464362851
1993,1368,8,15,621,1047,0.34782608695652173,-426,0.3723021582733813
1993,1369,15,11,1203,868,0.5769230769230769,335,0.5808788025108643
1993,1371,26,6,2087,404,0.8125,1683,0.8378161380971497
1993,1372,10,14,798,925,0.4166666666666667,-127,0.4631456761462565
1993,1373,15,13,1096,899,0.5357142857142857,197,0.5493734335839598
1993,1374,18,7,1484,503,0.72,981,0.7468545546049321
1993,1375,15,13,1362,919,0.5357142857142857,443,0.5971065322227094
1993,1376,8,18,693,1296,0.3076923076923077,-603,0.34841628959276016
1993,1378,8,19,639,1303,0.2962962962962963,-664,0.3290422245108136
1993,1379,10,17,817,1323,0.37037037037037035,-506,0.38177570093457946
1993,1380,16,9,1630,766,0.64,864,0.6803005008347245
1993,1381,11,12,894,824,0.4782608695652174,70,0.5203725261932479
1993,1382,10,16,751,1099,0.38461538461538464,-348,0.40594594594594596
1993,1383,9,18,760,1226,0.3333333333333333,-466,0.3826787512588117
1993,1384,9,18,628,1179,0.3333333333333333,-551,0.34753735473159936
1993,1385,18,10,1382,721,0.6428571428571429,661,0.6571564431764146
1993,1386,18,10,1392,657,0.6428571428571429,735,0.6793557833089312
1993,1387,10,17,881,966,0.37037037037037035,-85,0.47698971304818627
1993,1388,10,16,725,912,0.38461538461538464,-187,0.4428833231521075
1993,1389,9,18,670,1088,0.3333333333333333,-418,0.38111490329920367
1993,1390,6,22,411,1423,0.21428571428571427,-1012,0.22410032715376227
1993,1391,10,14,872,973,0.4166666666666667,-101,0.4726287262872629
1993,1393,19,9,1553,648,0.6785714285714286,905,0.7055883689232167
1993,1395,6,22,428,1387,0.21428571428571427,-959,0.23581267217630855
1993,1396,17,12,1231,772,0.5862068965517241,459,0.6145781328007988
1993,1397,13,17,1126,1235,0.43333333333333335,-109,0.4769165607793308
1993,1398,19,8,1589,565,0.7037037037037037,1024,0.7376973073351903
1993,1399,14,13,1310,1019,0.5185185185185185,291,0.562473164448261
1993,1400,10,17,863,1292,0.37037037037037035,-429,0.40046403712296985
1993,1401,10,17,755,1101,0.37037037037037035,-346,0.4067887931034483
1993,1402,12,13,907,905,0.48,2,0.5005518763796909
1993,1403,16,11,1320,808,0.5925925925925926,512,0.6203007518796992
1993,1404,5,19,399,1239,0.20833333333333334,-840,0.24358974358974358
1993,1405,12,15,948,868,0.4444444444444444,80,0.5220264317180616
1993,1406,17,9,1374,624,0.6538461538461539,750,0.6876876876876877
1993,1408,20,8,1594,553,0.7142857142857143,1041,0.7424312994876572
1993,1409,13,14,1020,1001,0.48148148148148145,19,0.5047006432459179
1993,1410,2,20,142,1251,0.09090909090909091,-1109,0.10193826274228285
1993,1411,10,14,833,997,0.4166666666666667,-164,0.4551912568306011
1993,1412,17,13,1358,794,0.5666666666666667,564,0.6310408921933085
1993,1414,5,21,400,1464,0.19230769230769232,-1064,0.2145922746781116
1993,1416,8,17,633,1268,0.32,-635,0.33298264071541295
1993,1417,21,10,1712,710,0.6774193548387096,1002,0.7068538398018167
1993,1418,17,13,1435,956,0.5666666666666667,479,0.6001672940192389
1993,1419,25,4,2236,284,0.8620689655172413,1952,0.8873015873015873
1993,1420,10,16,878,1228,0.38461538461538464,-350,0.41690408357075026
1993,1421,2,23,171,1533,0.08,-1362,0.10035211267605634
1993,1422,10,17,769,1090,0.37037037037037035,-321,0.41366325981710594
1993,1423,15,11,1267,837,0.5769230769230769,430,0.6021863117870723
1993,1424,21,7,1951,567,0.75,1384,0.7748212867355043
1993,1425,14,11,1049,725,0.56,324,0.5913190529875987
1993,1426,13,12,1089,931,0.52,158,0.5391089108910891
1993,1427,12,14,999,1066,0.46153846153846156,-67,0.4837772397094431
1993,1428,22,6,1739,422,0.7857142857142857,1317,0.8047200370198982
1993,1429,8,17,650,1285,0.32,-635,0.3359173126614987
1993,1431,18,12,1362,776,0.6,586,0.637043966323667
1993,1433,20,9,1642,669,0.6896551724137931,973,0.7105149286023367
1993,1434,11,16,938,1196,0.4074074074074074,-258,0.4395501405810684
1993,1435,26,5,2250,345,0.8387096774193549,1905,0.8670520231213873
1993,1436,9,17,783,1170,0.34615384615384615,-387,0.4009216589861751
1993,1437,8,19,675,1232,0.2962962962962963,-557,0.35395909805977976
1993,1438,19,9,1526,570,0.6785714285714286,956,0.7280534351145038
1993,1439,9,18,651,1149,0.3333333333333333,-498,0.3616666666666667
1993,1440,4,22,298,1391,0.15384615384615385,-1093,0.17643576080521017
1993,1441,4,20,324,1324,0.16666666666666666,-1000,0.1966019417475728
1993,1442,7,19,570,1323,0.2692307692307692,-753,0.3011093502377179
1993,1443,24,5,2098,420,0.8275862068965517,1678,0.8332009531374106
1993,1444,16,12,1127,763,0.5714285714285714,364,0.5962962962962963
1993,1447,18,12,1346,751,0.6,595,0.6418693371483071
1993,1448,19,8,1552,544,0.7037037037037037,1008,0.7404580152671756
1993,1449,11,14,745,968,0.44,-223,0.4349095154699358
1993,1450,13,12,1009,772,0.52,237,0.566535654126895
1993,1451,17,7,1349,515,0.7083333333333334,834,0.7237124463519313
1993,1452,16,11,1285,769,0.5925925925925926,516,0.6256085686465434
1993,1453,13,14,936,849,0.48148148148148145,87,0.5243697478991597
1993,1454,22,4,1749,305,0.8461538461538461,1444,0.8515092502434275
1993,1455,9,17,633,1035,0.34615384615384615,-402,0.37949640287769787
1993,1456,12,13,931,911,0.48,20,0.50542888165038
1993,1457,12,16,1055,1269,0.42857142857142855,-214,0.45395869191049915
1993,1458,14,13,1154,929,0.5185185185185185,225,0.5540086413826212
1993,1460,19,9,1839,669,0.6785714285714286,1170,0.7332535885167464
1993,1461,11,15,828,937,0.4230769230769231,-109,0.46912181303116146
1993,1462,22,5,1603,371,0.8148148148148148,1232,0.8120567375886525
1993,1463,9,16,530,826,0.36,-296,0.39085545722713866
1993,1464,3,23,265,1599,0.11538461538461539,-1334,0.14216738197424894
1994,1102,4,18,313,1165,0.18181818181818182,-852,0.21177266576454667
1994,1103,7,18,474,1060,0.28,-586,0.3089960886571056
1994,1104,19,9,1490,569,0.6785714285714286,921,0.7236522583778533
1994,1106,15,10,1371,755,0.6,616,0.6448730009407337
1994,1108,3,19,259,1401,0.13636363636363635,-1142,0.15602409638554218
1994,1110,8,19,689,1360,0.2962962962962963,-671,0.33626159102000974
1994,1111,15,11,1236,763,0.5769230769230769,473,0.6183091545772886
1994,1112,25,5,2309,407,0.8333333333333334,1902,0.8501472754050073
1994,1113,15,12,1211,880,0.5555555555555556,331,0.5791487326637972
1994,1114,12,15,951,1024,0.4444444444444444,-73,0.4815189873417722
1994,1116,24,3,2307,213,0.8888888888888888,2094,0.9154761904761904
1994,1117,15,12,1121,718,0.5555555555555556,403,0.6095704187058184
1994,1119,6,20,504,1485,0.23076923076923078,-981,0.25339366515837103
1994,1120,11,17,1017,1271,0.39285714285714285,-254,0.444493006993007
1994,1122,10,16,855,1184,0.38461538461538464,-329,0.41932319764590487
1994,1123,14,12,1060,859,0.5384615384615384,201,0.5523710265763419
1994,1124,16,11,1390,918,0.5925925925925926,472,0.6022530329289428
1994,1126,9,18,727,1189,0.3333333333333333,-462,0.3794363256784969
1994,1129,15,11,1152,719,0.5769230769230769,433,0.615713522180652
1994,1130,19,10,1562,703,0.6551724137931034,859,0.6896247240618102
1994,1131,11,16,903,1110,0.4074074074074074,-207,0.4485842026825633
1994,1132,15,10,1142,620,0.6,522,0.6481271282633371
1994,1133,20,7,1447,405,0.7407407407407407,1042,0.781317494600432
1994,1135,12,14,841,843,0.46153846153846156,-2,0.4994061757719715
1994,1137,9,17,821,1327,0.34615384615384615,-506,0.38221601489757917
1994,1138,9,18,705,1197,0.3333333333333333,-492,0.37066246056782337
1994,1139,15,13,1149,944,0.5357142857142857,205,0.5489727663640707
1994,1140,19,9,1582,636,0.6785714285714286,946,0.7132551848512173
1994,1141,5,20,328,1112,0.2,-784,0.22777777777777777
1994,1143,22,7,1802,499,0.7586206896551724,1303,0.7831377661886136
1994,1144,18,9,1323,584,0.6666666666666666,739,0.6937598321971683
1994,1145,22,6,1813,413,0.7857142857142857,1400,0.8144654088050315
1994,1147,14,12,1189,904,0.5384615384615384,285,0.5680840898232202
1994,1148,1,22,85,1580,0.043478260869565216,-1495,0.05105105105105105
1994,1149,8,18,691,1428,0.3076923076923077,-737,0.32609721566776784
1994,1150,16,12,1205,744,0.5714285714285714,461,0.6182657773217034
1994,1151,21,6,1754,446,0.7777777777777778,1308,0.7972727272727272
1994,1152,3,23,277,1746,0.11538461538461539,-1469,0.13692535837864558
1994,1153,22,9,1808,605,0.7096774193548387,1203,0.7492747617074181
1994,1154,9,16,651,1039,0.36,-388,0.385207100591716
1994,1155,16,15,1295,996,0.5161290322580645,299,0.5652553470100393
1994,1156,13,15,1044,971,0.4642857142857143,73,0.5181141439205955
1994,1157,13,11,1064,749,0.5416666666666666,315,0.5868725868725869
1994,1158,22,3,1701,194,0.88,1507,0.8976253298153034
1994,1159,17,12,1421,939,0.5862068965517241,482,0.6021186440677966
1994,1160,10,17,806,1186,0.37037037037037035,-380,0.4046184738955823
1994,1161,13,13,1070,875,0.5,195,0.5501285347043702
1994,1162,5,20,345,1125,0.2,-780,0.23469387755102042
1994,1163,27,4,2388,301,0.8709677419354839,2087,0.8880624767571588
1994,1164,20,8,1607,491,0.7142857142857143,1116,0.7659675881792183
1994,1165,6,18,451,1068,0.25,-617,0.2969058591178407
1994,1166,6,21,438,1301,0.2222222222222222,-863,0.2518688901667625
1994,1168,6,19,501,1277,0.24,-776,0.28177727784026996
1994,1169,7,18,582,1220,0.28,-638,0.32297447280799113
1994,1170,1,26,80,1580,0.037037037037037035,-1500,0.04819277108433735
1994,1171,9,16,656,980,0.36,-324,0.40097799511002447
1994,1172,20,7,1522,503,0.7407407407407407,1019,0.7516049382716049
1994,1173,5,21,461,1385,0.19230769230769232,-924,0.24972914409534128
1994,1174,12,13,905,896,0.48,9,0.5024986118822876
1994,1175,6,19,496,1228,0.24,-732,0.2877030162412993
1994,1177,16,11,1378,746,0.5925925925925926,632,0.6487758945386064
1994,1178,13,12,999,808,0.52,191,0.5528500276701716
1994,1179,10,16,792,1203,0.38461538461538464,-411,0.3969924812030075
1994,1180,24,4,1902,264,0.8571428571428571,1638,0.8781163434903048
1994,1181,23,5,1849,353,0.8214285714285714,1496,0.8396911898274296
1994,1182,16,12,1260,758,0.5714285714285714,502,0.624380574826561
1994,1183,11,15,824,951,0.4230769230769231,-127,0.46422535211267607
1994,1184,11,14,962,1040,0.44,-78,0.4805194805194805
1994,1185,13,12,997,853,0.52,144,0.538918918918919
1994,1186,2,20,157,1256,0.09090909090909091,-1099,0.1111111111111111
1994,1187,15,12,1176,816,0.5555555555555556,360,0.5903614457831325
1994,1190,14,14,1254,1041,0.5,213,0.5464052287581699
1994,1191,19,10,1544,661,0.6551724137931034,883,0.7002267573696145
1994,1192,13,13,967,898,0.5,69,0.5184986595174262
1994,1193,8,19,676,1253,0.2962962962962963,-577,0.35044064282011406
1994,1194,3,23,235,1553,0.11538461538461539,-1318,0.13143176733780762
1994,1196,25,7,1945,490,0.78125,1455,0.7987679671457906
1994,1197,3,23,211,1427,0.11538461538461539,-1216,0.1288156288156288
1994,1198,11,16,852,1003,0.4074074074074074,-151,0.4592991913746631
1994,1199,13,14,1115,963,0.48148148148148145,152,0.5365736284889316
1994,1200,11,15,858,964,0.4230769230769231,-106,0.47091108671789245
1994,1201,18,10,1429,673,0.6428571428571429,756,0.6798287345385348
1994,1202,10,17,770,1181,0.37037037037037035,-411,0.3946694003075346
1994,1203,17,11,1333,631,0.6071428571428571,702,0.6787169042769857
1994,1204,10,14,797,989,0.4166666666666667,-192,0.4462486002239642
1994,1206,10,17,1005,1380,0.37037037037037035,-375,0.42138364779874216
1994,1207,16,11,1185,730,0.5925925925925926,455,0.618798955613577
1994,1208,14,16,1223,1173,0.4666666666666667,50,0.5104340567612687
1994,1209,12,14,962,937,0.46153846153846156,25,0.506582411795682
1994,1210,16,12,1300,832,0.5714285714285714,468,0.6097560975609756
1994,1211,19,7,1602,518,0.7307692307692307,1084,0.7556603773584906
1994,1212,5,18,497,1303,0.21739130434782608,-806,0.2761111111111111
1994,1216,16,12,1365,774,0.5714285714285714,591,0.638148667601683
1994,1217,8,17,598,1104,0.32,-506,0.35135135135135137
1994,1218,18,14,1376,923,0.5625,453,0.5985210961287516
1994,1220,9,20,708,1260,0.3103448275862069,-552,0.3597560975609756
1994,1221,14,14,1271,1072,0.5,199,0.5424669227486129
1994,1222,8,19,659,1415,0.2962962962962963,-756,0.31774349083895853
1994,1224,8,17,650,1136,0.32,-486,0.3639417693169093
1994,1225,15,10,1121,684,0.6,437,0.6210526315789474
1994,1226,15,9,1269,655,0.625,614,0.6595634095634095
1994,1227,19,9,1702,648,0.6785714285714286,1054,0.7242553191489361
1994,1228,17,10,1543,733,0.6296296296296297,810,0.6779437609841827
1994,1229,16,11,1196,795,0.5925925925925926,401,0.6007031642390759
1994,1231,19,8,1619,590,0.7037037037037037,1029,0.7329108193752829
1994,1232,4,22,327,1312,0.15384615384615385,-985,0.19951189749847467
1994,1233,7,20,534,1491,0.25925925925925924,-957,0.2637037037037037
1994,1234,11,16,996,1258,0.4074074074074074,-262,0.4418811002661934
1994,1235,13,13,1198,992,0.5,206,0.5470319634703197
1994,1238,18,10,1503,720,0.6428571428571429,783,0.6761133603238867
1994,1239,17,11,1406,768,0.6071428571428571,638,0.6467341306347746
1994,1241,20,9,1733,703,0.6896551724137931,1030,0.7114121510673235
1994,1242,24,7,2008,478,0.7741935483870968,1530,0.8077232502011263
1994,1243,17,12,1261,731,0.5862068965517241,530,0.6330321285140562
1994,1245,13,14,938,854,0.48148148148148145,84,0.5234375
1994,1246,26,6,2335,469,0.8125,1866,0.8327389443651926
1994,1247,10,16,773,1090,0.38461538461538464,-317,0.41492216854535696
1994,1248,8,19,648,1394,0.2962962962962963,-746,0.31733594515181196
1994,1249,8,17,626,1206,0.32,-580,0.34170305676855894
1994,1250,9,17,751,1266,0.34615384615384615,-515,0.37233515121467525
1994,1251,16,11,1203,732,0.5925925925925926,471,0.6217054263565891
1994,1253,15,10,1301,687,0.6,614,0.6544265593561368
1994,1254,3,24,258,1704,0.1111111111111111,-1446,0.13149847094801223
1994,1256,1,25,66,1489,0.038461538461538464,-1423,0.04244372990353698
1994,1257,26,5,2182,346,0.8387096774193549,1836,0.8631329113924051
1994,1258,6,21,503,1629,0.2222222222222222,-1126,0.23592870544090055
1994,1259,17,12,1400,905,0.5862068965517241,495,0.6073752711496746
1994,1260,7,19,528,1235,0.2692307692307692,-707,0.2994895065229722
1994,1261,11,16,958,1203,0.4074074074074074,-245,0.44331328088847755
1994,1263,20,9,1795,619,0.6896551724137931,1176,0.7435791217895609
1994,1264,19,10,1558,630,0.6551724137931034,928,0.7120658135283364
1994,1265,14,13,1204,908,0.5185185185185185,296,0.5700757575757576
1994,1266,21,8,1515,492,0.7241379310344828,1023,0.7548579970104634
1994,1267,7,18,558,1262,0.28,-704,0.3065934065934066
1994,1268,16,11,1366,793,0.5925925925925926,573,0.6327003242241779
1994,1269,27,6,2074,435,0.8181818181818182,1639,0.8266241530490235
1994,1270,9,16,672,1065,0.36,-393,0.38687392055267705
1994,1271,13,12,1002,790,0.52,212,0.5591517857142857
1994,1272,13,16,1061,1029,0.4482758620689655,32,0.5076555023923445
1994,1273,3,24,218,1526,0.1111111111111111,-1308,0.125
1994,1274,7,20,555,1135,0.25925925925925924,-580,0.32840236686390534
1994,1275,18,10,1436,679,0.6428571428571429,757,0.6789598108747045
1994,1276,21,7,1713,533,0.75,1180,0.7626892252894034
1994,1277,19,11,1524,744,0.6333333333333333,780,0.671957671957672
1994,1278,20,11,1705,775,0.6451612903225806,930,0.6875
1994,1279,11,13,888,814,0.4583333333333333,74,0.5217391304347826
1994,1280,17,10,1345,678,0.6296296296296297,667,0.6648541769649036
1994,1281,24,3,1937,232,0.8888888888888888,1705,0.8930382664822499
1994,1282,11,17,901,1093,0.39285714285714285,-192,0.4518555667001003
1994,1283,12,15,794,896,0.4444444444444444,-102,0.46982248520710057
1994,1284,18,11,1509,697,0.6206896551724138,812,0.6840435176790571
1994,1285,15,9,1174,652,0.625,522,0.6429353778751369
1994,1286,13,11,1108,773,0.5416666666666666,335,0.5890483785220627
1994,1287,12,14,1048,1073,0.46153846153846156,-25,0.4941065535124941
1994,1288,8,20,610,1383,0.2857142857142857,-773,0.30607124937280483
1994,1290,8,16,742,1214,0.3333333333333333,-472,0.37934560327198363
1994,1291,14,14,1195,1038,0.5,157,0.5351545006717421
1994,1292,7,19,570,1267,0.2692307692307692,-697,0.3102885138813283
1994,1293,20,5,1861,391,0.8,1470,0.8263765541740675
1994,1296,9,17,709,1170,0.34615384615384615,-461,0.3773283661522086
1994,1298,16,12,1318,805,0.5714285714285714,513,0.6208195949128592
1994,1299,15,12,1217,812,0.5555555555555556,405,0.5998028585510103
1994,1301,11,19,830,1231,0.36666666666666664,-401,0.4027171276079573
1994,1302,14,11,1200,832,0.56,368,0.5905511811023622
1994,1304,20,9,1797,743,0.6896551724137931,1054,0.7074803149606299
1994,1305,10,17,785,1191,0.37037037037037035,-406,0.3972672064777328
1994,1306,15,13,1158,880,0.5357142857142857,278,0.5682041216879293
1994,1307,21,7,1674,498,0.75,1176,0.7707182320441989
1994,1308,21,7,1719,514,0.75,1205,0.7698163905060457
1994,1309,18,9,1309,599,0.6666666666666666,710,0.6860587002096437
1994,1310,6,21,454,1332,0.2222222222222222,-878,0.2541993281075028
1994,1311,17,9,1537,715,0.6538461538461539,822,0.6825044404973357
1994,1314,27,6,2402,451,0.8181818181818182,1951,0.8419207851384507
1994,1317,14,15,1074,1013,0.4827586206896552,61,0.5146142788691902
1994,1318,4,22,345,1475,0.15384615384615385,-1130,0.18956043956043955
1994,1319,10,12,828,903,0.45454545454545453,-75,0.4783362218370884
1994,1320,15,13,1210,895,0.5357142857142857,315,0.5748218527315915
1994,1321,13,13,1057,877,0.5,180,0.546535677352637
1994,1322,7,15,625,1216,0.3181818181818182,-591,0.33948940793047255
1994,1323,11,17,820,1164,0.39285714285714285,-344,0.41330645161290325
1994,1325,23,7,1930,503,0.7666666666666667,1427,0.7932593505959721
1994,1326,12,16,957,1163,0.42857142857142855,-206,0.4514150943396226
1994,1328,15,12,1395,985,0.5555555555555556,410,0.5861344537815126
1994,1329,21,9,1771,634,0.7,1137,0.7363825363825364
1994,1330,20,9,1741,703,0.6896551724137931,1038,0.7123567921440261
1994,1331,6,21,497,1448,0.2222222222222222,-951,0.25552699228791775
1994,1332,8,17,637,1228,0.32,-591,0.3415549597855228
1994,1333,6,20,468,1323,0.23076923076923078,-855,0.2613065326633166
1994,1334,15,14,1274,1010,0.5172413793103449,264,0.5577933450087565
1994,1335,23,2,1732,145,0.92,1587,0.9227490676611614
1994,1336,13,14,1000,895,0.48148148148148145,105,0.5277044854881267
1994,1337,17,10,1313,617,0.6296296296296297,696,0.6803108808290156
1994,1338,13,14,1088,1019,0.48148148148148145,69,0.516373991457048
1994,1339,10,17,848,1252,0.37037037037037035,-404,0.4038095238095238
1994,1341,2,22,178,1571,0.08333333333333333,-1393,0.1017724413950829
1994,1343,16,8,1082,413,0.6666666666666666,669,0.7237458193979933
1994,1344,20,9,1644,665,0.6896551724137931,979,0.7119965352966652
1994,1345,26,4,2268,279,0.8666666666666667,1989,0.8904593639575972
1994,1347,17,8,1360,530,0.68,830,0.7195767195767195
1994,1348,11,16,913,1015,0.4074074074074074,-102,0.47354771784232363
1994,1349,15,14,1212,962,0.5172413793103449,250,0.5574977000919963
1994,1350,14,14,1137,990,0.5,147,0.5345557122708039
1994,1351,21,8,1723,511,0.7241379310344828,1212,0.7712623097582811
1994,1352,14,14,1063,907,0.5,156,0.5395939086294417
1994,1353,11,16,847,984,0.4074074074074074,-137,0.4625887493173129
1994,1354,14,13,1025,913,0.5185185185185185,112,0.5288957688338494
1994,1356,22,6,1777,420,0.7857142857142857,1357,0.8088302230314065
1994,1358,7,19,574,1140,0.2692307692307692,-566,0.3348891481913652
1994,1359,8,18,602,1058,0.3076923076923077,-456,0.36265060240963853
1994,1360,16,11,1341,731,0.5925925925925926,610,0.6472007722007722
1994,1361,10,16,785,1089,0.38461538461538464,-304,0.41889007470651013
1994,1362,15,11,1416,891,0.5769230769230769,525,0.6137841352405722
1994,1363,15,12,1205,744,0.5555555555555556,461,0.6182657773217034
1994,1364,12,17,894,1048,0.41379310344827586,-154,0.4603501544799176
1994,1365,11,14,851,936,0.44,-85,0.4762171236709569
1994,1368,8,17,593,1234,0.32,-641,0.32457580733442803
1994,1369,9,17,889,1253,0.34615384615384615,-364,0.4150326797385621
1994,1371,17,12,1224,762,0.5862068965517241,462,0.6163141993957704
1994,1372,8,18,582,1199,0.3076923076923077,-617,0.32678270634475015
1994,1373,21,7,1729,523,0.75,1206,0.7677619893428064
1994,1374,6,21,426,1467,0.2222222222222222,-1041,0.22503961965134706
1994,1375,13,14,1084,906,0.48148148148148145,178,0.5447236180904522
1994,1376,9,19,714,1353,0.32142857142857145,-639,0.3454281567489115
1994,1378,10,17,732,1020,0.37037037037037035,-288,0.4178082191780822
1994,1379,15,14,1183,1038,0.5172413793103449,145,0.5326429536244934
1994,1380,12,11,1279,890,0.5217391304347826,389,0.5896726602120793
1994,1381,12,11,951,774,0.5217391304347826,177,0.551304347826087
1994,1382,10,17,767,1131,0.37037037037037035,-364,0.4041095890410959
1994,1383,1,26,78,1805,0.037037037037037035,-1727,0.04142326075411577
1994,1384,13,15,1078,1035,0.4642857142857143,43,0.5101751064836725
1994,1385,12,17,957,1169,0.41379310344827586,-212,0.4501411100658514
1994,1386,14,14,1089,948,0.5,141,0.5346097201767305
1994,1387,22,5,1840,334,0.8148148148148148,1506,0.8463661453541859
1994,1388,11,14,900,1018,0.44,-118,0.4692387904066736
1994,1389,14,13,1058,804,0.5185185185185185,254,0.5682062298603652
1994,1390,16,10,1250,696,0.6153846153846154,554,0.6423432682425488
1994,1391,13,15,922,972,0.4642857142857143,-50,0.48680042238648363
1994,1393,21,6,1847,426,0.7777777777777778,1421,0.8125824901011879
1994,1395,7,20,590,1397,0.25925925925925924,-807,0.2969300452944137
1994,1396,22,7,1478,380,0.7586206896551724,1098,0.7954790096878364
1994,1397,5,22,425,1483,0.18518518518518517,-1058,0.22274633123689727
1994,1398,17,11,1412,761,0.6071428571428571,651,0.6497929130234699
1994,1399,7,21,586,1692,0.25,-1106,0.257243195785777
1994,1400,25,7,2383,568,0.78125,1815,0.8075228736021688
1994,1401,19,10,1544,664,0.6551724137931034,880,0.6992753623188406
1994,1402,22,6,1633,420,0.7857142857142857,1213,0.7954213346322455
1994,1403,17,11,1477,859,0.6071428571428571,618,0.632277397260274
1994,1404,3,22,267,1565,0.12,-1298,0.1457423580786026
1994,1405,15,11,1148,764,0.5769230769230769,384,0.600418410041841
1994,1406,21,9,1605,598,0.7,1007,0.728551974580118
1994,1407,11,14,1115,1285,0.44,-170,0.46458333333333335
1994,1408,17,10,1437,697,0.6296296296296297,740,0.6733833177132146
1994,1409,20,7,1682,498,0.7407407407407407,1184,0.771559633027523
1994,1410,14,12,1078,824,0.5384615384615384,254,0.5667718191377498
1994,1411,15,10,1307,719,0.6,588,0.6451135241855873
1994,1412,22,7,1661,435,0.7586206896551724,1226,0.7924618320610687
1994,1414,9,20,741,1533,0.3103448275862069,-792,0.3258575197889182
1994,1416,19,8,1615,562,0.7037037037037037,1053,0.7418465778594396
1994,1417,21,6,1855,453,0.7777777777777778,1402,0.8037261698440208
1994,1418,21,7,1673,524,0.75,1149,0.7614929449248976
1994,1419,18,9,1542,658,0.6666666666666666,884,0.7009090909090909
1994,1420,5,21,407,1472,0.19230769230769232,-1065,0.21660457690260776
1994,1421,1,23,85,1331,0.041666666666666664,-1246,0.06002824858757062
1994,1422,15,12,1179,804,0.5555555555555556,375,0.594553706505295
1994,1423,18,10,1417,697,0.6428571428571429,720,0.6702932828760644
1994,1424,14,13,1126,962,0.5185185185185185,164,0.539272030651341
1994,1425,16,11,1265,690,0.5925925925925926,575,0.6470588235294118
1994,1426,5,20,403,1455,0.2,-1052,0.21689989235737353
1994,1427,10,15,827,1112,0.4,-285,0.4265085095410005
1994,1428,12,14,900,1013,0.46153846153846156,-113,0.47046523784631467
1994,1429,12,13,858,829,0.48,29,0.5085951393005335
1994,1431,14,12,987,849,0.5384615384615384,138,0.5375816993464052
1994,1433,14,13,1223,880,0.5185185185185185,343,0.5815501664289111
1994,1434,19,8,1496,540,0.7037037037037037,956,0.7347740667976425
1994,1435,16,11,1352,770,0.5925925925925926,582,0.6371347785108389
1994,1436,10,15,869,1095,0.4,-226,0.4424643584521385
1994,1437,15,12,1157,819,0.5555555555555556,338,0.5855263157894737
1994,1438,17,12,1161,712,0.5862068965517241,449,0.6198611852642819
1994,1439,18,10,1396,632,0.6428571428571429,764,0.6883629191321499
1994,1440,3,23,245,1445,0.11538461538461539,-1200,0.14497041420118342
1994,1441,10,16,766,1133,0.38461538461538464,-367,0.40337019483938913
1994,1442,6,20,441,1317,0.23076923076923078,-876,0.2508532423208191
1994,1443,19,10,1480,717,0.6551724137931034,763,0.6736458807464725
1994,1444,14,14,1093,861,0.5,232,0.5593654042988742
1994,1447,16,12,1275,837,0.5714285714285714,438,0.6036931818181818
1994,1448,20,10,1484,675,0.6666666666666666,809,0.6873552570634553
1994,1449,5,22,304,1367,0.18518518518518517,-1063,0.18192698982645122
1994,1450,18,10,1437,694,0.6428571428571429,743,0.674331299859221
1994,1451,16,10,1414,737,0.6153846153846154,677,0.6573686657368666
1994,1452,16,11,1337,759,0.5925925925925926,578,0.637881679389313
1994,1453,26,6,1799,339,0.8125,1460,0.8414405986903648
1994,1454,10,17,732,1124,0.37037037037037035,-392,0.39439655172413796
1994,1455,8,18,605,1060,0.3076923076923077,-455,0.3633633633633634
1994,1456,4,23,330,1643,0.14814814814814814,-1313,0.16725798276735934
1994,1457,3,22,261,1505,0.12,-1244,0.1477916194790487
1994,1458,17,10,1430,642,0.6296296296296297,788,0.6901544401544402
1994,1460,11,17,851,1153,0.39285714285714285,-302,0.4246506986027944
1994,1461,13,14,983,884,0.48148148148148145,99,0.5265131226566685
1994,1462,19,7,1537,519,0.7307692307692307,1018,0.747568093385214
1994,1463,9,16,625,970,0.36,-345,0.39184952978056425
1994,1464,5,21,378,1377,0.19230769230769232,-999,0.2153846153846154
1995,1102,5,19,382,1187,0.20833333333333334,-805,0.24346717654557043
1995,1103,7,18,472,1025,0.28,-553,0.3152972611890448
1995,1104,22,9,1678,587,0.7096774193548387,1091,0.7408388520971303
1995,1106,8,14,711,1082,0.36363636363636365,-371,0.3965421081985499
1995,1108,4,19,353,1479,0.17391304347826086,-1126,0.19268558951965065
1995,1110,9,19,764,1324,0.32142857142857145,-560,0.36590038314176243
1995,1111,7,20,575,1361,0.25925925925925924,-786,0.297004132231405
1995,1112,22,7,1955,507,0.7586206896551724,1448,0.7940698619008936
1995,1113,22,8,1774,593,0.7333333333333333,1181,0.7494719053654415
1995,1114,16,12,1284,797,0.5714285714285714,487,0.617011052378664
1995,1116,26,6,2336,466,0.8125,1870,0.8336902212705211
1995,1117,6,20,436,1246,0.23076923076923078,-810,0.25921521997621877
1995,1119,11,16,849,1114,0.4074074074074074,-265,0.4325012735608762
1995,1120,14,12,1135,858,0.5384615384615384,277,0.569493226292022
1995,1122,11,16,861,1145,0.4074074074074074,-284,0.4292123629112662
1995,1123,17,10,1338,721,0.6296296296296297,617,0.6498300145701797
1995,1124,8,19,741,1452,0.2962962962962963,-711,0.3378932968536252
1995,1126,10,15,864,1008,0.4,-144,0.46153846153846156
1995,1129,17,10,1291,645,0.6296296296296297,646,0.6668388429752066
1995,1130,9,19,754,1269,0.32142857142857145,-515,0.37271379139891253
1995,1131,15,16,1080,951,0.4838709677419355,129,0.5317577548005908
1995,1132,14,11,1118,618,0.56,500,0.6440092165898618
1995,1133,19,9,1420,573,0.6785714285714286,847,0.7124937280481686
1995,1135,13,13,960,804,0.5,156,0.54421768707483
1995,1137,13,14,1012,874,0.48148148148148145,138,0.5365853658536586
1995,1138,18,10,1443,727,0.6428571428571429,716,0.6649769585253457
1995,1139,14,12,1072,836,0.5384615384615384,236,0.5618448637316562
1995,1140,22,9,1697,638,0.7096774193548387,1059,0.7267665952890793
1995,1141,1,23,57,1445,0.041666666666666664,-1388,0.03794940079893475
1995,1143,13,14,1084,1074,0.48148148148148145,10,0.5023169601482854
1995,1144,6,18,406,1074,0.25,-668,0.2743243243243243
1995,1145,18,12,1354,738,0.6,616,0.6472275334608031
1995,1147,9,17,781,1298,0.34615384615384615,-517,0.37566137566137564
1995,1148,8,18,640,1183,0.3076923076923077,-543,0.3510696653867252
1995,1149,19,10,1449,700,0.6551724137931034,749,0.6742671009771987
1995,1150,19,8,1503,516,0.7037037037037037,987,0.7444279346210996
1995,1151,17,10,1279,741,0.6296296296296297,538,0.6331683168316832
1995,1152,6,20,548,1432,0.23076923076923078,-884,0.2767676767676768
1995,1153,21,11,1838,759,0.65625,1079,0.7077396996534463
1995,1154,8,16,594,977,0.3333333333333333,-383,0.3781031190324634
1995,1155,15,12,1088,652,0.5555555555555556,436,0.6252873563218391
1995,1156,8,17,623,1185,0.32,-562,0.34457964601769914
1995,1157,4,20,352,1337,0.16666666666666666,-985,0.20840734162226168
1995,1158,21,5,1548,311,0.8076923076923077,1237,0.8327057557826789
1995,1159,17,12,1449,782,0.5862068965517241,667,0.6494845360824743
1995,1160,15,12,1252,893,0.5555555555555556,359,0.5836829836829837
1995,1161,14,14,1151,917,0.5,234,0.5565764023210832
1995,1162,3,22,219,1295,0.12,-1076,0.14464993394980186
1995,1163,25,4,2166,280,0.8620689655172413,1886,0.8855273916598528
1995,1164,19,9,1470,576,0.6785714285714286,894,0.718475073313783
1995,1165,8,17,636,1088,0.32,-452,0.3689095127610209
1995,1166,7,19,461,1127,0.2692307692307692,-666,0.2903022670025189
1995,1168,7,20,519,1395,0.25925925925925924,-876,0.2711598746081505
1995,1169,7,19,592,1269,0.2692307692307692,-677,0.3181085437936593
1995,1170,6,21,436,1340,0.2222222222222222,-904,0.24549549549549549
1995,1171,12,13,882,814,0.48,68,0.5200471698113207
1995,1172,11,13,855,883,0.4583333333333333,-28,0.4919447640966628
1995,1173,7,20,555,1256,0.25925925925925924,-701,0.30646051905024846
1995,1174,10,15,784,1070,0.4,-286,0.4228694714131607
1995,1175,6,21,509,1356,0.2222222222222222,-847,0.27292225201072384
1995,1177,17,10,1397,734,0.6296296296296297,663,0.6555607695917409
1995,1178,11,15,833,964,0.4230769230769231,-131,0.46355036171396774
1995,1179,12,15,976,991,0.4444444444444444,-15,0.4961870869344179
1995,1180,22,7,1729,484,0.7586206896551724,1245,0.7812923633077271
1995,1181,13,18,1089,1321,0.41935483870967744,-232,0.45186721991701245
1995,1182,10,18,722,1186,0.35714285714285715,-464,0.37840670859538783
1995,1183,13,13,977,920,0.5,57,0.5150237216657881
1995,1184,9,19,726,1283,0.32142857142857145,-557,0.36137381781981087
1995,1185,18,9,1385,619,0.6666666666666666,766,0.6911177644710579
1995,1186,4,19,306,1212,0.17391304347826086,-906,0.2015810276679842
1995,1187,17,11,1318,725,0.6071428571428571,593,0.6451297112090064
1995,1190,11,14,930,998,0.44,-68,0.4823651452282158
1995,1191,18,9,1492,596,0.6666666666666666,896,0.7145593869731801
1995,1192,16,12,1225,833,0.5714285714285714,392,0.5952380952380952
1995,1193,13,15,1010,911,0.4642857142857143,99,0.5257678292555961
1995,1194,7,18,512,1047,0.28,-535,0.32841565105837073
1995,1196,17,12,1281,836,0.5862068965517241,445,0.6051015588096362
1995,1197,2,22,161,1522,0.08333333333333333,-1361,0.09566250742721331
1995,1198,11,18,791,1169,0.3793103448275862,-378,0.4035714285714286
1995,1199,12,15,1007,1020,0.4444444444444444,-13,0.49679329057720767
1995,1200,9,17,691,1004,0.34615384615384615,-313,0.40766961651917405
1995,1201,12,15,916,996,0.4444444444444444,-80,0.4790794979079498
1995,1202,7,17,532,1071,0.2916666666666667,-539,0.3318777292576419
1995,1203,18,13,1432,904,0.5806451612903226,528,0.613013698630137
1995,1204,4,20,276,1288,0.16666666666666666,-1012,0.17647058823529413
1995,1206,6,20,617,1742,0.23076923076923078,-1125,0.261551504874947
1995,1207,19,9,1457,658,0.6785714285714286,799,0.6888888888888889
1995,1208,18,9,1491,623,0.6666666666666666,868,0.7052980132450332
1995,1209,10,17,811,1148,0.37037037037037035,-337,0.41398672792240937
1995,1210,18,12,1563,837,0.6,726,0.65125
1995,1211,19,8,1510,563,0.7037037037037037,947,0.7284129281234926
1995,1212,7,17,627,1246,0.2916666666666667,-619,0.33475707421249334
1995,1216,11,16,849,1044,0.4074074074074074,-195,0.44849445324881143
1995,1217,5,20,368,1292,0.2,-924,0.2216867469879518
1995,1218,16,13,1195,838,0.5517241379310345,357,0.58780127889818
1995,1220,9,18,682,1224,0.3333333333333333,-542,0.3578174186778594
1995,1221,15,12,1262,829,0.5555555555555556,433,0.6035389765662362
1995,1222,8,19,663,1391,0.2962962962962963,-728,0.3227848101265823
1995,1224,9,18,711,1196,0.3333333333333333,-485,0.37283691662296803
1995,1225,9,15,689,915,0.375,-226,0.4295511221945137
1995,1226,14,10,1161,703,0.5833333333333334,458,0.6228540772532188
1995,1227,17,9,1435,734,0.6538461538461539,701,0.6615952051636699
1995,1228,18,11,1433,681,0.6206896551724138,752,0.6778618732261117
1995,1229,18,12,1461,797,0.6,664,0.6470327723649247
1995,1231,18,11,1499,694,0.6206896551724138,805,0.6835385316917465
1995,1232,6,19,496,1278,0.24,-782,0.27959413754227735
1995,1233,10,17,824,1211,0.37037037037037035,-387,0.4049140049140049
1995,1234,18,11,1629,841,0.6206896551724138,788,0.6595141700404858
1995,1235,19,10,1548,659,0.6551724137931034,889,0.7014046216583598
1995,1238,10,18,835,1316,0.35714285714285715,-481,0.38819153881915386
1995,1239,17,9,1362,616,0.6538461538461539,746,0.6885743174924166
1995,1241,16,13,1283,985,0.5517241379310345,298,0.5656966490299824
1995,1242,22,5,1925,340,0.8148148148148148,1585,0.8498896247240618
1995,1243,10,15,774,914,0.4,-140,0.4585308056872038
1995,1245,8,19,592,1165,0.2962962962962963,-573,0.3369379624359704
1995,1246,25,4,2210,330,0.8620689655172413,1880,0.8700787401574803
1995,1247,13,14,1029,965,0.48148148148148145,64,0.5160481444332999
1995,1248,1,25,78,1668,0.038461538461538464,-1590,0.044673539518900345
1995,1249,9,16,623,1012,0.36,-389,0.38103975535168194
1995,1250,10,16,844,1097,0.38461538461538464,-253,0.4348274085522926
1995,1251,10,16,702,1008,0.38461538461538464,-306,0.4105263157894737
1995,1253,19,9,1378,619,0.6785714285714286,759,0.6900350525788683
1995,1254,10,17,830,1318,0.37037037037037035,-488,0.38640595903165736
1995,1256,13,13,870,789,0.5,81,0.5244122965641953
1995,1257,19,13,1553,912,0.59375,641,0.6300202839756592
1995,1258,12,15,964,1000,0.4444444444444444,-36,0.4908350305498982
1995,1259,9,18,680,1172,0.3333333333333333,-492,0.367170626349892
1995,1260,4,22,292,1424,0.15384615384615385,-1132,0.17016317016317017
1995,1261,12,15,1077,1074,0.4444444444444444,3,0.500697350069735
1995,1263,11,16,769,1080,0.4074074074074074,-311,0.4159004867495944
1995,1264,25,4,1930,272,0.8620689655172413,1658,0.8764759309718437
1995,1265,17,11,1394,741,0.6071428571428571,653,0.652927400468384
1995,1266,17,11,1333,660,0.6071428571428571,673,0.6688409433015554
1995,1267,17,9,1510,655,0.6538461538461539,855,0.6974595842956121
1995,1268,23,7,2035,558,0.7666666666666667,1477,0.7848052448900887
1995,1269,26,4,2185,291,0.8666666666666667,1894,0.8824717285945073
1995,1270,11,16,891,1204,0.4074074074074074,-313,0.4252983293556086
1995,1271,10,14,779,844,0.4166666666666667,-65,0.47997535428219346
1995,1272,22,9,1837,621,0.7096774193548387,1216,0.7473555736371034
1995,1273,13,14,1096,989,0.48148148148148145,107,0.5256594724220623
1995,1274,15,12,1063,712,0.5555555555555556,351,0.5988732394366197
1995,1275,21,6,1502,399,0.7777777777777778,1103,0.7901104681746449
1995,1276,17,13,1279,833,0.5666666666666667,446,0.6055871212121212
1995,1277,22,5,1749,377,0.8148148148148148,1372,0.8226716839134525
1995,1278,19,11,1564,735,0.6333333333333333,829,0.6802957807742497
1995,1279,8,19,677,1201,0.2962962962962963,-524,0.3604898828541001
1995,1280,20,7,1509,472,0.7407407407407407,1037,0.7617364967188289
1995,1281,19,8,1505,589,0.7037037037037037,916,0.7187201528175741
1995,1282,7,19,549,1270,0.2692307692307692,-721,0.30181418361737217
1995,1283,16,11,1165,662,0.5925925925925926,503,0.6376573617952929
1995,1284,13,14,982,928,0.48148148148148145,54,0.5141361256544502
1995,1285,17,8,1338,557,0.68,781,0.7060686015831135
1995,1286,17,8,1464,579,0.68,885,0.7165932452276065
1995,1287,13,12,1059,775,0.52,284,0.5774263904034896
1995,1288,5,22,393,1454,0.18518518518518517,-1061,0.21277747698971305
1995,1290,14,10,1196,723,0.5833333333333334,473,0.6232412714955706
1995,1291,16,12,1332,835,0.5714285714285714,497,0.6146746654360867
1995,1292,8,15,612,1020,0.34782608695652173,-408,0.375
1995,1293,18,8,1643,550,0.6923076923076923,1093,0.749202006383949
1995,1296,18,10,1445,615,0.6428571428571429,830,0.7014563106796117
1995,1298,19,9,1478,619,0.6785714285714286,859,0.7048164043872198
1995,1299,13,13,920,821,0.5,99,0.5284319356691557
1995,1301,12,15,1048,1009,0.4444444444444444,39,0.5094798249878464
1995,1302,3,22,214,1400,0.12,-1186,0.1325898389095415
1995,1304,17,13,1485,895,0.5666666666666667,590,0.6239495798319328
1995,1305,18,11,1468,767,0.6206896551724138,701,0.6568232662192394
1995,1306,19,9,1632,624,0.6785714285714286,1008,0.723404255319149
1995,1307,14,15,1095,1054,0.4827586206896552,41,0.5095393206142392
1995,1308,22,9,1987,661,0.7096774193548387,1326,0.7503776435045317
1995,1309,19,11,1430,694,0.6333333333333333,736,0.6732580037664784
1995,1310,4,25,342,1625,0.13793103448275862,-1283,0.17386883579054396
1995,1311,22,5,2016,378,0.8148148148148148,1638,0.8421052631578947
1995,1314,24,5,2138,364,0.8275862068965517,1774,0.8545163868904876
1995,1317,11,13,862,905,0.4583333333333333,-43,0.4878324844368987
1995,1318,18,11,1376,729,0.6206896551724138,647,0.6536817102137767
1995,1319,5,17,373,1062,0.22727272727272727,-689,0.25993031358885016
1995,1320,7,20,519,1320,0.25925925925925924,-801,0.2822185970636215
1995,1321,5,22,376,1390,0.18518518518518517,-1014,0.2129105322763307
1995,1322,11,14,868,939,0.44,-71,0.4803541781959048
1995,1323,15,12,1150,749,0.5555555555555556,401,0.6055818852027383
1995,1325,22,9,1769,648,0.7096774193548387,1121,0.7318990484071163
1995,1326,6,22,524,1421,0.21428571428571427,-897,0.26940874035989715
1995,1328,23,8,1963,584,0.7419354838709677,1379,0.7707106399685905
1995,1329,21,9,1698,619,0.7,1079,0.7328441950798447
1995,1330,20,11,1619,788,0.6451612903225806,831,0.6726215205650187
1995,1331,7,17,540,1088,0.2916666666666667,-548,0.3316953316953317
1995,1332,17,8,1496,626,0.68,870,0.704995287464656
1995,1333,9,18,740,1300,0.3333333333333333,-560,0.3627450980392157
1995,1334,14,13,1118,852,0.5185185185185185,266,0.5675126903553299
1995,1335,22,5,1846,350,0.8148148148148148,1496,0.8406193078324226
1995,1336,17,10,1339,604,0.6296296296296297,735,0.6891405043746783
1995,1337,7,19,500,1217,0.2692307692307692,-717,0.29120559114735
1995,1338,10,18,753,1262,0.35714285714285715,-509,0.373697270471464
1995,1339,19,8,1460,577,0.7037037037037037,883,0.7167403043691704
1995,1341,3,21,251,1501,0.125,-1250,0.1432648401826484
1995,1343,15,10,1045,527,0.6,518,0.6647582697201018
1995,1344,15,12,1161,819,0.5555555555555556,342,0.5863636363636363
1995,1345,24,6,1896,426,0.8,1470,0.8165374677002584
1995,1347,12,12,885,760,0.5,125,0.5379939209726444
1995,1348,7,20,565,1330,0.25925925925925924,-765,0.29815303430079154
1995,1349,14,13,1083,895,0.5185185185185185,188,0.5475227502527806
1995,1350,8,20,606,1284,0.2857142857142857,-678,0.32063492063492066
1995,1351,17,11,1377,733,0.6071428571428571,644,0.6526066350710901
1995,1352,4,23,334,1523,0.14814814814814814,-1189,0.17985998922994076
1995,1353,13,15,1062,981,0.4642857142857143,81,0.5198237885462555
1995,1354,13,12,982,748,0.52,234,0.5676300578034682
1995,1356,22,8,1709,583,0.7333333333333333,1126,0.7456369982547993
1995,1358,5,19,377,1257,0.20833333333333334,-880,0.2307221542227662
1995,1359,14,11,1108,740,0.56,368,0.5995670995670995
1995,1360,10,16,843,1016,0.38461538461538464,-173,0.45346960731576114
1995,1361,8,17,528,1023,0.32,-495,0.3404255319148936
1995,1362,10,18,931,1214,0.35714285714285715,-283,0.43403263403263403
1995,1363,3,23,263,1421,0.11538461538461539,-1158,0.15617577197149643
1995,1364,13,14,1014,929,0.48148148148148145,85,0.5218733916623778
1995,1365,20,6,1592,400,0.7692307692307693,1192,0.7991967871485943
1995,1368,10,16,906,1194,0.38461538461538464,-288,0.43142857142857144
1995,1369,11,14,865,927,0.44,-62,0.48270089285714285
1995,1371,16,13,1380,955,0.5517241379310345,425,0.5910064239828694
1995,1372,12,14,1027,1219,0.46153846153846156,-192,0.4572573463935886
1995,1373,8,19,704,1204,0.2962962962962963,-500,0.3689727463312369
1995,1374,7,20,544,1351,0.25925925925925924,-807,0.2870712401055409
1995,1375,9,18,894,1390,0.3333333333333333,-496,0.3914185639229422
1995,1376,10,17,740,1067,0.37037037037037035,-327,0.4095185390149419
1995,1378,16,11,1242,732,0.5925925925925926,510,0.6291793313069909
1995,1379,16,12,1238,828,0.5714285714285714,410,0.5992255566311714
1995,1380,9,13,907,1051,0.4090909090909091,-144,0.46322778345250254
1995,1381,13,11,1129,769,0.5416666666666666,360,0.5948366701791359
1995,1382,16,12,1202,813,0.5714285714285714,389,0.5965260545905707
1995,1383,9,18,754,1289,0.3333333333333333,-535,0.3690651003426334
1995,1384,12,16,955,1051,0.42857142857142855,-96,0.4760717846460618
1995,1385,14,13,1154,997,0.5185185185185185,157,0.5364946536494654
1995,1386,17,11,1306,686,0.6071428571428571,620,0.6556224899598394
1995,1387,22,7,1751,476,0.7586206896551724,1275,0.7862595419847328
1995,1388,18,10,1353,643,0.6428571428571429,710,0.6778557114228457
1995,1389,19,10,1367,630,0.6551724137931034,737,0.684526790185278
1995,1390,19,8,1575,591,0.7037037037037037,984,0.7271468144044322
1995,1391,14,12,1162,808,0.5384615384615384,354,0.5898477157360406
1995,1393,18,9,1481,706,0.6666666666666666,775,0.6771833561957019
1995,1395,15,11,1483,927,0.5769230769230769,556,0.6153526970954357
1995,1396,19,10,1255,555,0.6551724137931034,700,0.6933701657458563
1995,1397,11,16,771,854,0.4074074074074074,-83,0.47446153846153843
1995,1398,16,10,1275,716,0.6153846153846154,559,0.640381717729784
1995,1399,10,14,797,962,0.4166666666666667,-165,0.45309835133598636
1995,1400,22,6,2108,521,0.7857142857142857,1587,0.801825789273488
1995,1401,13,16,1044,1104,0.4482758620689655,-60,0.4860335195530726
1995,1402,10,14,632,908,0.4166666666666667,-276,0.4103896103896104
1995,1403,18,9,1656,714,0.6666666666666666,942,0.6987341772151898
1995,1404,6,20,445,1284,0.23076923076923078,-839,0.2573742047426258
1995,1405,14,11,1096,698,0.56,398,0.6109253065774805
1995,1406,12,15,943,1067,0.4444444444444444,-124,0.4691542288557214
1995,1407,10,15,966,1263,0.4,-297,0.43337819650067294
1995,1408,22,9,1807,603,0.7096774193548387,1204,0.749792531120332
1995,1409,22,7,1734,477,0.7586206896551724,1257,0.7842605156037992
1995,1410,12,14,794,873,0.46153846153846156,-79,0.47630473905218956
1995,1411,20,6,1713,423,0.7692307692307693,1290,0.8019662921348315
1995,1412,14,15,1105,934,0.4827586206896552,171,0.5419323197645904
1995,1414,13,16,1028,1201,0.4482758620689655,-173,0.46119336025123375
1995,1416,10,16,844,1117,0.38461538461538464,-273,0.43039265680775113
1995,1417,25,2,2206,165,0.9259259259259259,2041,0.9304091100801349
1995,1418,5,22,322,1478,0.18518518518518517,-1156,0.17888888888888888
1995,1419,14,18,1179,1227,0.4375,-48,0.49002493765586036
1995,1420,12,14,821,896,0.46153846153846156,-75,0.47815958066394876
1995,1421,8,16,618,975,0.3333333333333333,-357,0.3879472693032015
1995,1422,23,6,1815,391,0.7931034482758621,1424,0.8227561196736174
1995,1423,16,11,1184,650,0.5925925925925926,534,0.6455834242093784
1995,1424,12,16,964,1183,0.42857142857142855,-219,0.44899860270144387
1995,1425,7,21,594,1546,0.25,-952,0.2775700934579439
1995,1426,9,17,721,1182,0.34615384615384615,-461,0.3788754598003153
1995,1427,13,13,1109,920,0.5,189,0.5465746673238048
1995,1428,25,5,2006,321,0.8333333333333334,1685,0.8620541469703481
1995,1429,19,7,1514,501,0.7307692307692307,1013,0.75136476426799
1995,1431,16,9,1251,633,0.64,618,0.6640127388535032
1995,1433,14,14,1075,887,0.5,188,0.5479102956167177
1995,1434,18,8,1445,556,0.6923076923076923,889,0.7221389305347327
1995,1435,13,15,1050,994,0.4642857142857143,56,0.5136986301369864
1995,1436,13,13,1054,892,0.5,162,0.5416238437821171
1995,1437,24,7,2001,431,0.7741935483870968,1570,0.8227796052631579
1995,1438,22,8,1802,547,0.7333333333333333,1255,0.767134951042997
1995,1439,20,10,1618,669,0.6666666666666666,949,0.7074770441626586
1995,1440,7,17,572,1309,0.2916666666666667,-737,0.30409356725146197
1995,1441,10,14,793,975,0.4166666666666667,-182,0.4485294117647059
1995,1442,18,8,1473,523,0.6923076923076923,950,0.7379759519038076
1995,1443,25,3,2000,228,0.8928571428571429,1772,0.8976660682226212
1995,1444,14,13,995,848,0.5185185185185185,147,0.539880629408573
1995,1447,10,17,814,1166,0.37037037037037035,-352,0.4111111111111111
1995,1448,24,5,1748,320,0.8275862068965517,1428,0.8452611218568665
1995,1449,9,18,639,1166,0.3333333333333333,-527,0.35401662049861493
1995,1450,14,11,1192,864,0.56,328,0.5797665369649806
1995,1451,17,8,1360,568,0.68,792,0.7053941908713693
1995,1452,12,13,969,909,0.48,60,0.5159744408945687
1995,1453,22,7,1466,437,0.7586206896551724,1029,0.7703625853914872
1995,1454,3,23,238,1507,0.11538461538461539,-1269,0.13638968481375358
1995,1455,12,14,782,869,0.46153846153846156,-87,0.47365233192004846
1995,1456,8,19,679,1216,0.2962962962962963,-537,0.358311345646438
1995,1457,6,20,484,1381,0.23076923076923078,-897,0.2595174262734584
1995,1458,13,14,996,974,0.48148148148148145,22,0.5055837563451777
1995,1460,12,17,949,1128,0.41379310344827586,-179,0.45690900337024554
1995,1461,11,15,756,927,0.4230769230769231,-171,0.44919786096256686
1995,1462,22,4,1903,278,0.8461538461538461,1625,0.8725355341586428
1995,1463,8,17,558,1038,0.32,-480,0.34962406015037595
1995,1464,16,10,1135,671,0.6153846153846154,464,0.6284606866002215
1996,1102,2,22,167,1399,0.08333333333333333,-1232,0.10664112388250319
1996,1103,2,23,149,1400,0.08,-1251,0.0961910910264687
1996,1104,16,11,1245,701,0.5925925925925926,544,0.6397738951695786
1996,1106,7,17,560,1165,0.2916666666666667,-605,0.32463768115942027
1996,1108,8,15,695,1056,0.34782608695652173,-361,0.3969160479725871
1996,1110,11,15,911,985,0.4230769230769231,-74,0.48048523206751054
1996,1111,6,20,491,1314,0.23076923076923078,-823,0.27202216066481993
1996,1112,24,6,1987,449,0.8,1538,0.8156814449917899
1996,1113,11,16,851,1129,0.4074074074074074,-278,0.4297979797979798
1996,1114,21,6,1630,390,0.7777777777777778,1240,0.806930693069307
1996,1116,18,12,1495,851,0.6,644,0.6372549019607843
1996,1117,8,18,545,1239,0.3076923076923077,-694,0.3054932735426009
1996,1119,4,20,312,1243,0.16666666666666666,-931,0.20064308681672025
1996,1120,18,12,1428,785,0.6,643,0.6452779032986896
1996,1122,17,10,1413,687,0.6296296296296297,726,0.6728571428571428
1996,1123,16,12,1241,825,0.5714285714285714,416,0.6006776379477251
1996,1124,8,17,668,1181,0.32,-513,0.36127636560302867
1996,1126,8,15,529,976,0.34782608695652173,-447,0.3514950166112957
1996,1129,14,12,957,717,0.5384615384615384,240,0.5716845878136201
1996,1130,18,10,1501,692,0.6428571428571429,809,0.6844505243958048
1996,1131,18,11,1329,708,0.6206896551724138,621,0.6524300441826215
1996,1132,12,13,893,768,0.48,125,0.5376279349789284
1996,1133,22,7,1635,443,0.7586206896551724,1192,0.7868142444658325
1996,1135,10,16,728,904,0.38461538461538464,-176,0.44607843137254904
1996,1137,15,11,1150,670,0.5769230769230769,480,0.6318681318681318
1996,1138,13,14,916,901,0.48148148148148145,15,0.5041276829939461
1996,1139,18,8,1351,516,0.6923076923076923,835,0.7236207820032137
1996,1140,15,13,1277,1026,0.5357142857142857,251,0.5544941380807642
1996,1141,4,20,292,1346,0.16666666666666666,-1054,0.17826617826617827
1996,1142,12,13,993,959,0.48,34,0.5087090163934426
1996,1143,17,10,1391,662,0.6296296296296297,729,0.6775450560155869
1996,1144,15,11,1018,666,0.5769230769230769,352,0.6045130641330166
1996,1145,19,10,1293,637,0.6551724137931034,656,0.6699481865284974
1996,1147,9,16,779,1091,0.36,-312,0.41657754010695186
1996,1148,12,15,1096,1015,0.4444444444444444,81,0.5191852202747513
1996,1149,13,13,992,856,0.5,136,0.5367965367965368
1996,1150,14,15,1057,933,0.4827586206896552,124,0.5311557788944724
1996,1151,13,12,1017,788,0.52,229,0.5634349030470914
1996,1152,2,25,205,1808,0.07407407407407407,-1603,0.10183805265772479
1996,1153,25,4,2051,282,0.8620689655172413,1769,0.87912558936991
1996,1154,7,16,539,995,0.30434782608695654,-456,0.3513689700130378
1996,1155,18,10,1327,570,0.6428571428571429,757,0.6995255666842383
1996,1156,5,21,337,1250,0.19230769230769232,-913,0.2123503465658475
1996,1157,3,21,219,1352,0.125,-1133,0.1394016549968173
1996,1158,22,3,1670,204,0.88,1466,0.8911419423692636
1996,1159,15,14,1184,921,0.5172413793103449,263,0.5624703087885986
1996,1160,9,18,804,1244,0.3333333333333333,-440,0.392578125
1996,1161,16,11,1325,764,0.5925925925925926,561,0.6342747726184778
1996,1162,6,19,407,1035,0.24,-628,0.28224687933425796
1996,1163,30,2,2512,160,0.9375,2352,0.9401197604790419
1996,1164,17,10,1382,681,0.6296296296296297,701,0.6698982064953951
1996,1165,9,16,646,938,0.36,-292,0.4078282828282828
1996,1166,13,15,940,917,0.4642857142857143,23,0.5061927840603123
1996,1168,6,20,462,1280,0.23076923076923078,-818,0.26521239954075776
1996,1169,6,18,463,1165,0.25,-702,0.2843980343980344
1996,1170,5,20,395,1302,0.2,-907,0.2327637006482027
1996,1171,15,10,1032,549,0.6,483,0.6527514231499051
1996,1172,22,4,1904,266,0.8461538461538461,1638,0.8774193548387097
1996,1173,15,14,1180,865,0.5172413793103449,315,0.5770171149144254
1996,1174,13,12,991,831,0.52,160,0.5439077936333699
1996,1175,10,17,752,1134,0.37037037037037035,-382,0.3987274655355249
1996,1177,11,18,845,1191,0.3793103448275862,-346,0.4150294695481336
1996,1178,17,11,1219,650,0.6071428571428571,569,0.6522204387372926
1996,1179,12,15,886,990,0.4444444444444444,-104,0.4722814498933902
1996,1180,25,3,2118,227,0.8928571428571429,1891,0.9031982942430704
1996,1181,18,12,1465,811,0.6,654,0.6436731107205624
1996,1182,9,18,725,1292,0.3333333333333333,-567,0.3594447198810114
1996,1183,12,15,868,993,0.4444444444444444,-125,0.4664159054271897
1996,1184,11,14,838,979,0.44,-141,0.46119977985690697
1996,1185,22,5,1887,357,0.8148148148148148,1530,0.8409090909090909
1996,1186,1,23,73,1459,0.041666666666666664,-1386,0.047650130548302874
1996,1187,16,11,1122,722,0.5925925925925926,400,0.6084598698481561
1996,1190,5,20,407,1415,0.2,-1008,0.2233809001097695
1996,1191,13,14,1056,887,0.48148148148148145,169,0.5434894493051982
1996,1192,7,20,542,1269,0.25925925925925924,-727,0.2992821645499724
1996,1193,20,9,1495,553,0.6896551724137931,942,0.72998046875
1996,1194,8,18,649,1136,0.3076923076923077,-487,0.36358543417366945
1996,1196,12,16,884,985,0.42857142857142855,-101,0.47298020331728197
1996,1197,4,19,269,1077,0.17391304347826086,-808,0.199851411589896
1996,1198,11,15,869,990,0.4230769230769231,-121,0.46745562130177515
1996,1199,13,14,1080,953,0.48148148148148145,127,0.5312346286276439
1996,1200,4,23,279,1349,0.14814814814814814,-1070,0.17137592137592136
1996,1201,19,10,1559,775,0.6551724137931034,784,0.6679520137103685
1996,1202,7,17,537,1214,0.2916666666666667,-677,0.3066818960593946
1996,1203,21,7,1672,512,0.75,1160,0.7655677655677655
1996,1204,2,23,144,1243,0.08,-1099,0.10382119682768565
1996,1206,10,16,1036,1294,0.38461538461538464,-258,0.4446351931330472
1996,1207,24,7,2047,490,0.7741935483870968,1557,0.8068584942845881
1996,1208,19,9,1570,648,0.6785714285714286,922,0.7078449053201082
1996,1209,10,15,748,1051,0.4,-303,0.41578654808226795
1996,1210,22,11,1858,767,0.6666666666666666,1091,0.7078095238095238
1996,1211,19,8,1414,516,0.7037037037037037,898,0.7326424870466322
1996,1212,10,16,818,1098,0.38461538461538464,-280,0.42693110647181626
1996,1214,7,17,548,1212,0.2916666666666667,-664,0.31136363636363634
1996,1216,6,22,484,1558,0.21428571428571427,-1074,0.23702252693437806
1996,1217,14,11,985,675,0.56,310,0.5933734939759037
1996,1218,10,18,815,1334,0.35714285714285715,-519,0.37924616100511865
1996,1220,8,18,604,1148,0.3076923076923077,-544,0.3447488584474886
1996,1221,16,13,1317,923,0.5517241379310345,394,0.5879464285714285
1996,1222,15,10,1210,693,0.6,517,0.6358381502890174
1996,1224,7,19,538,1223,0.2692307692307692,-685,0.30550823395797844
1996,1225,10,16,777,1067,0.38461538461538464,-290,0.4213665943600868
1996,1226,9,15,689,946,0.375,-257,0.42140672782874616
1996,1227,9,18,787,1266,0.3333333333333333,-479,0.38334145153434
1996,1228,18,12,1497,786,0.6,711,0.6557161629434954
1996,1229,19,11,1397,747,0.6333333333333333,650,0.6515858208955224
1996,1231,18,11,1457,757,0.6206896551724138,700,0.6580849141824752
1996,1232,10,16,733,1070,0.38461538461538464,-337,0.4065446478092069
1996,1233,21,7,1594,431,0.75,1163,0.7871604938271605
1996,1234,22,8,1811,583,0.7333333333333333,1228,0.7564745196324144
1996,1235,22,8,1532,474,0.7333333333333333,1058,0.7637088733798604
1996,1238,14,13,1129,911,0.5185185185185185,218,0.5534313725490196
1996,1239,15,13,1216,906,0.5357142857142857,310,0.5730442978322338
1996,1240,8,17,730,1289,0.32,-559,0.3615651312530956
1996,1241,10,20,780,1273,0.3333333333333333,-493,0.37993180711154406
1996,1242,25,4,2057,273,0.8620689655172413,1784,0.8828326180257511
1996,1243,16,11,1178,681,0.5925925925925926,497,0.633674018289403
1996,1245,13,13,1078,873,0.5,205,0.5525371604305485
1996,1246,28,2,2602,155,0.9333333333333333,2447,0.9437794704388829
1996,1247,6,24,429,1474,0.2,-1045,0.2254335260115607
1996,1248,7,18,535,1153,0.28,-618,0.3169431279620853
1996,1249,10,15,766,996,0.4,-230,0.43473325766174803
1996,1250,3,23,234,1527,0.11538461538461539,-1293,0.13287904599659284
1996,1251,15,12,1065,754,0.5555555555555556,311,0.5854865310610226
1996,1253,16,11,1263,730,0.5925925925925926,533,0.6337180130456598
1996,1254,8,19,683,1371,0.2962962962962963,-688,0.33252190847127555
1996,1256,10,17,677,991,0.37037037037037035,-314,0.4058752997601918
1996,1257,19,11,1547,756,0.6333333333333333,791,0.6717325227963525
1996,1258,16,11,1179,688,0.5925925925925926,491,0.6314943760042849
1996,1259,11,15,762,947,0.4230769230769231,-185,0.44587478057343477
1996,1260,7,19,570,1182,0.2692307692307692,-612,0.3253424657534247
1996,1261,11,17,920,1241,0.39285714285714285,-321,0.4257288292457196
1996,1263,15,13,1130,791,0.5357142857142857,339,0.5882352941176471
1996,1264,17,11,1230,687,0.6071428571428571,543,0.6416275430359938
1996,1265,22,6,1645,372,0.7857142857142857,1273,0.8155676747645018
1996,1266,22,7,1669,466,0.7586206896551724,1203,0.7817330210772834
1996,1267,16,11,1502,934,0.5925925925925926,568,0.6165845648604269
1996,1268,17,12,1489,872,0.5862068965517241,617,0.6306649724692927
1996,1269,31,1,2282,76,0.96875,2206,0.9677692960135709
1996,1270,15,12,1241,878,0.5555555555555556,363,0.5856536101934875
1996,1271,9,16,645,926,0.36,-281,0.4105665181413113
1996,1272,22,7,1717,425,0.7586206896551724,1292,0.8015873015873016
1996,1273,13,14,1044,964,0.48148148148148145,80,0.5199203187250996
1996,1274,15,13,1116,767,0.5357142857142857,349,0.592671269251195
1996,1275,20,7,1595,418,0.7407407407407407,1177,0.7923497267759563
1996,1276,20,11,1516,691,0.6451612903225806,825,0.686905301314001
1996,1277,14,15,939,844,0.4827586206896552,95,0.5266404935501963
1996,1278,18,12,1331,762,0.6,569,0.6359292881032012
1996,1279,11,15,867,914,0.4230769230769231,-47,0.48680516563728243
1996,1280,22,7,1717,444,0.7586206896551724,1273,0.7945395650161962
1996,1281,17,14,1456,969,0.5483870967741935,487,0.6004123711340206
1996,1282,12,15,946,942,0.4444444444444444,4,0.5010593220338984
1996,1283,16,12,1279,817,0.5714285714285714,462,0.6102099236641222
1996,1284,20,9,1462,559,0.6896551724137931,903,0.723404255319149
1996,1285,17,8,1329,563,0.68,766,0.702431289640592
1996,1286,19,8,1597,595,0.7037037037037037,1002,0.728558394160584
1996,1287,3,20,219,1346,0.13043478260869565,-1127,0.13993610223642172
1996,1288,7,20,502,1351,0.25925925925925924,-849,0.2709120345385861
1996,1290,18,6,1589,470,0.75,1119,0.7717338513841671
1996,1291,21,7,1676,468,0.75,1208,0.7817164179104478
1996,1292,13,12,1036,831,0.52,205,0.5549009105516872
1996,1293,16,9,1312,631,0.64,681,0.6752444673185796
1996,1296,19,9,1511,549,0.6785714285714286,962,0.733495145631068
1996,1298,13,12,884,709,0.52,175,0.5549278091650973
1996,1299,8,16,554,1023,0.3333333333333333,-469,0.3512999365884591
1996,1301,15,16,1336,1171,0.4838709677419355,165,0.5329078579976066
1996,1302,12,13,990,930,0.48,60,0.515625
1996,1304,16,14,1361,1041,0.5333333333333333,320,0.5666111573688593
1996,1305,16,13,1246,873,0.5517241379310345,373,0.588013213780085
1996,1306,6,21,520,1480,0.2222222222222222,-960,0.26
1996,1307,26,4,2100,255,0.8666666666666667,1845,0.89171974522293
1996,1308,10,15,722,965,0.4,-243,0.42797866034380555
1996,1309,21,8,1564,552,0.7241379310344828,1012,0.7391304347826086
1996,1310,13,15,872,908,0.4642857142857143,-36,0.4898876404494382
1996,1311,5,21,356,1368,0.19230769230769232,-1012,0.20649651972157773
1996,1314,20,10,1599,729,0.6666666666666666,870,0.6868556701030928
1996,1317,15,13,1071,813,0.5357142857142857,258,0.5684713375796179
1996,1318,4,24,303,1520,0.14285714285714285,-1217,0.1662095447065277
1996,1319,4,20,293,1287,0.16666666666666666,-994,0.18544303797468353
1996,1320,14,13,1163,920,0.5185185185185185,243,0.5583293326932309
1996,1321,7,20,506,1222,0.25925925925925924,-716,0.29282407407407407
1996,1322,5,20,371,1316,0.2,-945,0.21991701244813278
1996,1323,9,18,695,1108,0.3333333333333333,-413,0.38546866333887964
1996,1325,15,14,1203,921,0.5172413793103449,282,0.5663841807909604
1996,1326,10,17,809,999,0.37037037037037035,-190,0.44745575221238937
1996,1328,17,12,1508,820,0.5862068965517241,688,0.647766323024055
1996,1329,16,10,1211,609,0.6153846153846154,602,0.6653846153846154
1996,1330,17,13,1268,863,0.5666666666666667,405,0.5950258094791178
1996,1331,16,9,1262,575,0.64,687,0.6869896570495373
1996,1332,13,13,921,965,0.5,-44,0.4883351007423118
1996,1333,4,22,251,1193,0.15384615384615385,-942,0.17382271468144045
1996,1334,14,12,1113,776,0.5384615384615384,337,0.5892006352567496
1996,1335,17,10,1251,603,0.6296296296296297,648,0.6747572815533981
1996,1336,21,6,1676,339,0.7777777777777778,1337,0.8317617866004963
1996,1337,9,18,698,1178,0.3333333333333333,-480,0.3720682302771855
1996,1338,10,17,852,1096,0.37037037037037035,-244,0.43737166324435317
1996,1339,17,10,1363,669,0.6296296296296297,694,0.6707677165354331
1996,1343,20,6,1264,291,0.7692307692307693,973,0.8128617363344052
1996,1344,17,11,1398,796,0.6071428571428571,602,0.6371923427529627
1996,1345,25,5,1874,322,0.8333333333333334,1552,0.8533697632058288
1996,1347,12,13,948,887,0.48,61,0.5166212534059945
1996,1348,18,13,1497,899,0.5806451612903226,598,0.6247913188647746
1996,1349,14,14,993,918,0.5,75,0.5196232339089482
1996,1350,8,20,639,1286,0.2857142857142857,-647,0.33194805194805194
1996,1351,19,11,1530,708,0.6333333333333333,822,0.6836461126005362
1996,1352,4,23,291,1426,0.14814814814814814,-1135,0.16948165404775772
1996,1353,8,18,584,1234,0.3076923076923077,-650,0.32123212321232125
1996,1354,20,7,1519,431,0.7407407407407407,1088,0.778974358974359
1996,1356,10,17,756,1146,0.37037037037037035,-390,0.39747634069400634
1996,1358,11,14,900,927,0.44,-27,0.49261083743842365
1996,1359,14,11,1038,672,0.56,366,0.6070175438596491
1996,1360,13,14,976,848,0.48148148148148145,128,0.5350877192982456
1996,1361,13,14,1045,1009,0.48148148148148145,36,0.508763388510224
1996,1362,13,12,851,756,0.52,95,0.5295581829495956
1996,1363,13,16,1022,1067,0.4482758620689655,-45,0.48922929631402584
1996,1364,11,15,831,980,0.4230769230769231,-149,0.45886250690226393
1996,1365,19,8,1424,488,0.7037037037037037,936,0.7447698744769874
1996,1368,13,12,1129,971,0.52,158,0.5376190476190477
1996,1369,7,19,538,1285,0.2692307692307692,-747,0.29511793746571585
1996,1371,12,16,970,1084,0.42857142857142855,-114,0.47224926971762415
1996,1372,15,11,1236,806,0.5769230769230769,430,0.6052889324191969
1996,1373,5,22,379,1302,0.18518518518518517,-923,0.22546103509815585
1996,1374,6,20,436,1227,0.23076923076923078,-791,0.26217678893565843
1996,1375,11,15,742,733,0.4230769230769231,9,0.5030508474576271
1996,1376,17,11,1432,749,0.6071428571428571,683,0.6565795506648326
1996,1378,12,16,873,958,0.42857142857142855,-85,0.4767886400873839
1996,1379,11,15,798,974,0.4230769230769231,-176,0.4503386004514673
1996,1380,13,12,1287,943,0.52,344,0.5771300448430493
1996,1381,11,13,830,921,0.4583333333333333,-91,0.47401484865790977
1996,1382,10,18,703,1071,0.35714285714285715,-368,0.39627959413754227
1996,1383,9,18,668,1139,0.3333333333333333,-471,0.36967349197565025
1996,1384,13,14,976,797,0.48148148148148145,179,0.5504794134235759
1996,1385,11,16,868,1187,0.4074074074074074,-319,0.42238442822384425
1996,1386,15,12,1129,856,0.5555555555555556,273,0.5687657430730478
1996,1387,16,13,1146,739,0.5517241379310345,407,0.6079575596816976
1996,1388,12,15,904,1034,0.4444444444444444,-130,0.4664602683178535
1996,1389,15,12,1100,734,0.5555555555555556,366,0.5997818974918212
1996,1390,19,8,1523,518,0.7037037037037037,1005,0.746202841744243
1996,1391,8,17,641,1031,0.32,-390,0.3833732057416268
1996,1393,24,8,1913,540,0.75,1373,0.77986139421117
1996,1395,14,14,1219,1098,0.5,121,0.5261113508847648
1996,1396,19,12,1224,631,0.6129032258064516,593,0.6598382749326146
1996,1397,14,14,971,793,0.5,178,0.550453514739229
1996,1398,15,12,1156,844,0.5555555555555556,312,0.578
1996,1399,10,15,857,1070,0.4,-213,0.44473274519979245
1996,1400,20,9,1758,635,0.6896551724137931,1123,0.734642707898036
1996,1401,11,16,790,1025,0.4074074074074074,-235,0.43526170798898073
1996,1402,9,15,618,834,0.375,-216,0.4256198347107438
1996,1403,28,1,2296,77,0.9655172413793104,2219,0.967551622418879
1996,1404,10,14,793,982,0.4166666666666667,-189,0.4467605633802817
1996,1405,15,14,1159,933,0.5172413793103449,226,0.5540152963671128
1996,1406,15,12,1162,835,0.5555555555555556,327,0.5818728092138208
1996,1407,9,16,894,1417,0.36,-523,0.386845521419299
1996,1408,18,9,1428,631,0.6666666666666666,797,0.6935405536668285
1996,1409,22,7,1734,478,0.7586206896551724,1256,0.7839059674502713
1996,1410,8,19,494,1111,0.2962962962962963,-617,0.30778816199376946
1996,1411,9,14,713,1052,0.391304347826087,-339,0.4039660056657224
1996,1412,14,14,982,914,0.5,68,0.5179324894514767
1996,1414,15,12,1179,847,0.5555555555555556,332,0.5819348469891412
1996,1416,10,18,820,1252,0.35714285714285715,-432,0.39575289575289574
1996,1417,23,7,1861,497,0.7666666666666667,1364,0.7892281594571671
1996,1418,14,12,1134,762,0.5384615384615384,372,0.5981012658227848
1996,1419,15,13,1287,868,0.5357142857142857,419,0.597215777262181
1996,1420,5,22,343,1252,0.18518518518518517,-909,0.21504702194357367
1996,1421,14,10,1055,596,0.5833333333333334,459,0.6390066626287099
1996,1422,20,9,1529,539,0.6896551724137931,990,0.7393617021276596
1996,1423,13,16,854,812,0.4482758620689655,42,0.5126050420168067
1996,1424,10,16,714,1029,0.38461538461538464,-315,0.40963855421686746
1996,1425,11,19,920,1264,0.36666666666666664,-344,0.42124542124542125
1996,1426,10,15,775,1004,0.4,-229,0.4356379988757729
1996,1427,13,13,976,997,0.5,-21,0.49467815509376584
1996,1428,23,6,1824,392,0.7931034482758621,1432,0.8231046931407943
1996,1429,14,15,1038,979,0.4827586206896552,59,0.5146256817055033
1996,1431,11,15,824,1030,0.4230769230769231,-206,0.4444444444444444
1996,1433,24,8,1823,564,0.75,1259,0.763720150816925
1996,1434,19,10,1564,737,0.6551724137931034,827,0.6797044763146458
1996,1435,16,13,1267,902,0.5517241379310345,365,0.5841401567542647
1996,1436,11,14,958,894,0.44,64,0.5172786177105831
1996,1437,25,6,1931,405,0.8064516129032258,1526,0.8266267123287672
1996,1438,12,15,908,967,0.4444444444444444,-59,0.4842666666666667
1996,1439,22,5,1626,289,0.8148148148148148,1337,0.8490861618798956
1996,1440,15,10,1329,731,0.6,598,0.6451456310679612
1996,1441,15,11,1322,818,0.5769230769230769,504,0.6177570093457944
1996,1442,15,12,1261,704,0.5555555555555556,557,0.6417302798982188
1996,1443,13,13,1004,967,0.5,37,0.5093860984271943
1996,1444,15,12,1108,795,0.5555555555555556,313,0.582238570677877
1996,1447,10,17,842,1152,0.37037037037037035,-310,0.4222668004012036
1996,1448,23,5,1696,258,0.8214285714285714,1438,0.8679631525076765
1996,1449,16,11,1203,707,0.5925925925925926,496,0.6298429319371728
1996,1450,16,11,1240,787,0.5925925925925926,453,0.6117414898865319
1996,1451,18,10,1592,729,0.6428571428571429,863,0.6859112451529513
1996,1452,12,15,1066,1086,0.4444444444444444,-20,0.49535315985130113
1996,1453,24,3,1614,156,0.8888888888888888,1458,0.911864406779661
1996,1454,8,18,611,1200,0.3076923076923077,-589,0.33738266151297625
1996,1455,8,21,571,1199,0.27586206896551724,-628,0.3225988700564972
1996,1456,9,16,706,1117,0.36,-411,0.3872737246297312
1996,1457,6,19,451,1250,0.24,-799,0.26513815402704294
1996,1458,15,14,1095,798,0.5172413793103449,297,0.5784469096671949
1996,1459,1,22,81,1324,0.043478260869565216,-1243,0.05765124555160142
1996,1460,13,13,997,885,0.5,112,0.5297555791710946
1996,1461,11,15,872,999,0.4230769230769231,-127,0.4660609299839658
1996,1462,13,15,1080,1030,0.4642857142857143,50,0.5118483412322274
1996,1463,7,18,471,1054,0.28,-583,0.30885245901639347
1996,1464,10,15,748,912,0.4,-164,0.4506024096385542
1997,1102,4,18,339,1134,0.18181818181818182,-795,0.23014256619144602
1997,1103,7,18,580,1181,0.28,-601,0.32935831913685404
1997,1104,16,14,1183,888,0.5333333333333333,295,0.5712216320618059
1997,1106,8,20,615,1170,0.2857142857142857,-555,0.3445378151260504
1997,1108,9,15,682,1018,0.375,-336,0.4011764705882353
1997,1110,10,16,740,990,0.38461538461538464,-250,0.4277456647398844
1997,1111,12,14,920,896,0.46153846153846156,24,0.5066079295154186
1997,1112,19,9,1714,669,0.6785714285714286,1045,0.7192614351657575
1997,1113,8,20,649,1321,0.2857142857142857,-672,0.32944162436548224
1997,1114,14,11,1087,737,0.56,350,0.5959429824561403
1997,1116,15,12,1299,839,0.5555555555555556,460,0.607577174929841
1997,1117,13,12,1029,788,0.52,241,0.5663181067694001
1997,1119,8,16,594,1050,0.3333333333333333,-456,0.3613138686131387
1997,1120,14,15,1028,841,0.4827586206896552,187,0.5500267522739433
1997,1122,15,14,1256,988,0.5172413793103449,268,0.5597147950089126
1997,1123,15,13,1229,856,0.5357142857142857,373,0.5894484412470024
1997,1124,17,12,1272,787,0.5862068965517241,485,0.6177756192326372
1997,1126,11,16,829,1036,0.4074074074074074,-207,0.44450402144772116
1997,1129,14,13,1007,775,0.5185185185185185,232,0.5650953984287318
1997,1130,21,8,1598,557,0.7241379310344828,1041,0.7415313225058004
1997,1131,25,4,1717,251,0.8620689655172413,1466,0.8724593495934959
1997,1132,21,9,1784,645,0.7,1139,0.7344586249485385
1997,1133,16,12,1102,713,0.5714285714285714,389,0.6071625344352617
1997,1135,4,22,263,1122,0.15384615384615385,-859,0.18989169675090253
1997,1137,17,11,1238,715,0.6071428571428571,523,0.6338965693804404
1997,1138,17,11,1312,690,0.6071428571428571,622,0.6553446553446554
1997,1139,21,9,1480,580,0.7,900,0.7184466019417476
1997,1140,1,25,64,1483,0.038461538461538464,-1419,0.04137039431157078
1997,1141,6,19,499,1294,0.24,-795,0.27830451756832125
1997,1142,11,16,916,1221,0.4074074074074074,-305,0.4286382779597567
1997,1143,21,8,1653,562,0.7241379310344828,1091,0.7462753950338601
1997,1144,9,16,655,950,0.36,-295,0.40809968847352024
1997,1145,17,12,1164,658,0.5862068965517241,506,0.6388583973655324
1997,1147,7,18,534,1260,0.28,-726,0.2976588628762542
1997,1148,8,19,521,1152,0.2962962962962963,-631,0.3114166168559474
1997,1149,15,12,1071,839,0.5555555555555556,232,0.5607329842931937
1997,1150,21,8,1561,519,0.7241379310344828,1042,0.7504807692307692
1997,1151,18,10,1386,683,0.6428571428571429,703,0.6698888351860802
1997,1152,4,23,352,1511,0.14814814814814814,-1159,0.18894256575415996
1997,1153,25,7,2107,484,0.78125,1623,0.8131995368583559
1997,1154,9,14,723,857,0.391304347826087,-134,0.45759493670886076
1997,1155,21,9,1482,550,0.7,932,0.7293307086614174
1997,1156,9,19,622,1189,0.32142857142857145,-567,0.3434566537824406
1997,1157,9,15,662,853,0.375,-191,0.43696369636963694
1997,1158,26,2,2116,114,0.9285714285714286,2002,0.9488789237668162
1997,1159,12,16,1000,1005,0.42857142857142855,-5,0.49875311720698257
1997,1160,21,9,1617,587,0.7,1030,0.7336660617059891
1997,1161,17,9,1310,627,0.6538461538461539,683,0.6763035622096025
1997,1162,5,20,374,1179,0.2,-805,0.24082421120412106
1997,1163,14,14,997,824,0.5,173,0.5475013728720484
1997,1164,21,8,1692,602,0.7241379310344828,1090,0.7375762859633828
1997,1165,14,11,947,639,0.56,308,0.5970996216897856
1997,1166,15,15,1047,977,0.5,70,0.517292490118577
1997,1168,13,14,1053,915,0.48148148148148145,138,0.5350609756097561
1997,1169,11,15,913,1051,0.4230769230769231,-138,0.464867617107943
1997,1170,2,21,172,1215,0.08695652173913043,-1043,0.1240086517664023
1997,1171,17,8,1218,489,0.68,729,0.7135325131810193
1997,1172,15,10,1187,640,0.6,547,0.6496989600437876
1997,1173,13,14,1037,866,0.48148148148148145,171,0.5449290593799264
1997,1174,13,16,1055,1106,0.4482758620689655,-51,0.4881999074502545
1997,1175,7,20,551,1262,0.25925925925925924,-711,0.3039161610590182
1997,1177,3,23,216,1221,0.11538461538461539,-1005,0.15031315240083507
1997,1178,15,13,1071,752,0.5357142857142857,319,0.5874931431705979
1997,1179,2,26,142,1609,0.07142857142857142,-1467,0.08109651627641348
1997,1180,22,8,1706,476,0.7333333333333333,1230,0.7818515123739689
1997,1181,23,8,1906,565,0.7419354838709677,1341,0.7713476325374342
1997,1182,9,18,761,1219,0.3333333333333333,-458,0.3843434343434343
1997,1183,10,15,802,1029,0.4,-227,0.4380120152921901
1997,1184,7,18,556,1131,0.28,-575,0.32957913455838767
1997,1185,19,10,1560,747,0.6551724137931034,813,0.6762028608582574
1997,1186,6,17,449,1127,0.2608695652173913,-678,0.2848984771573604
1997,1187,16,10,1136,626,0.6153846153846154,510,0.64472190692395
1997,1190,5,20,363,1087,0.2,-724,0.2503448275862069
1997,1191,17,14,1114,851,0.5483870967741935,263,0.5669211195928753
1997,1192,18,10,1379,647,0.6428571428571429,732,0.6806515301085884
1997,1193,11,18,841,1076,0.3793103448275862,-235,0.43870631194574855
1997,1194,14,11,1046,690,0.56,356,0.6025345622119815
1997,1196,12,17,957,1170,0.41379310344827586,-213,0.44992947813822287
1997,1197,8,19,611,1250,0.2962962962962963,-639,0.3283181085437937
1997,1198,16,13,1334,904,0.5517241379310345,430,0.5960679177837355
1997,1199,16,11,1298,680,0.5925925925925926,618,0.6562184024266936
1997,1200,6,21,394,1270,0.2222222222222222,-876,0.23677884615384615
1997,1201,19,11,1605,830,0.6333333333333333,775,0.6591375770020534
1997,1202,8,17,545,1072,0.32,-527,0.3370439084724799
1997,1203,15,13,1068,828,0.5357142857142857,240,0.5632911392405063
1997,1204,8,18,583,972,0.3076923076923077,-389,0.37491961414791
1997,1206,10,17,880,1269,0.37037037037037035,-389,0.4094927873429502
1997,1207,19,9,1339,587,0.6785714285714286,752,0.6952232606438213
1997,1208,24,8,1764,542,0.75,1222,0.7649609713790113
1997,1209,8,17,586,1103,0.32,-517,0.3469508584961516
1997,1210,9,18,615,1045,0.3333333333333333,-430,0.3704819277108434
1997,1211,13,12,1008,758,0.52,250,0.5707814269535674
1997,1212,9,16,650,1008,0.36,-358,0.39203860072376356
1997,1214,8,19,599,1217,0.2962962962962963,-618,0.32984581497797355
1997,1216,17,11,1296,759,0.6071428571428571,537,0.6306569343065693
1997,1217,16,9,1150,551,0.64,599,0.6760728982951205
1997,1218,20,7,1565,458,0.7407407407407407,1107,0.7736035590706871
1997,1220,11,15,803,906,0.4230769230769231,-103,0.46986541837331774
1997,1221,8,19,580,1235,0.2962962962962963,-655,0.31955922865013775
1997,1222,10,15,801,1020,0.4,-219,0.43986820428336076
1997,1224,7,19,563,1293,0.2692307692307692,-730,0.30334051724137934
1997,1225,8,17,534,994,0.32,-460,0.3494764397905759
1997,1226,11,13,885,874,0.4583333333333333,11,0.503126776577601
1997,1227,15,14,1069,816,0.5172413793103449,253,0.5671087533156499
1997,1228,21,9,1703,592,0.7,1111,0.7420479302832244
1997,1229,24,5,1816,353,0.8275862068965517,1463,0.8372521899492854
1997,1231,22,10,1641,694,0.6875,947,0.7027837259100642
1997,1232,12,16,945,998,0.42857142857142855,-53,0.4863612969634586
1997,1233,22,7,1811,443,0.7586206896551724,1368,0.8034605146406388
1997,1234,20,9,1558,547,0.6896551724137931,1011,0.7401425178147268
1997,1235,20,8,1410,474,0.7142857142857143,936,0.7484076433121019
1997,1238,13,15,1028,969,0.4642857142857143,59,0.514772158237356
1997,1239,5,23,431,1645,0.17857142857142858,-1214,0.20761078998073218
1997,1240,9,16,682,1104,0.36,-422,0.3818589025755879
1997,1241,15,13,1099,844,0.5357142857142857,255,0.5656201749871334
1997,1242,31,1,2639,94,0.96875,2545,0.9656055616538602
1997,1243,9,17,661,1004,0.34615384615384615,-343,0.396996996996997
1997,1245,7,18,522,1158,0.28,-636,0.3107142857142857
1997,1246,29,4,2457,285,0.8787878787878788,2172,0.8960612691466083
1997,1247,10,17,712,1065,0.37037037037037035,-353,0.4006752954417558
1997,1248,9,17,692,1037,0.34615384615384615,-345,0.40023134759976864
1997,1249,13,12,1025,799,0.52,226,0.5619517543859649
1997,1250,1,26,79,1668,0.037037037037037035,-1589,0.045220377790498
1997,1251,20,9,1439,503,0.6896551724137931,936,0.7409886714727085
1997,1253,13,14,1010,947,0.48148148148148145,63,0.516096065406234
1997,1254,21,8,1977,678,0.7241379310344828,1299,0.7446327683615819
1997,1256,14,13,975,806,0.5185185185185185,169,0.5474452554744526
1997,1257,23,8,1871,479,0.7419354838709677,1392,0.7961702127659575
1997,1258,6,21,432,1400,0.2222222222222222,-968,0.23580786026200873
1997,1259,13,14,955,903,0.48148148148148145,52,0.5139935414424112
1997,1260,11,15,815,852,0.4230769230769231,-37,0.48890221955608876
1997,1261,10,20,761,1239,0.3333333333333333,-478,0.3805
1997,1263,10,18,667,1088,0.35714285714285715,-421,0.3800569800569801
1997,1264,9,18,631,1002,0.3333333333333333,-371,0.38640538885486836
1997,1265,6,22,414,1383,0.21428571428571427,-969,0.2303839732888147
1997,1266,22,8,1567,483,0.7333333333333333,1084,0.764390243902439
1997,1267,19,9,1579,635,0.6785714285714286,944,0.7131887985546522
1997,1268,21,10,1662,678,0.6774193548387096,984,0.7102564102564103
1997,1269,18,13,1264,812,0.5806451612903226,452,0.6088631984585742
1997,1270,16,12,1427,850,0.5714285714285714,577,0.626701800614844
1997,1271,8,17,623,1163,0.32,-540,0.34882418812989924
1997,1272,16,14,1079,811,0.5333333333333333,268,0.5708994708994709
1997,1273,2,22,154,1366,0.08333333333333333,-1212,0.1013157894736842
1997,1274,16,12,1111,713,0.5714285714285714,398,0.6091008771929824
1997,1275,21,8,1589,556,0.7241379310344828,1033,0.7407925407925408
1997,1276,19,11,1491,727,0.6333333333333333,764,0.6722272317403066
1997,1277,16,11,1192,705,0.5925925925925926,487,0.628360569319979
1997,1278,26,3,2022,222,0.896551724137931,1800,0.9010695187165776
1997,1279,19,8,1424,481,0.7037037037037037,943,0.74750656167979
1997,1280,11,18,821,1055,0.3793103448275862,-234,0.43763326226012794
1997,1281,15,17,1243,1120,0.46875,123,0.5260262378332629
1997,1282,8,17,649,1085,0.32,-436,0.3742791234140715
1997,1283,24,8,1905,534,0.75,1371,0.7810578105781057
1997,1284,18,11,1398,666,0.6206896551724138,732,0.6773255813953488
1997,1285,17,10,1279,717,0.6296296296296297,562,0.6407815631262525
1997,1286,12,13,1027,878,0.48,149,0.5391076115485565
1997,1287,6,19,523,1471,0.24,-948,0.2622868605817452
1997,1288,9,18,701,1128,0.3333333333333333,-427,0.38326954620010933
1997,1290,17,10,1459,746,0.6296296296296297,713,0.6616780045351474
1997,1291,14,13,1042,901,0.5185185185185185,141,0.5362840967575914
1997,1292,16,12,1316,793,0.5714285714285714,523,0.6239924134660977
1997,1293,17,9,1406,606,0.6538461538461539,800,0.6988071570576541
1997,1296,11,15,803,936,0.4230769230769231,-133,0.46175963197239794
1997,1298,18,8,1374,500,0.6923076923076923,874,0.7331910352187834
1997,1299,13,12,1007,780,0.52,227,0.5635142697257974
1997,1301,15,14,964,717,0.5172413793103449,247,0.5734681737061273
1997,1302,14,12,1048,881,0.5384615384615384,167,0.543286677034733
1997,1304,16,14,1238,957,0.5333333333333333,281,0.564009111617312
1997,1305,19,9,1495,572,0.6785714285714286,923,0.7232704402515723
1997,1306,7,20,450,1140,0.25925925925925924,-690,0.2830188679245283
1997,1307,23,7,1837,436,0.7666666666666667,1401,0.8081830180378354
1997,1308,17,9,1390,660,0.6538461538461539,730,0.6780487804878049
1997,1309,22,6,1650,362,0.7857142857142857,1288,0.820079522862823
1997,1310,11,17,809,1141,0.39285714285714285,-332,0.4148717948717949
1997,1311,8,16,694,1127,0.3333333333333333,-433,0.3811092806150467
1997,1314,24,6,1925,411,0.8,1514,0.8240582191780822
1997,1317,7,16,535,966,0.30434782608695654,-431,0.3564290473017988
1997,1318,7,20,469,1251,0.25925925925925924,-782,0.27267441860465114
1997,1319,19,5,1492,376,0.7916666666666666,1116,0.7987152034261242
1997,1320,16,12,1212,784,0.5714285714285714,428,0.6072144288577155
1997,1321,7,22,474,1243,0.2413793103448276,-769,0.27606290040768783
1997,1322,12,15,933,991,0.4444444444444444,-58,0.48492723492723494
1997,1323,14,13,1075,832,0.5185185185185185,243,0.5637126376507604
1997,1325,16,10,1253,669,0.6153846153846154,584,0.6519250780437045
1997,1326,10,17,776,1111,0.37037037037037035,-335,0.4112347641759406
1997,1328,19,10,1500,661,0.6551724137931034,839,0.6941230911614993
1997,1329,16,14,1171,907,0.5333333333333333,264,0.5635226179018287
1997,1330,22,10,1622,666,0.6875,956,0.708916083916084
1997,1331,19,6,1502,379,0.76,1123,0.7985114300903775
1997,1332,16,10,1308,682,0.6153846153846154,626,0.6572864321608041
1997,1333,5,20,371,1335,0.2,-964,0.2174677608440797
1997,1334,22,5,1557,383,0.8148148148148148,1174,0.8025773195876289
1997,1335,12,14,874,866,0.46153846153846156,8,0.5022988505747127
1997,1336,10,17,649,985,0.37037037037037035,-336,0.39718482252141984
1997,1337,5,21,367,1188,0.19230769230769232,-821,0.2360128617363344
1997,1338,16,14,1222,826,0.5333333333333333,396,0.5966796875
1997,1339,7,18,515,1143,0.28,-628,0.3106151990349819
1997,1341,7,17,539,1104,0.2916666666666667,-565,0.3280584297017651
1997,1343,23,3,1500,171,0.8846153846153846,1329,0.8976660682226212
1997,1344,20,11,1540,775,0.6451612903225806,765,0.6652267818574514
1997,1345,17,11,1279,739,0.6071428571428571,540,0.6337958374628345
1997,1347,14,13,1075,869,0.5185185185185185,206,0.5529835390946503
1997,1348,20,9,1706,638,0.6896551724137931,1068,0.7278156996587031
1997,1349,10,15,722,906,0.4,-184,0.44348894348894347
1997,1350,13,15,991,935,0.4642857142857143,56,0.5145379023883697
1997,1351,14,13,1047,874,0.5185185185185185,173,0.5450286309213951
1997,1352,4,23,296,1489,0.14814814814814814,-1193,0.16582633053221288
1997,1353,11,16,723,1016,0.4074074074074074,-293,0.41575618171362855
1997,1354,13,12,990,720,0.52,270,0.5789473684210527
1997,1356,13,17,1011,1172,0.43333333333333335,-161,0.4631241410902428
1997,1358,8,18,594,1085,0.3076923076923077,-491,0.35378201310303753
1997,1359,17,9,1220,547,0.6538461538461539,673,0.6904357668364459
1997,1360,15,11,1127,711,0.5769230769230769,416,0.6131664853101197
1997,1361,11,15,928,1028,0.4230769230769231,-100,0.47443762781186094
1997,1362,14,12,987,776,0.5384615384615384,211,0.5598411798071469
1997,1363,12,14,850,907,0.46153846153846156,-57,0.48377916903813317
1997,1364,10,15,733,967,0.4,-234,0.43117647058823527
1997,1365,16,11,1166,749,0.5925925925925926,417,0.6088772845953002
1997,1368,8,18,597,1267,0.3076923076923077,-670,0.32027896995708155
1997,1369,10,17,778,1161,0.37037037037037035,-383,0.40123775141825685
1997,1371,9,18,689,1146,0.3333333333333333,-457,0.3754768392370572
1997,1372,10,15,797,1019,0.4,-222,0.43887665198237885
1997,1373,9,18,686,1082,0.3333333333333333,-396,0.38800904977375567
1997,1374,15,12,1119,702,0.5555555555555556,417,0.6144975288303131
1997,1375,21,6,1449,310,0.7777777777777778,1139,0.8237635019897669
1997,1376,23,7,1766,476,0.7666666666666667,1290,0.7876895628902766
1997,1378,8,19,532,1081,0.2962962962962963,-549,0.32982021078735274
1997,1379,12,15,790,860,0.4444444444444444,-70,0.47878787878787876
1997,1380,6,17,530,1265,0.2608695652173913,-735,0.29526462395543174
1997,1381,5,17,366,969,0.22727272727272727,-603,0.27415730337078653
1997,1382,14,14,1022,935,0.5,87,0.5222278998467041
1997,1383,13,15,843,978,0.4642857142857143,-135,0.46293245469522243
1997,1384,12,15,857,1028,0.4444444444444444,-171,0.4546419098143236
1997,1385,13,14,925,890,0.48148148148148145,35,0.509641873278237
1997,1386,24,6,1747,380,0.8,1367,0.8213446168312176
1997,1387,11,18,722,955,0.3793103448275862,-233,0.43053070960047707
1997,1388,21,7,1514,471,0.75,1043,0.7627204030226701
1997,1389,13,15,826,836,0.4642857142857143,-10,0.4969915764139591
1997,1390,18,7,1498,504,0.72,994,0.7482517482517482
1997,1391,7,18,510,1014,0.28,-504,0.3346456692913386
1997,1393,19,12,1526,804,0.6129032258064516,722,0.6549356223175966
1997,1395,21,12,1854,920,0.6363636363636364,934,0.6683489545782264
1997,1396,19,10,1299,637,0.6551724137931034,662,0.6709710743801653
1997,1397,11,16,735,810,0.4074074074074074,-75,0.47572815533980584
1997,1398,9,18,746,1240,0.3333333333333333,-494,0.3756294058408862
1997,1399,13,13,1049,871,0.5,178,0.5463541666666667
1997,1400,16,11,1310,764,0.5925925925925926,546,0.6316297010607522
1997,1401,9,18,630,1124,0.3333333333333333,-494,0.35917901938426455
1997,1402,15,12,1180,748,0.5555555555555556,432,0.6120331950207469
1997,1403,19,9,1560,683,0.6785714285714286,877,0.6954971020954079
1997,1404,9,16,702,983,0.36,-281,0.4166172106824926
1997,1405,12,14,921,932,0.46153846153846156,-11,0.4970318402590394
1997,1406,9,19,722,1365,0.32142857142857145,-643,0.34595112601820793
1997,1407,15,11,1234,805,0.5769230769230769,429,0.6051986267778323
1997,1408,18,10,1414,626,0.6428571428571429,788,0.6931372549019608
1997,1409,23,9,1761,562,0.71875,1199,0.758071459319845
1997,1410,1,25,57,1358,0.038461538461538464,-1301,0.040282685512367494
1997,1411,10,16,787,1066,0.38461538461538464,-279,0.4247166756610901
1997,1412,18,13,1261,819,0.5806451612903226,442,0.60625
1997,1414,1,25,76,1438,0.038461538461538464,-1362,0.05019815059445178
1997,1416,5,19,407,1215,0.20833333333333334,-808,0.25092478421701603
1997,1417,21,7,1700,507,0.75,1193,0.7702763932940644
1997,1418,12,16,957,1097,0.42857142857142855,-140,0.46592015579357354
1997,1419,13,14,972,900,0.48148148148148145,72,0.5192307692307693
1997,1420,4,22,319,1175,0.15384615384615385,-856,0.21352074966532797
1997,1421,17,10,1186,660,0.6296296296296297,526,0.6424702058504875
1997,1422,10,20,686,1210,0.3333333333333333,-524,0.3618143459915612
1997,1423,16,13,1057,656,0.5517241379310345,401,0.6170461179217747
1997,1424,20,9,1530,582,0.6896551724137931,948,0.7244318181818182
1997,1425,17,10,1404,748,0.6296296296296297,656,0.6524163568773235
1997,1426,10,15,700,898,0.4,-198,0.4380475594493116
1997,1427,7,17,551,1235,0.2916666666666667,-684,0.30851063829787234
1997,1428,25,3,1889,191,0.8928571428571429,1698,0.9081730769230769
1997,1429,17,9,1248,530,0.6538461538461539,718,0.7019122609673791
1997,1431,10,13,771,729,0.43478260869565216,42,0.514
1997,1433,14,13,1063,847,0.5185185185185185,216,0.5565445026178011
1997,1434,22,6,1688,400,0.7857142857142857,1288,0.8084291187739464
1997,1435,18,11,1383,645,0.6206896551724138,738,0.6819526627218935
1997,1436,13,13,994,786,0.5,208,0.5584269662921348
1997,1437,22,9,1703,612,0.7096774193548387,1091,0.7356371490280778
1997,1438,18,12,1324,715,0.6,609,0.6493379107405591
1997,1439,14,16,916,917,0.4666666666666667,-1,0.49972722313147844
1997,1440,9,16,735,1105,0.36,-370,0.39945652173913043
1997,1441,11,13,846,834,0.4583333333333333,12,0.5035714285714286
1997,1442,17,10,1321,698,0.6296296296296297,623,0.654284299157999
1997,1443,11,15,871,960,0.4230769230769231,-89,0.4756963407973785
1997,1444,14,14,1048,826,0.5,222,0.5592315901814301
1997,1447,10,17,787,1165,0.37037037037037035,-378,0.4031762295081967
1997,1448,23,6,1638,366,0.7931034482758621,1272,0.8173652694610778
1997,1449,16,10,1294,666,0.6153846153846154,628,0.6602040816326531
1997,1450,12,17,950,1207,0.41379310344827586,-257,0.44042651831247104
1997,1451,14,12,1203,839,0.5384615384615384,364,0.589128305582762
1997,1452,19,9,1657,600,0.6785714285714286,1057,0.7341603898980948
1997,1453,13,14,807,715,0.48148148148148145,92,0.5302233902759527
1997,1454,7,20,431,1090,0.25925925925925924,-659,0.28336620644312954
1997,1455,14,13,1033,782,0.5185185185185185,251,0.5691460055096419
1997,1456,11,16,779,974,0.4074074074074074,-195,0.44438106103822017
1997,1457,8,15,608,931,0.34782608695652173,-323,0.3950617283950617
1997,1458,18,9,1127,469,0.6666666666666666,658,0.706140350877193
1997,1459,4,20,358,1143,0.16666666666666666,-785,0.2385076615589607
1997,1460,6,20,420,1246,0.23076923076923078,-826,0.25210084033613445
1997,1461,11,16,853,1087,0.4074074074074074,-234,0.43969072164948453
1997,1462,22,5,1877,373,0.8148148148148148,1504,0.8342222222222222
1997,1463,9,16,634,927,0.36,-293,0.40614990390775146
1997,1464,8,18,588,1046,0.3076923076923077,-458,0.3598531211750306
1998,1102,5,16,375,943,0.23809523809523808,-568,0.2845220030349014
1998,1103,16,10,1206,734,0.6153846153846154,472,0.6216494845360825
1998,1104,15,15,1121,968,0.5,153,0.5366203925323121
1998,1106,8,16,651,984,0.3333333333333333,-333,0.3981651376146789
1998,1108,8,15,665,989,0.34782608695652173,-324,0.40205562273276907
1998,1110,8,19,558,1092,0.2962962962962963,-534,0.3381818181818182
1998,1111,18,8,1321,497,0.6923076923076923,824,0.7266226622662266
1998,1112,27,4,2515,343,0.8709677419354839,2172,0.8799860041987404
1998,1113,17,13,1557,990,0.5666666666666667,567,0.6113074204946997
1998,1114,14,13,1059,760,0.5185185185185185,299,0.5821880153930731
1998,1116,23,7,2011,503,0.7666666666666667,1508,0.799920445505171
1998,1117,20,9,1563,607,0.6896551724137931,956,0.7202764976958526
1998,1119,7,19,552,1121,0.2692307692307692,-569,0.3299462044231919
1998,1120,15,13,1130,801,0.5357142857142857,329,0.585189021232522
1998,1122,15,11,1149,677,0.5769230769230769,472,0.6292442497261774
1998,1123,19,7,1505,520,0.7307692307692307,985,0.7432098765432099
1998,1124,14,14,1101,869,0.5,232,0.5588832487309645
1998,1126,1,26,79,1562,0.037037037037037035,-1483,0.04814137720901889
1998,1129,15,13,1191,832,0.5357142857142857,359,0.5887296094908552
1998,1130,14,16,1029,1057,0.4666666666666667,-28,0.49328859060402686
1998,1131,19,11,1403,698,0.6333333333333333,705,0.6677772489290814
1998,1132,9,16,677,1011,0.36,-334,0.40106635071090047
1998,1133,14,14,995,801,0.5,194,0.5540089086859689
1998,1135,6,20,388,1090,0.23076923076923078,-702,0.2625169147496617
1998,1137,12,15,902,958,0.4444444444444444,-56,0.48494623655913977
1998,1138,13,13,1017,874,0.5,143,0.5378106821787414
1998,1139,19,10,1307,604,0.6551724137931034,703,0.683935112506541
1998,1140,9,21,636,1270,0.3,-634,0.3336831059811123
1998,1141,4,21,307,1407,0.16,-1100,0.17911318553092181
1998,1142,11,14,943,1136,0.44,-193,0.4535834535834536
1998,1143,11,15,854,971,0.4230769230769231,-117,0.46794520547945206
1998,1144,7,17,526,989,0.2916666666666667,-463,0.3471947194719472
1998,1145,13,14,964,881,0.48148148148148145,83,0.5224932249322494
1998,1147,10,20,785,1287,0.3333333333333333,-502,0.37886100386100385
1998,1148,4,21,274,1352,0.16,-1078,0.16851168511685116
1998,1149,3,22,214,1477,0.12,-1263,0.12655233589591958
1998,1150,19,10,1436,687,0.6551724137931034,749,0.6764013188883655
1998,1151,10,14,678,828,0.4166666666666667,-150,0.450199203187251
1998,1152,2,25,160,1677,0.07407407407407407,-1517,0.08709853021230267
1998,1153,26,5,2034,337,0.8387096774193549,1697,0.8578658793757908
1998,1154,12,12,847,671,0.5,176,0.5579710144927537
1998,1155,18,13,1344,893,0.5806451612903226,451,0.6008046490835941
1998,1156,12,15,842,903,0.4444444444444444,-61,0.4825214899713467
1998,1157,6,17,421,979,0.2608695652173913,-558,0.3007142857142857
1998,1158,22,5,1595,296,0.8148148148148148,1299,0.8434690639873083
1998,1159,10,18,796,1279,0.35714285714285715,-483,0.3836144578313253
1998,1160,12,14,919,937,0.46153846153846156,-18,0.4951508620689655
1998,1161,18,8,1270,483,0.6923076923076923,787,0.7244723331431832
1998,1162,10,15,645,775,0.4,-130,0.45422535211267606
1998,1163,29,4,2275,251,0.8787878787878788,2024,0.900633412509897
1998,1164,21,8,1713,537,0.7241379310344828,1176,0.7613333333333333
1998,1165,8,17,560,999,0.32,-439,0.359204618345093
1998,1166,18,9,1454,578,0.6666666666666666,876,0.7155511811023622
1998,1168,11,16,855,1115,0.4074074074074074,-260,0.434010152284264
1998,1169,9,15,847,1162,0.375,-315,0.42160278745644597
1998,1170,1,22,73,1266,0.043478260869565216,-1193,0.05451829723674384
1998,1171,7,19,443,1031,0.2692307692307692,-588,0.3005427408412483
1998,1172,18,9,1327,570,0.6666666666666666,757,0.6995255666842383
1998,1173,20,11,1570,772,0.6451612903225806,798,0.6703672075149445
1998,1174,18,9,1364,602,0.6666666666666666,762,0.6937945066124109
1998,1175,7,18,514,1200,0.28,-686,0.2998833138856476
1998,1177,6,23,421,1299,0.20689655172413793,-878,0.24476744186046512
1998,1178,22,5,1654,324,0.8148148148148148,1330,0.8361981799797775
1998,1179,2,24,140,1418,0.07692307692307693,-1278,0.08985879332477535
1998,1180,13,15,929,941,0.4642857142857143,-12,0.49679144385026736
1998,1181,27,3,2331,214,0.9,2117,0.9159135559921414
1998,1182,11,19,867,1306,0.36666666666666664,-439,0.39898757478140817
1998,1183,14,11,1080,757,0.56,323,0.587915078933043
1998,1184,9,16,662,1074,0.36,-412,0.3813364055299539
1998,1185,19,9,1579,663,0.6785714285714286,916,0.7042818911685995
1998,1186,14,10,1129,688,0.5833333333333334,441,0.6213538800220143
1998,1187,9,17,703,1033,0.34615384615384615,-330,0.4049539170506912
1998,1190,9,16,675,931,0.36,-256,0.4202988792029888
1998,1191,14,15,1067,952,0.4827586206896552,115,0.5284794452699356
1998,1192,22,6,1903,444,0.7857142857142857,1459,0.8108223263740946
1998,1193,12,15,921,975,0.4444444444444444,-54,0.48575949367088606
1998,1194,5,21,346,1260,0.19230769230769232,-914,0.21544209215442092
1998,1196,14,14,1143,996,0.5,147,0.5343618513323983
1998,1197,11,17,890,1106,0.39285714285714285,-216,0.44589178356713427
1998,1198,21,8,1942,591,0.7241379310344828,1351,0.7666798262929333
1998,1199,17,13,1285,829,0.5666666666666667,456,0.6078524124881741
1998,1200,6,21,453,1309,0.2222222222222222,-856,0.25709421112372305
1998,1201,16,11,1417,790,0.5925925925925926,627,0.6420480289986407
1998,1202,7,19,453,1135,0.2692307692307692,-682,0.285264483627204
1998,1203,24,8,1872,483,0.75,1389,0.7949044585987262
1998,1204,7,17,490,1013,0.2916666666666667,-523,0.3260146373918829
1998,1206,9,18,623,1074,0.3333333333333333,-451,0.3671184443134944
1998,1207,13,14,977,910,0.48148148148148145,67,0.5177530471648119
1998,1208,16,14,1308,951,0.5333333333333333,357,0.5790172642762285
1998,1209,14,12,1157,763,0.5384615384615384,394,0.6026041666666667
1998,1210,17,13,1391,889,0.5666666666666667,502,0.6100877192982456
1998,1211,21,9,1765,638,0.7,1127,0.7344985434873076
1998,1212,12,11,892,719,0.5217391304347826,173,0.5536933581626319
1998,1214,14,12,987,783,0.5384615384615384,204,0.5576271186440678
1998,1216,14,12,1143,903,0.5384615384615384,240,0.5586510263929618
1998,1217,12,13,924,811,0.48,113,0.5325648414985591
1998,1218,19,8,1499,579,0.7037037037037037,920,0.7213666987487969
1998,1220,17,12,1305,835,0.5862068965517241,470,0.6098130841121495
1998,1221,7,20,518,1330,0.25925925925925924,-812,0.2803030303030303
1998,1222,8,20,539,1231,0.2857142857142857,-692,0.3045197740112994
1998,1224,8,20,591,1346,0.2857142857142857,-755,0.3051109963861642
1998,1225,13,12,1062,713,0.52,349,0.5983098591549296
1998,1226,5,18,386,1184,0.21739130434782608,-798,0.24585987261146497
1998,1227,22,5,1684,344,0.8148148148148148,1340,0.8303747534516766
1998,1228,22,9,1623,553,0.7096774193548387,1070,0.7458639705882353
1998,1229,23,5,1767,364,0.8214285714285714,1403,0.8291881745659315
1998,1231,19,11,1525,770,0.6333333333333333,755,0.664488017429194
1998,1232,16,11,1186,689,0.5925925925925926,497,0.6325333333333333
1998,1233,26,5,2159,347,0.8387096774193549,1812,0.8615323224261772
1998,1234,19,10,1615,682,0.6551724137931034,933,0.7030909882455376
1998,1235,10,18,729,1041,0.35714285714285715,-312,0.411864406779661
1998,1238,10,13,768,803,0.43478260869565216,-35,0.48886059834500317
1998,1239,8,19,616,1160,0.2962962962962963,-544,0.34684684684684686
1998,1240,10,14,779,1031,0.4166666666666667,-252,0.4303867403314917
1998,1241,11,16,793,936,0.4074074074074074,-143,0.45864661654135336
1998,1242,33,3,2792,221,0.9166666666666666,2571,0.9266511782276801
1998,1243,17,11,1406,718,0.6071428571428571,688,0.6619585687382298
1998,1245,11,16,815,1020,0.4074074074074074,-205,0.444141689373297
1998,1246,29,4,2317,292,0.8787878787878788,2025,0.8880797240321963
1998,1247,9,18,685,1243,0.3333333333333333,-558,0.3552904564315353
1998,1248,17,9,1329,582,0.6538461538461539,747,0.695447409733124
1998,1249,15,14,1059,877,0.5172413793103449,182,0.547004132231405
1998,1250,8,17,637,1103,0.32,-466,0.3660919540229885
1998,1251,8,16,551,988,0.3333333333333333,-437,0.35802469135802467
1998,1253,10,19,668,1182,0.3448275862068966,-514,0.36108108108108106
1998,1254,18,10,1726,894,0.6428571428571429,832,0.6587786259541984
1998,1256,12,15,976,873,0.4444444444444444,103,0.5278528934559221
1998,1257,12,20,933,1334,0.375,-401,0.41155712395235994
1998,1258,6,20,487,1419,0.23076923076923078,-932,0.25550891920251834
1998,1259,12,16,958,1185,0.42857142857142855,-227,0.44703686420905275
1998,1260,12,14,850,837,0.46153846153846156,13,0.5038529934795495
1998,1261,8,18,525,1056,0.3076923076923077,-531,0.33206831119544594
1998,1263,5,20,364,1362,0.2,-998,0.21089223638470453
1998,1264,12,17,864,1039,0.41379310344827586,-175,0.45401996847083553
1998,1265,11,17,805,1134,0.39285714285714285,-329,0.4151624548736462
1998,1266,18,10,1232,566,0.6428571428571429,666,0.6852057842046718
1998,1267,9,16,662,999,0.36,-337,0.39855508729680916
1998,1268,19,10,1600,692,0.6551724137931034,908,0.6980802792321117
1998,1269,21,10,1509,676,0.6774193548387096,833,0.6906178489702517
1998,1270,6,19,501,1245,0.24,-744,0.2869415807560137
1998,1271,9,18,737,1101,0.3333333333333333,-364,0.4009793253536453
1998,1272,16,11,1232,749,0.5925925925925926,483,0.6219081272084805
1998,1273,3,21,253,1341,0.125,-1088,0.1587202007528231
1998,1274,18,9,1302,598,0.6666666666666666,704,0.6852631578947368
1998,1275,16,12,1190,714,0.5714285714285714,476,0.625
1998,1276,23,8,1821,554,0.7419354838709677,1267,0.7667368421052632
1998,1277,20,7,1520,478,0.7407407407407407,1042,0.7607607607607607
1998,1278,15,15,1126,1005,0.5,121,0.5283904270295636
1998,1279,20,6,1652,432,0.7692307692307693,1220,0.7927063339731286
1998,1280,14,15,1013,1052,0.4827586206896552,-39,0.49055690072639224
1998,1281,17,14,1298,896,0.5483870967741935,402,0.5916134913400183
1998,1282,7,18,570,1132,0.28,-562,0.33490011750881316
1998,1283,16,16,1268,1101,0.5,167,0.5352469396369777
1998,1284,4,23,274,1350,0.14814814814814814,-1076,0.1687192118226601
1998,1285,12,13,835,843,0.48,-8,0.49761620977353993
1998,1286,15,10,1241,682,0.6,559,0.6453458138325533
1998,1287,3,23,234,1419,0.11538461538461539,-1185,0.14156079854809436
1998,1288,12,16,945,1089,0.42857142857142855,-144,0.4646017699115044
1998,1290,5,19,404,1369,0.20833333333333334,-965,0.22786238014664412
1998,1291,13,15,919,1081,0.4642857142857143,-162,0.4595
1998,1292,15,9,1104,616,0.625,488,0.641860465116279
1998,1293,25,3,2188,196,0.8928571428571429,1992,0.9177852348993288
1998,1296,9,16,630,1041,0.36,-411,0.3770197486535009
1998,1298,16,10,1258,575,0.6153846153846154,683,0.6863066012002182
1998,1299,7,18,544,1184,0.28,-640,0.3148148148148148
1998,1301,16,14,1168,780,0.5333333333333333,388,0.5995893223819302
1998,1302,4,19,314,1241,0.17391304347826086,-927,0.20192926045016077
1998,1304,20,11,1468,757,0.6451612903225806,711,0.6597752808988764
1998,1305,15,12,1242,812,0.5555555555555556,430,0.6046738072054528
1998,1306,9,17,619,1073,0.34615384615384615,-454,0.36583924349881797
1998,1307,23,7,1883,415,0.7666666666666667,1468,0.81940818102698
1998,1308,14,12,1145,772,0.5384615384615384,373,0.5972874282733438
1998,1309,15,12,1125,745,0.5555555555555556,380,0.6016042780748663
1998,1310,14,13,1112,841,0.5185185185185185,271,0.5693804403481822
1998,1311,18,9,1483,599,0.6666666666666666,884,0.7122958693563881
1998,1313,5,20,370,1277,0.2,-907,0.2246508803885853
1998,1314,30,3,2495,230,0.9090909090909091,2265,0.9155963302752294
1998,1317,5,21,416,1576,0.19230769230769232,-1160,0.20883534136546184
1998,1318,14,14,994,896,0.5,98,0.5259259259259259
1998,1319,18,6,1504,423,0.75,1081,0.7804878048780488
1998,1320,10,17,769,1100,0.37037037037037035,-331,0.41144997324772603
1998,1321,10,17,660,976,0.37037037037037035,-316,0.4034229828850856
1998,1322,11,14,857,949,0.44,-92,0.4745293466223699
1998,1323,13,14,1032,864,0.48148148148148145,168,0.5443037974683544
1998,1325,5,21,407,1256,0.19230769230769232,-849,0.24473842453397474
1998,1326,8,22,584,1394,0.26666666666666666,-810,0.29524772497472196
1998,1328,20,10,1548,659,0.6666666666666666,889,0.7014046216583598
1998,1329,21,6,1716,425,0.7777777777777778,1291,0.8014946286781878
1998,1330,12,16,825,913,0.42857142857142855,-88,0.47468354430379744
1998,1331,16,12,1421,783,0.5714285714285714,638,0.6447368421052632
1998,1332,13,13,985,820,0.5,165,0.5457063711911357
1998,1333,9,17,683,1103,0.34615384615384615,-420,0.3824188129899216
1998,1334,22,9,1678,583,0.7096774193548387,1095,0.7421494913754976
1998,1335,17,12,1274,801,0.5862068965517241,473,0.6139759036144579
1998,1336,15,12,1195,767,0.5555555555555556,428,0.609072375127421
1998,1337,17,10,1214,671,0.6296296296296297,543,0.6440318302387268
1998,1338,11,16,838,1149,0.4074074074074074,-311,0.4217413185707096
1998,1339,10,13,719,796,0.43478260869565216,-77,0.4745874587458746
1998,1341,9,15,661,1000,0.375,-339,0.3979530403371463
1998,1343,25,1,1702,42,0.9615384615384616,1660,0.9759174311926605
1998,1344,13,16,927,969,0.4482758620689655,-42,0.4889240506329114
1998,1345,26,7,2292,488,0.7878787878787878,1804,0.8244604316546763
1998,1347,16,7,1298,434,0.6956521739130435,864,0.7494226327944573
1998,1348,22,8,1749,565,0.7333333333333333,1184,0.7558340535868626
1998,1349,5,22,343,1350,0.18518518518518517,-1007,0.2025989367985824
1998,1350,22,7,1596,445,0.7586206896551724,1151,0.781969622733954
1998,1351,18,9,1343,561,0.6666666666666666,782,0.7053571428571429
1998,1352,7,19,467,1169,0.2692307692307692,-702,0.28545232273838633
1998,1353,14,15,1064,943,0.4827586206896552,121,0.5301444942700548
1998,1354,22,6,1705,384,0.7857142857142857,1321,0.8161799904260412
1998,1356,13,16,1084,1090,0.4482758620689655,-6,0.49862005519779207
1998,1358,9,17,683,1122,0.34615384615384615,-439,0.378393351800554
1998,1359,12,12,928,714,0.5,214,0.5651644336175395
1998,1360,12,14,916,893,0.46153846153846156,23,0.5063571033720288
1998,1361,12,15,886,979,0.4444444444444444,-93,0.47506702412868634
1998,1362,18,10,1410,653,0.6428571428571429,757,0.6834706737760543
1998,1363,3,23,205,1345,0.11538461538461539,-1140,0.13225806451612904
1998,1364,5,19,398,1283,0.20833333333333334,-885,0.23676383105294468
1998,1365,17,10,1249,731,0.6296296296296297,518,0.6308080808080808
1998,1368,4,20,343,1501,0.16666666666666666,-1158,0.18600867678958785
1998,1369,11,13,875,865,0.4583333333333333,10,0.5028735632183908
1998,1371,14,14,1007,876,0.5,131,0.534784917684546
1998,1372,9,16,708,1068,0.36,-360,0.39864864864864863
1998,1373,17,12,1500,917,0.5862068965517241,583,0.6206040546131568
1998,1374,17,10,1353,710,0.6296296296296297,643,0.6558410082404266
1998,1375,21,6,1430,339,0.7777777777777778,1091,0.8083663086489542
1998,1376,22,7,1627,451,0.7586206896551724,1176,0.7829643888354186
1998,1378,17,13,1187,787,0.5666666666666667,400,0.6013171225937184
1998,1379,21,10,1549,605,0.6774193548387096,944,0.7191272051996286
1998,1380,10,13,935,999,0.43478260869565216,-64,0.48345398138572904
1998,1381,5,20,428,1269,0.2,-841,0.2522097819681791
1998,1382,17,14,1217,826,0.5483870967741935,391,0.595692608908468
1998,1383,14,12,1001,852,0.5384615384615384,149,0.54020507285483
1998,1384,16,10,1146,652,0.6153846153846154,494,0.6373748609566184
1998,1385,21,9,1589,587,0.7,1002,0.7302389705882353
1998,1386,11,17,771,1101,0.39285714285714285,-330,0.41185897435897434
1998,1387,21,10,1471,638,0.6774193548387096,833,0.6974869606448554
1998,1388,10,15,796,1071,0.4,-275,0.42635243706480985
1998,1389,8,19,596,1266,0.2962962962962963,-670,0.3200859291084855
1998,1390,25,4,2052,276,0.8620689655172413,1776,0.8814432989690721
1998,1391,10,14,756,894,0.4166666666666667,-138,0.4581818181818182
1998,1393,24,8,1805,490,0.75,1315,0.7864923747276689
1998,1395,26,5,2630,387,0.8387096774193549,2243,0.8717268810076235
1998,1396,21,8,1395,523,0.7241379310344828,872,0.7273201251303442
1998,1397,20,8,1542,577,0.7142857142857143,965,0.7277017461066541
1998,1398,11,16,787,1060,0.4074074074074074,-273,0.42609637249593935
1998,1399,7,20,504,1228,0.25925925925925924,-724,0.2909930715935335
1998,1400,14,17,1217,1246,0.45161290322580644,-29,0.4941128704831506
1998,1401,7,20,641,1385,0.25925925925925924,-744,0.31638696939782823
1998,1402,16,11,1242,723,0.5925925925925926,519,0.6320610687022901
1998,1403,13,14,1096,992,0.48148148148148145,104,0.524904214559387
1998,1404,6,20,455,1170,0.23076923076923078,-715,0.28
1998,1405,14,12,954,854,0.5384615384615384,100,0.5276548672566371
1998,1406,8,20,543,1241,0.2857142857142857,-698,0.30437219730941706
1998,1407,6,19,457,1265,0.24,-808,0.2653890824622532
1998,1408,7,22,538,1393,0.2413793103448276,-855,0.27861211807353703
1998,1409,18,12,1301,748,0.6,553,0.6349438750610054
1998,1410,3,24,275,1676,0.1111111111111111,-1401,0.14095335725269093
1998,1411,13,16,1084,1078,0.4482758620689655,6,0.5013876040703052
1998,1412,19,11,1489,754,0.6333333333333333,735,0.6638430673205529
1998,1414,7,18,484,1077,0.28,-593,0.31005765534913515
1998,1416,15,11,1209,741,0.5769230769230769,468,0.62
1998,1417,21,8,1783,650,0.7241379310344828,1133,0.7328401150842582
1998,1418,17,13,1337,898,0.5666666666666667,439,0.5982102908277405
1998,1419,12,16,1043,1130,0.42857142857142855,-87,0.47998159226875287
1998,1420,11,14,821,907,0.44,-86,0.47511574074074076
1998,1421,16,9,1166,578,0.64,588,0.6685779816513762
1998,1422,8,17,549,1026,0.32,-477,0.3485714285714286
1998,1423,20,10,1318,550,0.6666666666666666,768,0.7055674518201285
1998,1424,19,12,1419,739,0.6129032258064516,680,0.6575532900834106
1998,1425,9,19,754,1347,0.32142857142857145,-593,0.35887672536887194
1998,1426,11,16,812,1081,0.4074074074074074,-269,0.4289487585842578
1998,1427,15,10,1239,662,0.6,577,0.65176223040505
1998,1428,24,3,1687,181,0.8888888888888888,1506,0.9031049250535332
1998,1429,22,7,1638,410,0.7586206896551724,1228,0.7998046875
1998,1431,10,14,679,845,0.4166666666666667,-166,0.44553805774278216
1998,1433,9,19,567,1220,0.32142857142857145,-653,0.31729155008393956
1998,1434,18,8,1408,478,0.6923076923076923,930,0.7465535524920467
1998,1435,18,12,1422,838,0.6,584,0.6292035398230088
1998,1436,15,11,1198,717,0.5769230769230769,481,0.6255874673629243
1998,1437,12,17,978,1047,0.41379310344827586,-69,0.482962962962963
1998,1438,11,19,761,1211,0.36666666666666664,-450,0.3859026369168357
1998,1439,10,17,752,1035,0.37037037037037035,-283,0.4208170117515389
1998,1440,10,13,776,871,0.43478260869565216,-95,0.4711596842744384
1998,1441,9,15,678,997,0.375,-319,0.4047761194029851
1998,1442,14,11,1057,682,0.56,375,0.6078205865439908
1998,1443,10,19,712,1193,0.3448275862068966,-481,0.373753280839895
1998,1444,20,7,1688,458,0.7407407407407407,1230,0.7865796831314072
1998,1447,12,16,937,1112,0.42857142857142855,-175,0.4572962420693021
1998,1448,15,13,1078,772,0.5357142857142857,306,0.5827027027027027
1998,1449,18,9,1457,678,0.6666666666666666,779,0.6824355971896956
1998,1450,7,19,528,1302,0.2692307692307692,-774,0.28852459016393445
1998,1451,12,12,949,805,0.5,144,0.5410490307867731
1998,1452,20,8,1664,539,0.7142857142857143,1125,0.7553336359509759
1998,1453,16,12,1152,655,0.5714285714285714,497,0.6375207526286663
1998,1454,3,24,213,1438,0.1111111111111111,-1225,0.12901271956390067
1998,1455,16,15,1099,871,0.5161290322580645,228,0.5578680203045685
1998,1456,19,7,1390,420,0.7307692307692307,970,0.7679558011049724
1998,1457,5,17,340,998,0.22727272727272727,-658,0.25411061285500747
1998,1458,12,19,816,1061,0.3870967741935484,-245,0.43473628129994674
1998,1459,6,18,394,1067,0.25,-673,0.26967830253251196
1998,1460,9,18,655,1142,0.3333333333333333,-487,0.36449638286032277
1998,1461,18,8,1216,442,0.6923076923076923,774,0.7334137515078407
1998,1462,22,7,1920,518,0.7586206896551724,1402,0.7875307629204266
1998,1463,11,14,796,822,0.44,-26,0.4919653893695921
1998,1464,18,9,1353,557,0.6666666666666666,796,0.7083769633507854
1998,3102,4,20,263,1112,0.16666666666666666,-849,0.19127272727272726
1998,3103,11,18,842,1166,0.3793103448275862,-324,0.41932270916334663
1998,3104,21,9,1657,640,0.7,1017,0.7213757074444929
1998,3106,6,15,421,865,0.2857142857142857,-444,0.3273716951788491
1998,3108,12,11,898,662,0.5217391304347826,236,0.5756410256410256
1998,3110,21,6,1603,363,0.7777777777777778,1240,0.8153611393692777
1998,3111,9,17,599,995,0.34615384615384615,-396,0.37578419071518193
1998,3112,21,6,1708,408,0.7777777777777778,1300,0.8071833648393195
1998,3113,9,18,729,1051,0.3333333333333333,-322,0.4095505617977528
1998,3116,17,11,1389,697,0.6071428571428571,692,0.6658676893576222
1998,3117,19,9,1612,667,0.6785714285714286,945,0.7073277753400614
1998,3119,8,18,546,1036,0.3076923076923077,-490,0.34513274336283184
1998,3120,16,11,1216,616,0.5925925925925926,600,0.6637554585152838
1998,3122,9,16,662,927,0.36,-265,0.4166142227816237
1998,3123,9,16,684,1057,0.36,-373,0.39287765651924184
1998,3124,16,10,1270,668,0.6153846153846154,602,0.6553147574819401
1998,3126,7,18,460,976,0.28,-516,0.3203342618384401
1998,3129,19,10,1379,575,0.6551724137931034,804,0.7057318321392017
1998,3130,17,11,1289,670,0.6071428571428571,619,0.6579887697805002
1998,3131,9,18,666,1062,0.3333333333333333,-396,0.3854166666666667
1998,3132,20,7,1645,481,0.7407407407407407,1164,0.7737535277516463
1998,3133,8,17,599,1001,0.32,-402,0.374375
1998,3135,9,15,655,955,0.375,-300,0.40683229813664595
1998,3137,9,13,643,686,0.4090909090909091,-43,0.48382242287434163
1998,3138,12,10,923,660,0.5454545454545454,263,0.5830701200252685
1998,3139,24,5,1957,316,0.8275862068965517,1641,0.8609766827980643
1998,3140,14,14,1043,893,0.5,150,0.5387396694214877
1998,3141,10,17,839,1150,0.37037037037037035,-311,0.4218200100553042
1998,3142,6,19,424,1211,0.24,-787,0.25932721712538226
1998,3143,6,22,434,1270,0.21428571428571427,-836,0.2546948356807512
1998,3144,16,9,1228,624,0.64,604,0.6630669546436285
1998,3145,2,25,138,1491,0.07407407407407407,-1353,0.0847145488029466
1998,3148,16,8,1194,471,0.6666666666666666,723,0.7171171171171171
1998,3149,9,14,623,846,0.391304347826087,-223,0.4240980258679374
1998,3150,10,17,633,1035,0.37037037037037035,-402,0.37949640287769787
1998,3151,9,19,680,1091,0.32142857142857145,-411,0.3839638622247318
1998,3153,21,6,1582,401,0.7777777777777778,1181,0.7977811396873424
1998,3155,22,8,1725,446,0.7333333333333333,1279,0.7945647167204053
1998,3156,13,15,1015,944,0.4642857142857143,71,0.5181214905564063
1998,3157,6,17,421,969,0.2608695652173913,-548,0.30287769784172663
1998,3158,7,17,526,1052,0.2916666666666667,-526,0.3333333333333333
1998,3159,7,15,529,954,0.3181818181818182,-425,0.35670937289278487
1998,3160,12,16,863,913,0.42857142857142855,-50,0.48592342342342343
1998,3161,21,5,1775,341,0.8076923076923077,1434,0.8388468809073724
1998,3162,4,19,275,1063,0.17391304347826086,-788,0.2055306427503737
1998,3163,30,2,2557,139,0.9375,2418,0.9484421364985163
1998,3164,9,15,616,864,0.375,-248,0.41621621621621624
1998,3165,4,18,281,1044,0.18181818181818182,-763,0.2120754716981132
1998,3166,16,12,1185,724,0.5714285714285714,461,0.6207438449449973
1998,3168,10,15,733,976,0.4,-243,0.4289057928613224
1998,3169,12,13,840,739,0.48,101,0.5319822672577581
1998,3170,6,17,443,1066,0.2608695652173913,-623,0.2935719019218025
1998,3171,14,11,1035,615,0.56,420,0.6272727272727273
1998,3172,18,8,1453,539,0.6923076923076923,914,0.7294176706827309
1998,3173,9,17,651,1070,0.34615384615384615,-419,0.37826844857640907
1998,3174,6,20,423,1221,0.23076923076923078,-798,0.2572992700729927
1998,3175,7,20,479,1226,0.25925925925925924,-747,0.2809384164222874
1998,3177,10,16,788,1040,0.38461538461538464,-252,0.4310722100656455
1998,3178,11,15,842,957,0.4230769230769231,-115,0.4680377987770984
1998,3179,25,4,2053,277,0.8620689655172413,1776,0.8811158798283262
1998,3180,11,14,783,785,0.44,-2,0.49936224489795916
1998,3181,21,7,1669,451,0.75,1218,0.7872641509433962
1998,3182,19,8,1519,513,0.7037037037037037,1006,0.7475393700787402
1998,3183,12,13,812,754,0.48,58,0.5185185185185185
1998,3184,18,8,1414,535,0.6923076923076923,879,0.7255002565418163
1998,3185,9,15,678,921,0.375,-243,0.42401500938086306
1998,3186,4,22,263,1148,0.15384615384615385,-885,0.18639262934089298
1998,3187,9,17,594,814,0.34615384615384615,-220,0.421875
1998,3190,10,15,761,1108,0.4,-347,0.4071696094168004
1998,3191,5,18,360,1152,0.21739130434782608,-792,0.23809523809523808
1998,3192,7,19,527,1137,0.2692307692307692,-610,0.3167067307692308
1998,3193,20,8,1488,462,0.7142857142857143,1026,0.7630769230769231
1998,3194,13,13,1080,828,0.5,252,0.5660377358490566
1998,3196,21,8,1605,489,0.7241379310344828,1116,0.7664756446991404
1998,3197,15,7,1122,437,0.6818181818181818,685,0.7196921103271328
1998,3198,28,1,2270,67,0.9655172413793104,2203,0.9713307659392384
1998,3199,7,18,472,1157,0.28,-685,0.28974831184775934
1998,3200,4,22,234,1192,0.15384615384615385,-958,0.1640953716690042
1998,3201,12,15,848,918,0.4444444444444444,-70,0.4801812004530011
1998,3202,15,13,1143,859,0.5357142857142857,284,0.570929070929071
1998,3203,17,9,1283,535,0.6538461538461539,748,0.7057205720572057
1998,3204,18,11,1472,764,0.6206896551724138,708,0.6583184257602862
1998,3206,14,12,937,679,0.5384615384615384,258,0.5798267326732673
1998,3207,9,19,686,1144,0.32142857142857145,-458,0.37486338797814206
1998,3208,17,9,1398,598,0.6538461538461539,800,0.7004008016032064
1998,3209,15,10,1184,613,0.6,571,0.6588759042849193
1998,3210,9,15,692,835,0.375,-143,0.4531761624099542
1998,3211,9,16,684,969,0.36,-285,0.41379310344827586
1998,3212,15,6,1259,369,0.7142857142857143,890,0.7733415233415234
1998,3214,19,7,1395,469,0.7307692307692307,926,0.7483905579399142
1998,3216,9,16,552,872,0.36,-320,0.38764044943820225
1998,3217,20,5,1580,296,0.8,1284,0.8422174840085288
1998,3218,24,3,1961,198,0.8888888888888888,1763,0.9082908754052802
1998,3220,12,14,860,857,0.46153846153846156,3,0.500873616773442
1998,3221,21,7,1715,480,0.75,1235,0.7813211845102506
1998,3222,8,17,558,1051,0.32,-493,0.3467992541951523
1998,3224,21,6,1524,300,0.7777777777777778,1224,0.8355263157894737
1998,3225,13,14,980,873,0.48148148148148145,107,0.5288720992984349
1998,3226,13,11,953,634,0.5416666666666666,319,0.6005040957781979
1998,3227,6,20,395,1126,0.23076923076923078,-731,0.2596975673898751
1998,3228,16,9,1350,619,0.64,731,0.6856272219400711
1998,3229,10,17,741,1025,0.37037037037037035,-284,0.41959229898074746
1998,3231,18,10,1355,657,0.6428571428571429,698,0.6734592445328031
1998,3232,17,10,1139,598,0.6296296296296297,541,0.6557282671272309
1998,3233,10,17,698,936,0.37037037037037035,-238,0.42717258261933905
1998,3234,16,10,1169,596,0.6153846153846154,573,0.6623229461756374
1998,3235,24,7,1790,421,0.7741935483870968,1369,0.80958842152872
1998,3238,14,8,1059,511,0.6363636363636364,548,0.6745222929936305
1998,3240,14,13,1075,818,0.5185185185185185,257,0.5678816693079768
1998,3241,16,11,1122,647,0.5925925925925926,475,0.6342566421707179
1998,3242,22,7,1512,412,0.7586206896551724,1100,0.7858627858627859
1998,3243,10,17,712,949,0.37037037037037035,-237,0.4286574352799518
1998,3245,22,6,1843,351,0.7857142857142857,1492,0.8400182315405652
1998,3246,13,15,900,870,0.4642857142857143,30,0.5084745762711864
1998,3247,15,11,1100,645,0.5769230769230769,455,0.6303724928366762
1998,3248,14,12,939,717,0.5384615384615384,222,0.5670289855072463
1998,3249,5,22,399,1314,0.18518518518518517,-915,0.2329246935201401
1998,3250,10,16,717,961,0.38461538461538464,-244,0.4272943980929678
1998,3251,24,0,1759,0,1.0,1759,1.0
1998,3253,5,19,358,1181,0.20833333333333334,-823,0.23261858349577647
1998,3254,4,21,335,1301,0.16,-966,0.2047677261613692
1998,3256,26,3,2344,212,0.896551724137931,2132,0.917057902973396
1998,3257,18,12,1404,764,0.6,640,0.6476014760147601
1998,3258,3,22,205,1258,0.12,-1053,0.14012303485987695
1998,3259,19,8,1296,438,0.7037037037037037,858,0.7474048442906575
1998,3260,7,21,489,1276,0.25,-787,0.2770538243626062
1998,3261,17,12,1262,730,0.5862068965517241,532,0.6335341365461847
1998,3263,19,7,1540,502,0.7307692307692307,1038,0.7541625857002938
1998,3264,12,17,843,985,0.41379310344827586,-142,0.4611597374179431
1998,3265,4,22,268,1237,0.15384615384615385,-969,0.17807308970099667
1998,3266,20,6,1492,415,0.7692307692307693,1077,0.7823807026743577
1998,3267,7,20,517,1365,0.25925925925925924,-848,0.2747077577045696
1998,3268,15,13,1025,684,0.5357142857142857,341,0.5997659449970744
1998,3269,17,9,1074,505,0.6538461538461539,569,0.6801773274224192
1998,3270,9,15,641,901,0.375,-260,0.4156939040207523
1998,3271,15,8,1042,469,0.6521739130434783,573,0.6896095301125083
1998,3272,22,4,1819,288,0.8461538461538461,1531,0.863312766967252
1998,3273,8,16,556,862,0.3333333333333333,-306,0.3921015514809591
1998,3274,19,8,1530,489,0.7037037037037037,1041,0.7578008915304606
1998,3275,12,14,869,844,0.46153846153846156,25,0.5072971395213076
1998,3276,18,9,1397,625,0.6666666666666666,772,0.6909000989119684
1998,3277,11,15,854,964,0.4230769230769231,-110,0.46974697469746973
1998,3278,3,23,206,1341,0.11538461538461539,-1135,0.13316095669036845
1998,3279,11,19,828,1123,0.36666666666666664,-295,0.42439774474628394
1998,3280,12,14,888,904,0.46153846153846156,-16,0.4955357142857143
1998,3281,10,16,731,995,0.38461538461538464,-264,0.4235225955967555
1998,3282,5,17,371,1039,0.22727272727272727,-668,0.2631205673758865
1998,3283,24,5,1901,337,0.8275862068965517,1564,0.8494191242180519
1998,3284,9,16,670,881,0.36,-211,0.43197936814958093
1998,3285,19,6,1390,387,0.76,1003,0.7822172200337648
1998,3286,8,15,548,930,0.34782608695652173,-382,0.37077131258457374
1998,3287,6,18,514,1218,0.25,-704,0.2967667436489607
1998,3288,8,18,516,865,0.3076923076923077,-349,0.3736422881969587
1998,3290,11,12,780,812,0.4782608695652174,-32,0.4899497487437186
1998,3291,15,12,1141,692,0.5555555555555556,449,0.6224768139661757
1998,3292,15,11,1117,674,0.5769230769230769,443,0.6236739251814629
1998,3293,5,19,386,1015,0.20833333333333334,-629,0.2755174875089222
1998,3296,4,21,319,1425,0.16,-1106,0.18291284403669725
1998,3298,21,5,1464,348,0.8076923076923077,1116,0.8079470198675497
1998,3299,3,18,164,908,0.14285714285714285,-744,0.15298507462686567
1998,3301,21,6,1552,381,0.7777777777777778,1171,0.8028970512157269
1998,3304,21,9,1718,616,0.7,1102,0.7360754070265638
1998,3305,17,8,1234,482,0.68,752,0.7191142191142191
1998,3306,11,14,748,850,0.44,-102,0.46808510638297873
1998,3307,26,5,1931,314,0.8387096774193549,1617,0.8601336302895323
1998,3308,6,18,417,1035,0.25,-618,0.2871900826446281
1998,3309,11,15,899,963,0.4230769230769231,-64,0.48281417830290013
1998,3310,12,13,896,738,0.48,158,0.5483476132190942
1998,3311,7,13,497,747,0.35,-250,0.3995176848874598
1998,3313,5,17,360,1039,0.22727272727272727,-679,0.2573266619013581
1998,3314,24,6,1966,400,0.8,1566,0.830938292476754
1998,3317,8,16,589,951,0.3333333333333333,-362,0.38246753246753246
1998,3318,16,12,1166,689,0.5714285714285714,477,0.6285714285714286
1998,3319,20,3,1523,190,0.8695652173913043,1333,0.8890834792761237
1998,3320,11,13,885,838,0.4583333333333333,47,0.5136390017411492
1998,3321,7,20,545,1348,0.25925925925925924,-803,0.2879027997886952
1998,3322,12,9,873,606,0.5714285714285714,267,0.59026369168357
1998,3323,20,9,1574,585,0.6896551724137931,989,0.729041222788328
1998,3325,17,10,1336,689,0.6296296296296297,647,0.659753086419753
1998,3326,15,11,1137,669,0.5769230769230769,468,0.6295681063122923
1998,3328,8,19,596,1232,0.2962962962962963,-636,0.32603938730853393
1998,3329,18,10,1389,539,0.6428571428571429,850,0.7204356846473029
1998,3330,25,2,1998,133,0.9259259259259259,1865,0.9375879868606288
1998,3331,4,17,304,994,0.19047619047619047,-690,0.23420647149460708
1998,3332,15,9,1120,586,0.625,534,0.6565064478311841
1998,3333,5,18,336,1159,0.21739130434782608,-823,0.22474916387959867
1998,3334,8,17,506,897,0.32,-391,0.36065573770491804
1998,3335,12,12,855,711,0.5,144,0.5459770114942529
1998,3336,16,12,1238,717,0.5714285714285714,521,0.6332480818414322
1998,3337,15,10,1076,593,0.6,483,0.6446974236069503
1998,3338,6,21,372,1235,0.2222222222222222,-863,0.23148724331051648
1998,3339,19,9,1425,513,0.6785714285714286,912,0.7352941176470589
1998,3341,4,15,209,721,0.21052631578947367,-512,0.22473118279569892
1998,3343,16,9,1040,474,0.64,566,0.6869220607661823
1998,3344,10,16,845,1047,0.38461538461538464,-202,0.4466173361522199
1998,3345,18,9,1352,602,0.6666666666666666,750,0.691914022517912
1998,3347,12,10,927,720,0.5454545454545454,207,0.5628415300546448
1998,3348,6,21,424,1149,0.2222222222222222,-725,0.26954863318499683
1998,3349,21,9,1613,536,0.7,1077,0.7505816658911122
1998,3350,11,15,917,1049,0.4230769230769231,-132,0.4664292980671414
1998,3351,7,20,467,1273,0.25925925925925924,-806,0.26839080459770115
1998,3352,2,23,178,1378,0.08,-1200,0.11439588688946016
1998,3353,20,9,1438,559,0.6896551724137931,879,0.7200801201802705
1998,3354,5,20,343,1118,0.2,-775,0.23477070499657768
1998,3356,8,17,516,978,0.32,-462,0.3453815261044177
1998,3358,11,12,763,713,0.4782608695652174,50,0.5169376693766937
1998,3359,3,21,230,1256,0.125,-1026,0.15477792732166892
1998,3360,12,13,808,691,0.48,117,0.5390260173448966
1998,3361,10,13,695,770,0.43478260869565216,-75,0.47440273037542663
1998,3362,9,15,594,845,0.375,-251,0.4127866574009729
1998,3363,6,21,437,1206,0.2222222222222222,-769,0.26597687157638467
1998,3364,25,5,2144,357,0.8333333333333334,1787,0.8572570971611355
1998,3365,22,6,1757,387,0.7857142857142857,1370,0.8194962686567164
1998,3368,4,17,312,1010,0.19047619047619047,-698,0.23600605143721634
1998,3369,5,19,377,1171,0.20833333333333334,-794,0.24354005167958656
1998,3371,8,18,609,1051,0.3076923076923077,-442,0.36686746987951807
1998,3372,23,3,1956,223,0.8846153846153846,1733,0.8976594768242313
1998,3373,20,8,1523,510,0.7142857142857143,1013,0.749139203148057
1998,3374,21,7,1507,452,0.75,1055,0.7692700357325166
1998,3375,6,20,396,1093,0.23076923076923078,-697,0.26595030221625254
1998,3376,13,15,1019,932,0.4642857142857143,87,0.522296258329062
1998,3378,9,14,617,849,0.391304347826087,-232,0.4208731241473397
1998,3379,11,11,816,647,0.5,169,0.557758031442242
1998,3380,12,10,887,598,0.5454545454545454,289,0.5973063973063973
1998,3381,11,10,832,702,0.5238095238095238,130,0.5423728813559322
1998,3382,15,13,1161,821,0.5357142857142857,340,0.5857719475277497
1998,3383,10,15,654,842,0.4,-188,0.43716577540106955
1998,3384,20,7,1499,365,0.7407407407407407,1134,0.8041845493562232
1998,3385,6,20,413,1035,0.23076923076923078,-622,0.2852209944751381
1998,3386,17,10,1160,549,0.6296296296296297,611,0.6787595084844938
1998,3387,11,14,815,785,0.44,30,0.509375
1998,3388,18,9,1309,525,0.6666666666666666,784,0.7137404580152672
1998,3389,17,9,1168,512,0.6538461538461539,656,0.6952380952380952
1998,3390,21,5,1859,388,0.8076923076923077,1471,0.8273253226524254
1998,3391,9,17,673,1111,0.34615384615384615,-438,0.3772421524663677
1998,3393,12,15,973,912,0.4444444444444444,61,0.5161803713527852
1998,3395,11,15,856,917,0.4230769230769231,-61,0.48279751833051326
1998,3396,10,15,665,860,0.4,-195,0.4360655737704918
1998,3397,33,0,2933,0,1.0,2933,1.0
1998,3398,10,11,750,782,0.47619047619047616,-32,0.489556135770235
1998,3399,20,5,1447,276,0.8,1171,0.8398142774230992
1998,3400,12,15,949,1013,0.4444444444444444,-64,0.4836901121304791
1998,3401,8,19,683,1289,0.2962962962962963,-606,0.34634888438133876
1998,3402,2,20,121,1158,0.09090909090909091,-1037,0.0946051602814699
1998,3403,25,4,1948,278,0.8620689655172413,1670,0.8751123090745733
1998,3404,17,9,1288,535,0.6538461538461539,753,0.7065277015907844
1998,3405,23,6,1831,394,0.7931034482758621,1437,0.8229213483146067
1998,3406,13,13,928,766,0.5,162,0.5478158205430933
1998,3407,13,13,1052,875,0.5,177,0.5459263103269331
1998,3408,18,6,1385,391,0.75,994,0.7798423423423423
1998,3409,9,16,603,932,0.36,-329,0.39283387622149835
1998,3410,1,26,68,1267,0.037037037037037035,-1199,0.05093632958801498
1998,3411,1,22,78,1065,0.043478260869565216,-987,0.06824146981627296
1998,3412,9,18,627,1092,0.3333333333333333,-465,0.3647469458987784
1998,3414,15,10,1043,598,0.6,445,0.635588056063376
1998,3416,15,11,1200,743,0.5769230769230769,457,0.6176016469377251
1998,3417,19,8,1579,598,0.7037037037037037,981,0.7253100597152045
1998,3418,8,18,565,988,0.3076923076923077,-423,0.36381197681905986
1998,3419,15,7,1136,402,0.6818181818181818,734,0.7386215864759428
1998,3420,7,19,459,965,0.2692307692307692,-506,0.3223314606741573
1998,3421,7,19,484,1159,0.2692307692307692,-675,0.2945830797321972
1998,3422,19,8,1514,496,0.7037037037037037,1018,0.7532338308457711
1998,3423,10,15,743,907,0.4,-164,0.4503030303030303
1998,3424,4,23,310,1351,0.14814814814814814,-1041,0.18663455749548466
1998,3425,11,15,762,923,0.4230769230769231,-161,0.45222551928783383
1998,3426,14,7,1018,359,0.6666666666666666,659,0.739288307915759
1998,3427,13,10,905,570,0.5652173913043478,335,0.6135593220338983
1998,3428,21,5,1534,275,0.8076923076923077,1259,0.8479823106688779
1998,3431,13,11,885,663,0.5416666666666666,222,0.5717054263565892
1998,3433,15,12,1072,763,0.5555555555555556,309,0.5841961852861035
1998,3434,18,6,1412,386,0.75,1026,0.7853170189098999
1998,3435,19,8,1380,455,0.7037037037037037,925,0.7520435967302452
1998,3436,20,7,1451,447,0.7407407407407407,1004,0.7644889357218124
1998,3437,19,9,1238,462,0.6785714285714286,776,0.7282352941176471
1998,3438,18,9,1293,589,0.6666666666666666,704,0.6870350690754516
1998,3439,19,9,1394,556,0.6785714285714286,838,0.7148717948717949
1998,3441,6,19,447,1101,0.24,-654,0.28875968992248063
1998,3442,5,15,333,962,0.25,-629,0.2571428571428571
1998,3443,25,8,2285,541,0.7575757575757576,1744,0.8085633404104742
1998,3444,8,18,611,1113,0.3076923076923077,-502,0.35440835266821347
1998,3447,17,12,1117,679,0.5862068965517241,438,0.6219376391982183
1998,3448,4,22,282,1216,0.15384615384615385,-934,0.1882510013351135
1998,3449,18,9,1368,577,0.6666666666666666,791,0.7033419023136247
1998,3450,12,14,866,866,0.46153846153846156,0,0.5
1998,3451,6,19,417,1089,0.24,-672,0.27689243027888444
1998,3452,12,15,881,1049,0.4444444444444444,-168,0.4564766839378238
1998,3453,20,8,1329,476,0.7142857142857143,853,0.7362880886426593
1998,3454,15,12,1018,753,0.5555555555555556,265,0.5748164878599661
1998,3455,12,14,873,820,0.46153846153846156,53,0.5156526875369167
1998,3456,8,17,577,1050,0.32,-473,0.35464044253226795
1998,3457,3,20,200,1268,0.13043478260869565,-1068,0.1362397820163488
1998,3458,21,8,1678,519,0.7241379310344828,1159,0.7637687756030951
1998,3459,3,23,209,1576,0.11538461538461539,-1367,0.11708683473389356
1998,3460,7,18,475,991,0.28,-516,0.32401091405184174
1998,3461,8,15,629,856,0.34782608695652173,-227,0.4235690235690236
1998,3462,16,11,1205,714,0.5925925925925926,491,0.627931214174049
1998,3463,13,11,834,561,0.5416666666666666,273,0.5978494623655914
1998,3464,25,0,2015,0,1.0,2015,1.0
1999,1102,7,16,591,1130,0.30434782608695654,-539,0.3434049970947124
1999,1103,17,9,1324,625,0.6538461538461539,699,0.6793227296049256
1999,1104,17,14,1226,861,0.5483870967741935,365,0.5874460948730235
1999,1106,8,15,622,878,0.34782608695652173,-256,0.4146666666666667
1999,1108,20,6,1582,381,0.7692307692307693,1201,0.8059093224656139
1999,1110,5,21,332,1295,0.19230769230769232,-963,0.20405654578979718
1999,1111,18,8,1376,520,0.6923076923076923,856,0.7257383966244726
1999,1112,22,6,1868,455,0.7857142857142857,1413,0.8041325871717606
1999,1113,12,16,968,1105,0.42857142857142855,-137,0.46695610226724554
1999,1114,10,15,734,896,0.4,-162,0.4503067484662577
1999,1115,1,22,75,1444,0.043478260869565216,-1369,0.04937458854509546
1999,1116,22,10,1845,664,0.6875,1181,0.735352730171383
1999,1117,17,11,1271,773,0.6071428571428571,498,0.6218199608610567
1999,1119,6,19,420,1027,0.24,-607,0.2902557014512785
1999,1120,27,3,2248,207,0.9,2041,0.9156822810590631
1999,1122,11,15,862,1015,0.4230769230769231,-153,0.45924347362813
1999,1123,15,11,1021,687,0.5769230769230769,334,0.5977751756440282
1999,1124,5,24,373,1395,0.1724137931034483,-1022,0.21097285067873303
1999,1126,11,16,809,981,0.4074074074074074,-172,0.4519553072625698
1999,1129,20,8,1412,499,0.7142857142857143,913,0.738880167451596
1999,1130,6,21,411,1278,0.2222222222222222,-867,0.2433392539964476
1999,1131,9,18,626,1110,0.3333333333333333,-484,0.36059907834101385
1999,1132,16,10,1195,624,0.6153846153846154,571,0.65695437053326
1999,1133,17,11,1155,619,0.6071428571428571,536,0.6510710259301015
1999,1135,4,22,275,1303,0.15384615384615385,-1028,0.17427122940430925
1999,1137,14,13,987,758,0.5185185185185185,229,0.5656160458452723
1999,1138,4,24,238,1405,0.14285714285714285,-1167,0.14485696895922093
1999,1139,20,8,1328,451,0.7142857142857143,877,0.746486790331647
1999,1140,12,16,950,1059,0.42857142857142855,-109,0.4728720756595321
1999,1141,9,16,677,1059,0.36,-382,0.38997695852534564
1999,1142,9,16,846,1234,0.36,-388,0.40673076923076923
1999,1143,17,11,1304,748,0.6071428571428571,556,0.6354775828460039
1999,1144,8,17,601,993,0.32,-392,0.37703889585947303
1999,1145,15,12,1145,773,0.5555555555555556,372,0.5969760166840459
1999,1147,13,14,898,791,0.48148148148148145,107,0.5316755476613381
1999,1148,19,12,1395,782,0.6129032258064516,613,0.6407900780891135
1999,1149,7,14,573,945,0.3333333333333333,-372,0.3774703557312253
1999,1150,22,10,1569,614,0.6875,955,0.7187356848373797
1999,1151,14,12,967,776,0.5384615384615384,191,0.5547905909351692
1999,1152,3,22,197,1154,0.12,-957,0.14581791265729088
1999,1153,25,5,1921,287,0.8333333333333334,1634,0.8700181159420289
1999,1154,5,18,369,992,0.21739130434782608,-623,0.27112417340191036
1999,1155,15,14,1160,893,0.5172413793103449,267,0.565026790063322
1999,1156,12,14,907,890,0.46153846153846156,17,0.5047301057317752
1999,1157,4,16,346,1081,0.2,-735,0.2424667133847232
1999,1158,25,2,1858,107,0.9259259259259259,1751,0.9455470737913486
1999,1159,13,14,916,820,0.48148148148148145,96,0.5276497695852534
1999,1160,15,14,1169,893,0.5172413793103449,276,0.566925315227934
1999,1161,16,10,1220,662,0.6153846153846154,558,0.6482465462274176
1999,1162,8,16,528,856,0.3333333333333333,-328,0.3815028901734104
1999,1163,28,2,2213,113,0.9333333333333333,2100,0.9514187446259673
1999,1164,15,14,1148,844,0.5172413793103449,304,0.5763052208835341
1999,1165,10,15,703,884,0.4,-181,0.44297416509136733
1999,1166,21,8,1647,585,0.7241379310344828,1062,0.7379032258064516
1999,1168,12,14,919,876,0.46153846153846156,43,0.5119777158774373
1999,1169,15,12,1239,959,0.5555555555555556,280,0.5636942675159236
1999,1170,3,23,189,1379,0.11538461538461539,-1190,0.12053571428571429
1999,1171,13,12,921,672,0.52,249,0.5781544256120528
1999,1172,13,11,1030,741,0.5416666666666666,289,0.5815923207227555
1999,1173,11,17,827,1073,0.39285714285714285,-246,0.43526315789473685
1999,1174,25,5,2025,317,0.8333333333333334,1708,0.8646456020495303
1999,1175,7,19,565,1349,0.2692307692307692,-784,0.29519331243469177
1999,1176,10,17,820,1168,0.37037037037037035,-348,0.4124748490945674
1999,1177,17,12,1340,787,0.5862068965517241,553,0.6299952985425482
1999,1178,23,5,1522,276,0.8214285714285714,1246,0.8464961067853171
1999,1179,9,17,685,991,0.34615384615384615,-306,0.4087112171837709
1999,1180,20,9,1464,572,0.6896551724137931,892,0.7190569744597249
1999,1181,32,1,3005,75,0.9696969696969697,2930,0.9756493506493507
1999,1182,4,23,291,1370,0.14814814814814814,-1079,0.17519566526189043
1999,1183,12,16,876,1117,0.42857142857142855,-241,0.43953838434520826
1999,1184,2,23,139,1464,0.08,-1325,0.08671241422333126
1999,1185,5,20,315,1175,0.2,-860,0.21140939597315436
1999,1186,8,17,653,1159,0.32,-506,0.36037527593818985
1999,1187,12,14,816,816,0.46153846153846156,0,0.5
1999,1190,14,11,1067,669,0.56,398,0.6146313364055299
1999,1191,21,9,1606,613,0.7,993,0.7237494366831906
1999,1192,11,16,762,996,0.4074074074074074,-234,0.4334470989761092
1999,1193,12,15,988,1123,0.4444444444444444,-135,0.4680246328754145
1999,1194,5,20,414,1373,0.2,-959,0.23167319529938443
1999,1196,20,8,1715,544,0.7142857142857143,1171,0.7591854803010182
1999,1197,12,18,902,1292,0.4,-390,0.41112123974475845
1999,1198,13,16,949,1062,0.4482758620689655,-113,0.47190452511188463
1999,1199,13,17,985,1133,0.43333333333333335,-148,0.46506137865911235
1999,1200,12,15,846,938,0.4444444444444444,-92,0.4742152466367713
1999,1201,20,11,1709,772,0.6451612903225806,937,0.6888351471180976
1999,1202,11,16,800,986,0.4074074074074074,-186,0.4479283314669653
1999,1203,20,8,1645,572,0.7142857142857143,1073,0.7419936851601263
1999,1204,8,16,561,926,0.3333333333333333,-365,0.3772696704774714
1999,1206,18,10,1398,680,0.6428571428571429,718,0.6727622714148219
1999,1207,14,15,1039,952,0.4827586206896552,87,0.521848317428428
1999,1208,15,14,1105,986,0.5172413793103449,119,0.5284552845528455
1999,1209,16,13,1227,888,0.5517241379310345,339,0.5801418439716312
1999,1210,15,15,1153,870,0.5,283,0.5699456253089471
1999,1211,24,6,1971,398,0.8,1573,0.8319966230476995
1999,1212,5,20,396,1300,0.2,-904,0.23349056603773585
1999,1214,8,19,635,1239,0.2962962962962963,-604,0.33884738527214514
1999,1216,11,16,824,1029,0.4074074074074074,-205,0.44468429573664325
1999,1217,12,13,896,853,0.48,43,0.5122927387078331
1999,1218,6,20,413,1246,0.23076923076923078,-833,0.2489451476793249
1999,1220,20,9,1423,528,0.6896551724137931,895,0.7293695540748334
1999,1221,6,20,402,1086,0.23076923076923078,-684,0.2701612903225806
1999,1222,10,17,727,1187,0.37037037037037035,-460,0.37983281086729365
1999,1224,2,25,150,1493,0.07407407407407407,-1343,0.09129640900791236
1999,1225,14,11,1109,706,0.56,403,0.6110192837465565
1999,1226,5,20,371,1219,0.2,-848,0.23333333333333334
1999,1227,7,21,500,1133,0.25,-633,0.3061849357011635
1999,1228,14,18,931,1036,0.4375,-105,0.47330960854092524
1999,1229,16,14,1173,897,0.5333333333333333,276,0.5666666666666667
1999,1231,22,10,1738,658,0.6875,1080,0.7253756260434057
1999,1232,15,12,1074,793,0.5555555555555556,281,0.5752544188537762
1999,1233,15,14,1213,982,0.5172413793103449,231,0.5526195899772209
1999,1234,18,9,1364,626,0.6666666666666666,738,0.685427135678392
1999,1235,14,15,914,860,0.4827586206896552,54,0.5152198421645998
1999,1237,8,14,595,850,0.36363636363636365,-255,0.4117647058823529
1999,1238,13,12,911,765,0.52,146,0.5435560859188544
1999,1239,10,15,694,890,0.4,-196,0.43813131313131315
1999,1240,6,18,453,1033,0.25,-580,0.30484522207267833
1999,1241,16,11,1212,725,0.5925925925925926,487,0.6257098606091894
1999,1242,21,9,1531,575,0.7,956,0.7269705603038936
1999,1243,19,12,1412,725,0.6129032258064516,687,0.6607393542349087
1999,1245,21,6,1486,387,0.7777777777777778,1099,0.7933796049119061
1999,1246,25,8,1999,493,0.7575757575757576,1506,0.8021669341894061
1999,1247,13,15,1026,997,0.4642857142857143,29,0.5071675729115176
1999,1248,20,7,1501,441,0.7407407407407407,1060,0.7729145211122554
1999,1249,15,11,1194,753,0.5769230769230769,441,0.613251155624037
1999,1250,4,22,294,1298,0.15384615384615385,-1004,0.18467336683417085
1999,1253,12,15,910,896,0.4444444444444444,14,0.5038759689922481
1999,1254,10,17,716,1112,0.37037037037037035,-396,0.3916849015317287
1999,1256,19,9,1533,601,0.6785714285714286,932,0.718369259606373
1999,1257,19,10,1629,619,0.6551724137931034,1010,0.724644128113879
1999,1258,9,16,757,1122,0.36,-365,0.4028738690792975
1999,1259,13,15,1048,1117,0.4642857142857143,-69,0.4840646651270208
1999,1260,9,17,623,941,0.34615384615384615,-318,0.3983375959079284
1999,1261,11,15,765,946,0.4230769230769231,-181,0.44710695499707775
1999,1263,18,9,1519,634,0.6666666666666666,885,0.7055271713887599
1999,1264,5,22,378,1310,0.18518518518518517,-932,0.22393364928909953
1999,1265,16,12,1186,847,0.5714285714285714,339,0.5833743236596163
1999,1266,14,15,951,872,0.4827586206896552,79,0.521667580910587
1999,1267,14,11,1105,780,0.56,325,0.5862068965517241
1999,1268,25,5,2189,383,0.8333333333333334,1806,0.8510886469673405
1999,1269,14,16,936,993,0.4666666666666667,-57,0.48522550544323484
1999,1270,13,15,1095,998,0.4642857142857143,97,0.5231724796942189
1999,1271,10,17,781,1128,0.37037037037037035,-347,0.40911471974855945
1999,1272,13,15,1045,1096,0.4642857142857143,-51,0.4880896777206913
1999,1273,7,18,550,1038,0.28,-488,0.34634760705289674
1999,1274,22,6,1667,373,0.7857142857142857,1294,0.817156862745098
1999,1275,22,7,1591,404,0.7586206896551724,1187,0.7974937343358396
1999,1276,12,19,848,1187,0.3870967741935484,-339,0.4167076167076167
1999,1277,28,4,2046,245,0.875,1801,0.8930597992143169
1999,1278,17,10,1258,607,0.6296296296296297,651,0.6745308310991958
1999,1279,16,12,1340,781,0.5714285714285714,559,0.6317774634606318
1999,1280,19,12,1397,760,0.6129032258064516,637,0.6476587853500232
1999,1281,20,8,1501,521,0.7142857142857143,980,0.7423343224530168
1999,1282,7,20,516,1368,0.25925925925925924,-852,0.27388535031847133
1999,1283,20,10,1563,666,0.6666666666666666,897,0.7012113055181696
1999,1284,5,20,389,1182,0.2,-793,0.24761298535964354
1999,1285,10,14,760,920,0.4166666666666667,-160,0.4523809523809524
1999,1286,13,13,1086,922,0.5,164,0.5408366533864541
1999,1287,11,15,916,1040,0.4230769230769231,-124,0.46830265848670755
1999,1288,14,14,1017,842,0.5,175,0.5470683162990855
1999,1290,12,12,936,799,0.5,137,0.5394812680115274
1999,1291,15,14,1078,918,0.5172413793103449,160,0.5400801603206413
1999,1292,10,17,742,1078,0.37037037037037035,-336,0.4076923076923077
1999,1293,25,5,2040,347,0.8333333333333334,1693,0.854629241726016
1999,1296,6,20,442,1118,0.23076923076923078,-676,0.2833333333333333
1999,1298,17,7,1248,463,0.7083333333333334,785,0.7293980128579778
1999,1299,11,15,827,913,0.4230769230769231,-86,0.4752873563218391
1999,1301,18,13,1420,793,0.5806451612903226,627,0.6416629010393131
1999,1304,19,12,1376,644,0.6129032258064516,732,0.6811881188118812
1999,1305,7,18,585,1105,0.28,-520,0.34615384615384615
1999,1306,4,23,294,1439,0.14814814814814814,-1145,0.16964800923254472
1999,1307,23,8,1909,444,0.7419354838709677,1465,0.8113047173820654
1999,1308,21,8,1529,450,0.7241379310344828,1079,0.7726124305204649
1999,1309,14,16,922,902,0.4666666666666667,20,0.5054824561403509
1999,1310,17,12,1441,900,0.5862068965517241,541,0.6155489107219138
1999,1311,12,15,902,880,0.4444444444444444,22,0.5061728395061729
1999,1313,15,12,1354,974,0.5555555555555556,380,0.5816151202749141
1999,1314,24,9,1741,613,0.7272727272727273,1128,0.7395921835174172
1999,1317,4,22,383,1477,0.15384615384615385,-1094,0.20591397849462365
1999,1318,10,18,739,1188,0.35714285714285715,-449,0.3834976647638817
1999,1319,18,8,1417,556,0.6923076923076923,861,0.7181956411556006
1999,1320,9,18,689,1214,0.3333333333333333,-525,0.36205990541250654
1999,1321,14,13,900,709,0.5185185185185185,191,0.5593536357986327
1999,1322,9,15,674,907,0.375,-233,0.4263124604680582
1999,1323,14,15,1094,992,0.4827586206896552,102,0.5244487056567594
1999,1325,17,10,1349,671,0.6296296296296297,678,0.6678217821782179
1999,1326,22,8,1664,588,0.7333333333333333,1076,0.738898756660746
1999,1328,19,10,1430,624,0.6551724137931034,806,0.6962025316455697
1999,1329,21,10,1538,636,0.6774193548387096,902,0.7074517019319227
1999,1330,22,8,1608,522,0.7333333333333333,1086,0.7549295774647887
1999,1331,15,11,1197,795,0.5769230769230769,402,0.6009036144578314
1999,1332,15,11,1192,755,0.5769230769230769,437,0.6122239342578326
1999,1333,11,14,769,857,0.44,-88,0.47293972939729395
1999,1334,12,13,836,828,0.48,8,0.5024038461538461
1999,1335,21,5,1575,285,0.8076923076923077,1290,0.8467741935483871
1999,1336,13,14,968,902,0.48148148148148145,66,0.5176470588235295
1999,1337,17,12,1149,725,0.5862068965517241,424,0.6131270010672358
1999,1338,14,16,1058,959,0.4666666666666667,99,0.5245413981160139
1999,1339,7,18,524,1117,0.28,-593,0.31931748933577087
1999,1340,15,11,1235,785,0.5769230769230769,450,0.6113861386138614
1999,1341,4,19,369,1228,0.17391304347826086,-859,0.23105823418910457
1999,1343,19,7,1194,410,0.7307692307692307,784,0.7443890274314214
1999,1344,16,13,1299,899,0.5517241379310345,400,0.5909918107370337
1999,1345,19,12,1413,729,0.6129032258064516,684,0.6596638655462185
1999,1346,8,18,574,1173,0.3076923076923077,-599,0.32856325128792213
1999,1347,14,8,1182,491,0.6363636363636364,691,0.7065152420800956
1999,1348,20,12,1522,783,0.625,739,0.6603036876355748
1999,1349,16,10,1189,570,0.6153846153846154,619,0.6759522455940875
1999,1350,15,12,1101,715,0.5555555555555556,386,0.6062775330396476
1999,1351,12,16,941,1112,0.42857142857142855,-171,0.45835362883584996
1999,1352,14,12,1067,789,0.5384615384615384,278,0.5748922413793104
1999,1353,18,12,1378,744,0.6,634,0.649387370405278
1999,1354,16,11,1073,670,0.5925925925925926,403,0.6156052782558806
1999,1356,15,12,1013,733,0.5555555555555556,280,0.5801832760595648
1999,1358,9,16,678,1076,0.36,-398,0.3865450399087799
1999,1359,22,4,1678,239,0.8461538461538461,1439,0.8753260302556077
1999,1360,16,9,1129,541,0.64,588,0.6760479041916168
1999,1361,3,22,221,1421,0.12,-1200,0.1345919610231425
1999,1362,11,18,758,1085,0.3793103448275862,-327,0.4112859468258275
1999,1363,11,16,831,919,0.4074074074074074,-88,0.47485714285714287
1999,1364,14,12,1022,806,0.5384615384615384,216,0.5590809628008753
1999,1365,14,15,978,908,0.4827586206896552,70,0.5185577942735949
1999,1368,4,20,339,1308,0.16666666666666666,-969,0.2058287795992714
1999,1369,18,9,1349,533,0.6666666666666666,816,0.7167906482465463
1999,1371,14,14,1024,841,0.5,183,0.5490616621983915
1999,1372,3,22,220,1496,0.12,-1276,0.1282051282051282
1999,1373,25,5,2185,423,0.8333333333333334,1762,0.8378067484662577
1999,1374,14,14,1094,962,0.5,132,0.5321011673151751
1999,1375,10,16,672,854,0.38461538461538464,-182,0.44036697247706424
1999,1376,8,21,570,1175,0.27586206896551724,-605,0.32664756446991405
1999,1378,14,14,1094,912,0.5,182,0.5453639082751744
1999,1379,14,16,888,983,0.4666666666666667,-95,0.4746125066809193
1999,1380,18,6,1569,435,0.75,1134,0.7829341317365269
1999,1381,10,16,803,1064,0.38461538461538464,-261,0.43010176754151047
1999,1382,14,15,957,903,0.4827586206896552,54,0.5145161290322581
1999,1383,19,8,1573,583,0.7037037037037037,990,0.7295918367346939
1999,1384,9,17,686,1065,0.34615384615384615,-379,0.3917761279268989
1999,1385,25,8,2063,556,0.7575757575757576,1507,0.7877052310042001
1999,1386,11,18,781,1112,0.3793103448275862,-331,0.41257263602746963
1999,1387,15,16,1026,998,0.4838709677419355,28,0.5069169960474308
1999,1388,12,18,898,1132,0.4,-234,0.44236453201970444
1999,1389,14,15,1018,1003,0.4827586206896552,15,0.5037110341415141
1999,1390,23,6,1753,371,0.7931034482758621,1382,0.8253295668549906
1999,1391,12,12,908,730,0.5,178,0.5543345543345544
1999,1393,20,11,1567,677,0.6451612903225806,890,0.698306595365419
1999,1395,18,10,1614,788,0.6428571428571429,826,0.671940049958368
1999,1396,21,10,1473,592,0.6774193548387096,881,0.713317191283293
1999,1397,20,8,1554,511,0.7142857142857143,1043,0.752542372881356
1999,1398,10,14,759,895,0.4166666666666667,-136,0.4588875453446191
1999,1399,9,15,658,913,0.375,-255,0.41884150222788036
1999,1400,19,12,1396,739,0.6129032258064516,657,0.653864168618267
1999,1401,12,15,854,1017,0.4444444444444444,-163,0.4564404061998931
1999,1402,17,9,1272,527,0.6538461538461539,745,0.7070594774874931
1999,1403,13,17,1074,1035,0.43333333333333335,39,0.5092460881934566
1999,1404,5,18,388,1059,0.21739130434782608,-671,0.2681409813407049
1999,1405,16,8,1140,507,0.6666666666666666,633,0.692167577413479
1999,1406,6,22,405,1258,0.21428571428571427,-853,0.24353577871316898
1999,1407,7,18,571,1297,0.28,-726,0.3056745182012848
1999,1408,12,15,934,972,0.4444444444444444,-38,0.4900314795383001
1999,1409,22,9,1675,526,0.7096774193548387,1149,0.761017719218537
1999,1410,5,22,405,1583,0.18518518518518517,-1178,0.20372233400402415
1999,1411,6,18,473,1056,0.25,-583,0.30935251798561153
1999,1412,20,11,1605,699,0.6451612903225806,906,0.6966145833333334
1999,1414,4,20,313,1241,0.16666666666666666,-928,0.20141570141570142
1999,1416,17,10,1311,619,0.6296296296296297,692,0.6792746113989637
1999,1417,22,8,1808,531,0.7333333333333333,1277,0.7729799059427106
1999,1418,13,16,919,1032,0.4482758620689655,-113,0.47104049205535625
1999,1419,12,14,936,919,0.46153846153846156,17,0.5045822102425876
1999,1420,19,9,1317,570,0.6785714285714286,747,0.6979332273449921
1999,1421,7,17,614,1153,0.2916666666666667,-539,0.34748160724391625
1999,1422,7,20,503,1253,0.25925925925925924,-750,0.2864464692482916
1999,1423,11,17,717,969,0.39285714285714285,-252,0.42526690391459077
1999,1424,15,12,1195,810,0.5555555555555556,385,0.5960099750623441
1999,1425,15,12,1199,847,0.5555555555555556,352,0.5860215053763441
1999,1426,9,15,757,947,0.375,-190,0.4442488262910798
1999,1427,16,10,1253,758,0.6153846153846154,495,0.6230730979612134
1999,1428,24,4,1757,234,0.8571428571428571,1523,0.8824711200401808
1999,1429,12,13,875,884,0.48,-9,0.4974417282546902
1999,1431,15,12,1105,752,0.5555555555555556,353,0.5950457727517501
1999,1433,15,16,1177,1044,0.4838709677419355,133,0.529941467807294
1999,1434,17,8,1328,475,0.68,853,0.7365501941209096
1999,1435,13,15,1046,932,0.4642857142857143,114,0.5288169868554095
1999,1436,11,16,771,993,0.4074074074074074,-222,0.4370748299319728
1999,1437,20,10,1565,698,0.6666666666666666,867,0.6915598762704375
1999,1438,13,16,1037,1040,0.4482758620689655,-3,0.4992778045257583
1999,1439,13,15,962,867,0.4642857142857143,95,0.5259704756697648
1999,1440,9,13,672,816,0.4090909090909091,-144,0.45161290322580644
1999,1441,4,21,274,1225,0.16,-951,0.1827885256837892
1999,1442,13,11,995,713,0.5416666666666666,282,0.582552693208431
1999,1443,12,16,822,973,0.42857142857142855,-151,0.45793871866295266
1999,1444,10,15,756,989,0.4,-233,0.4332378223495702
1999,1447,9,18,674,1131,0.3333333333333333,-457,0.3734072022160665
1999,1448,16,13,1154,763,0.5517241379310345,391,0.6019822639540949
1999,1449,16,11,1287,726,0.5925925925925926,561,0.639344262295082
1999,1450,9,18,763,1187,0.3333333333333333,-424,0.3912820512820513
1999,1451,21,7,1769,458,0.75,1311,0.7943421643466547
1999,1452,9,19,651,1202,0.32142857142857145,-551,0.3513221802482461
1999,1453,18,11,1211,563,0.6206896551724138,648,0.6826381059751973
1999,1454,6,18,402,1114,0.25,-712,0.26517150395778366
1999,1455,12,17,972,1040,0.41379310344827586,-68,0.4831013916500994
1999,1456,6,19,423,1140,0.24,-717,0.2706333973128599
1999,1457,15,6,1111,328,0.7142857142857143,783,0.7720639332870048
1999,1458,22,9,1478,477,0.7096774193548387,1001,0.7560102301790281
1999,1459,9,16,689,1015,0.36,-326,0.4043427230046948
1999,1460,8,18,640,1142,0.3076923076923077,-502,0.35914702581369246
1999,1461,17,9,1436,697,0.6538461538461539,739,0.673230192217534
1999,1462,21,10,1641,722,0.6774193548387096,919,0.6944561997460855
1999,1463,3,22,206,1260,0.12,-1054,0.14051841746248295
1999,1464,12,12,838,770,0.5,68,0.5211442786069652
1999,3102,4,21,251,1094,0.16,-843,0.18661710037174722
1999,3103,16,12,1185,792,0.5714285714285714,393,0.5993930197268589
1999,3104,19,10,1572,695,0.6551724137931034,877,0.6934274371415968
1999,3105,7,18,494,1005,0.28,-511,0.3295530353569046
1999,3106,13,12,816,739,0.52,77,0.52475884244373
1999,3108,14,12,1015,696,0.5384615384615384,319,0.5932203389830508
1999,3110,11,16,844,1045,0.4074074074074074,-201,0.4467972472207517
1999,3111,13,14,1013,973,0.48148148148148145,40,0.5100704934541792
1999,3112,17,10,1336,682,0.6296296296296297,654,0.6620416253716551
1999,3113,12,15,874,913,0.4444444444444444,-39,0.4890878567431449
1999,3115,2,23,123,1257,0.08,-1134,0.0891304347826087
1999,3116,15,14,1253,865,0.5172413793103449,388,0.5915958451369216
1999,3117,16,13,1261,852,0.5517241379310345,409,0.5967818267865594
1999,3119,5,21,308,1234,0.19230769230769232,-926,0.19974059662775617
1999,3120,19,8,1437,523,0.7037037037037037,914,0.7331632653061224
1999,3122,6,20,430,1168,0.23076923076923078,-738,0.2690863579474343
1999,3123,8,17,625,1151,0.32,-526,0.3519144144144144
1999,3124,16,13,1247,790,0.5517241379310345,457,0.6121747668139421
1999,3125,17,8,1247,455,0.68,792,0.7326674500587544
1999,3126,4,23,272,1252,0.14814814814814814,-980,0.1784776902887139
1999,3129,13,14,852,789,0.48148148148148145,63,0.5191956124314442
1999,3130,21,7,1539,427,0.75,1112,0.7828077314343845
1999,3131,5,22,384,1336,0.18518518518518517,-952,0.22325581395348837
1999,3132,13,14,1154,879,0.48148148148148145,275,0.5676340383669454
1999,3133,6,19,500,1213,0.24,-713,0.29188558085230587
1999,3135,12,14,897,850,0.46153846153846156,47,0.5134516313680595
1999,3137,13,13,932,747,0.5,185,0.5550923168552709
1999,3138,15,12,1116,731,0.5555555555555556,385,0.6042230644288035
1999,3139,17,11,1375,724,0.6071428571428571,651,0.6550738446879466
1999,3140,16,12,1226,689,0.5714285714285714,537,0.6402088772845953
1999,3141,11,15,865,1001,0.4230769230769231,-136,0.46355841371918544
1999,3142,6,18,440,1089,0.25,-649,0.28776978417266186
1999,3143,12,15,796,885,0.4444444444444444,-89,0.47352766210588937
1999,3144,16,11,1181,666,0.5925925925925926,515,0.6394152680021656
1999,3145,13,15,1081,1029,0.4642857142857143,52,0.5123222748815166
1999,3148,11,16,773,972,0.4074074074074074,-199,0.44297994269340973
1999,3149,14,10,1027,595,0.5833333333333334,432,0.6331689272503083
1999,3150,6,21,390,1265,0.2222222222222222,-875,0.23564954682779457
1999,3151,10,17,785,1107,0.37037037037037035,-322,0.41490486257928116
1999,3152,1,26,62,1493,0.037037037037037035,-1431,0.03987138263665595
1999,3153,22,8,1597,459,0.7333333333333333,1138,0.7767509727626459
1999,3155,24,5,1795,346,0.8275862068965517,1449,0.8383932741709481
1999,3156,15,13,1245,835,0.5357142857142857,410,0.5985576923076923
1999,3157,16,10,1089,552,0.6153846153846154,537,0.6636197440585009
1999,3158,6,21,437,1266,0.2222222222222222,-829,0.2566059894304169
1999,3159,8,18,475,927,0.3076923076923077,-452,0.3388017118402282
1999,3160,14,13,1016,833,0.5185185185185185,183,0.5494862087614927
1999,3161,31,2,2504,124,0.9393939393939394,2380,0.9528158295281582
1999,3162,4,20,260,1126,0.16666666666666666,-866,0.18759018759018758
1999,3163,27,4,2559,300,0.8709677419354839,2259,0.8950682056663168
1999,3164,13,14,984,880,0.48148148148148145,104,0.5278969957081545
1999,3165,11,15,853,939,0.4230769230769231,-86,0.4760044642857143
1999,3166,16,13,1146,797,0.5517241379310345,349,0.5898095728255275
1999,3168,4,22,307,1290,0.15384615384615385,-983,0.19223544145272387
1999,3169,21,7,1561,487,0.75,1074,0.76220703125
1999,3170,3,23,224,1278,0.11538461538461539,-1054,0.14913448735019974
1999,3171,18,8,1295,534,0.6923076923076923,761,0.708037178786222
1999,3172,17,9,1359,622,0.6538461538461539,737,0.6860171630489652
1999,3173,11,17,798,981,0.39285714285714285,-183,0.448566610455312
1999,3174,16,11,1182,731,0.5925925925925926,451,0.6178776790381599
1999,3175,10,17,603,986,0.37037037037037035,-383,0.37948395217117686
1999,3176,11,15,806,798,0.4230769230769231,8,0.5024937655860349
1999,3177,12,15,906,938,0.4444444444444444,-32,0.4913232104121475
1999,3178,13,15,947,1036,0.4642857142857143,-89,0.47755925365607665
1999,3179,18,9,1420,606,0.6666666666666666,814,0.700888450148075
1999,3180,12,16,810,915,0.42857142857142855,-105,0.46956521739130436
1999,3181,24,6,2037,407,0.8,1630,0.8334697217675942
1999,3182,15,13,1066,787,0.5357142857142857,279,0.5752833243389098
1999,3183,5,21,373,1381,0.19230769230769232,-1008,0.21265678449258837
1999,3184,11,16,843,1116,0.4074074074074074,-273,0.43032159264931086
1999,3185,14,13,1131,868,0.5185185185185185,263,0.5657828914457229
1999,3186,8,18,545,975,0.3076923076923077,-430,0.35855263157894735
1999,3187,16,13,1213,839,0.5517241379310345,374,0.5911306042884991
1999,3189,4,23,270,1280,0.14814814814814814,-1010,0.17419354838709677
1999,3190,16,12,1256,762,0.5714285714285714,494,0.622398414271556
1999,3191,19,10,1375,652,0.6551724137931034,723,0.6783423778983719
1999,3192,7,19,519,1124,0.2692307692307692,-605,0.31588557516737675
1999,3193,12,15,944,1004,0.4444444444444444,-60,0.48459958932238195
1999,3194,5,20,408,1341,0.2,-933,0.2332761578044597
1999,3196,19,13,1555,902,0.59375,653,0.6328856328856329
1999,3197,18,11,1209,711,0.6206896551724138,498,0.6296875
1999,3198,23,6,1778,373,0.7931034482758621,1405,0.8265922826592282
1999,3199,7,20,569,1401,0.25925925925925924,-832,0.28883248730964467
1999,3200,9,18,605,1029,0.3333333333333333,-424,0.37025703794369647
1999,3201,9,19,660,1120,0.32142857142857145,-460,0.3707865168539326
1999,3202,13,14,938,883,0.48148148148148145,55,0.5151015925315761
1999,3203,19,9,1509,578,0.6785714285714286,931,0.7230474365117393
1999,3204,13,14,1102,918,0.48148148148148145,184,0.5455445544554456
1999,3206,13,14,982,848,0.48148148148148145,134,0.5366120218579234
1999,3207,18,11,1363,669,0.6206896551724138,694,0.6707677165354331
1999,3208,23,6,1998,422,0.7931034482758621,1576,0.8256198347107438
1999,3209,14,12,1052,776,0.5384615384615384,276,0.5754923413566739
1999,3210,13,14,1116,919,0.48148148148148145,197,0.5484029484029485
1999,3211,8,19,554,1073,0.2962962962962963,-519,0.3405039950829748
1999,3212,24,4,2130,295,0.8571428571428571,1835,0.8783505154639175
1999,3214,18,10,1289,568,0.6428571428571429,721,0.6941303177167475
1999,3216,8,18,521,989,0.3076923076923077,-468,0.34503311258278146
1999,3217,9,15,636,931,0.375,-295,0.40587109125717935
1999,3218,17,10,1196,597,0.6296296296296297,599,0.6670384829894033
1999,3219,6,16,383,946,0.2727272727272727,-563,0.28818660647103084
1999,3220,9,19,587,1078,0.32142857142857145,-491,0.3525525525525526
1999,3221,21,7,1639,446,0.75,1193,0.7860911270983213
1999,3222,4,22,268,1435,0.15384615384615385,-1167,0.15736934820904286
1999,3224,16,12,1110,739,0.5714285714285714,371,0.6003244997295836
1999,3225,15,12,1145,822,0.5555555555555556,323,0.5821047280122014
1999,3226,7,18,436,994,0.28,-558,0.3048951048951049
1999,3227,5,22,328,1170,0.18518518518518517,-842,0.21895861148197596
1999,3228,18,11,1520,814,0.6206896551724138,706,0.6512425021422451
1999,3229,7,20,542,1170,0.25925925925925924,-628,0.316588785046729
1999,3231,13,18,1021,1195,0.41935483870967744,-174,0.46074007220216606
1999,3232,18,10,1243,597,0.6428571428571429,646,0.6755434782608696
1999,3233,11,16,786,918,0.4074074074074074,-132,0.4612676056338028
1999,3234,12,15,891,1009,0.4444444444444444,-118,0.4689473684210526
1999,3235,22,7,1732,436,0.7586206896551724,1296,0.7988929889298892
1999,3237,9,17,659,1062,0.34615384615384615,-403,0.3829169087739686
1999,3238,14,9,952,488,0.6086956521739131,464,0.6611111111111111
1999,3240,15,14,1163,894,0.5172413793103449,269,0.5653864851725814
1999,3241,11,20,751,1086,0.3548387096774194,-335,0.4088187261839956
1999,3242,22,9,1462,525,0.7096774193548387,937,0.7357825868142929
1999,3243,15,13,1089,743,0.5357142857142857,346,0.5944323144104804
1999,3245,22,7,1820,415,0.7586206896551724,1405,0.814317673378076
1999,3246,20,10,1560,645,0.6666666666666666,915,0.7074829931972789
1999,3247,14,14,976,725,0.5,251,0.5737801293356849
1999,3248,8,20,531,1176,0.2857142857142857,-645,0.3110720562390158
1999,3249,9,17,578,943,0.34615384615384615,-365,0.3800131492439185
1999,3250,14,12,953,734,0.5384615384615384,219,0.5649081209247184
1999,3251,21,7,1453,456,0.75,997,0.7611314824515453
1999,3253,18,11,1352,700,0.6206896551724138,652,0.6588693957115009
1999,3254,2,24,117,1289,0.07692307692307693,-1172,0.08321479374110953
1999,3256,26,2,2355,138,0.9285714285714286,2217,0.9446450060168472
1999,3257,21,10,1642,637,0.6774193548387096,1005,0.7204914436156209
1999,3258,8,19,556,1159,0.2962962962962963,-603,0.324198250728863
1999,3259,21,7,1404,375,0.75,1029,0.7892074198988196
1999,3260,3,22,188,1193,0.12,-1005,0.13613323678493844
1999,3261,20,7,1595,432,0.7407407407407407,1163,0.7868771583621115
1999,3263,23,6,1764,384,0.7931034482758621,1380,0.8212290502793296
1999,3264,10,18,734,1142,0.35714285714285715,-408,0.39125799573560766
1999,3265,4,23,258,1292,0.14814814814814814,-1034,0.1664516129032258
1999,3266,21,7,1539,462,0.75,1077,0.7691154422788605
1999,3267,4,22,303,1386,0.15384615384615385,-1083,0.17939609236234458
1999,3268,6,21,494,1129,0.2222222222222222,-635,0.30437461491065926
1999,3269,16,14,1103,812,0.5333333333333333,291,0.5759791122715404
1999,3270,14,12,897,669,0.5384615384615384,228,0.5727969348659003
1999,3271,11,17,765,978,0.39285714285714285,-213,0.4388984509466437
1999,3272,19,9,1520,562,0.6785714285714286,958,0.7300672430355427
1999,3273,9,17,639,958,0.34615384615384615,-319,0.4001252348152787
1999,3274,15,13,1174,771,0.5357142857142857,403,0.603598971722365
1999,3275,11,15,841,976,0.4230769230769231,-135,0.4628508530544854
1999,3276,17,11,1414,668,0.6071428571428571,746,0.6791546589817483
1999,3277,15,13,1149,822,0.5357142857142857,327,0.5829528158295282
1999,3278,7,20,469,1128,0.25925925925925924,-659,0.2936756418284283
1999,3279,15,12,1101,693,0.5555555555555556,408,0.6137123745819398
1999,3280,17,10,1340,572,0.6296296296296297,768,0.700836820083682
1999,3281,12,15,887,881,0.4444444444444444,6,0.5016968325791855
1999,3282,11,14,818,860,0.44,-42,0.48748510131108463
1999,3283,24,6,1953,374,0.8,1579,0.8392780403953588
1999,3284,16,13,1206,876,0.5517241379310345,330,0.579250720461095
1999,3285,11,16,778,882,0.4074074074074074,-104,0.4686746987951807
1999,3286,16,10,1112,546,0.6153846153846154,566,0.6706875753920386
1999,3287,4,21,330,1410,0.16,-1080,0.1896551724137931
1999,3288,12,16,765,810,0.42857142857142855,-45,0.4857142857142857
1999,3290,17,8,1239,463,0.68,776,0.7279670975323149
1999,3291,21,7,1586,479,0.75,1107,0.7680387409200968
1999,3292,17,9,1377,621,0.6538461538461539,756,0.6891891891891891
1999,3293,10,17,694,1045,0.37037037037037035,-351,0.39907993099482464
1999,3296,10,16,683,851,0.38461538461538464,-168,0.4452411994784876
1999,3298,17,11,1212,636,0.6071428571428571,576,0.6558441558441559
1999,3299,10,17,671,860,0.37037037037037035,-189,0.43827563683866755
1999,3301,16,11,1316,684,0.5925925925925926,632,0.658
1999,3304,21,11,1645,684,0.65625,961,0.7063117217689996
1999,3305,9,19,626,1060,0.32142857142857145,-434,0.37129300118623965
1999,3306,19,7,1298,415,0.7307692307692307,883,0.7577349678925861
1999,3307,22,6,1459,316,0.7857142857142857,1143,0.8219718309859155
1999,3308,6,18,408,956,0.25,-548,0.2991202346041056
1999,3309,11,16,896,1005,0.4074074074074074,-109,0.4713308784850079
1999,3310,10,18,746,1160,0.35714285714285715,-414,0.391395592864638
1999,3311,13,14,808,815,0.48148148148148145,-7,0.49784349969192854
1999,3313,15,13,1049,791,0.5357142857142857,258,0.5701086956521739
1999,3314,26,7,2243,514,0.7878787878787878,1729,0.8135654697134567
1999,3317,19,8,1448,485,0.7037037037037037,963,0.7490946714950854
1999,3318,22,7,1485,429,0.7586206896551724,1056,0.7758620689655172
1999,3319,14,14,998,826,0.5,172,0.5471491228070176
1999,3320,19,8,1398,496,0.7037037037037037,902,0.7381203801478353
1999,3321,12,16,873,1037,0.42857142857142855,-164,0.4570680628272251
1999,3322,22,6,1609,425,0.7857142857142857,1184,0.7910521140609637
1999,3323,25,4,2109,278,0.8620689655172413,1831,0.88353581901969
1999,3324,13,13,1046,930,0.5,116,0.5293522267206477
1999,3325,4,22,328,1454,0.15384615384615385,-1126,0.1840628507295174
1999,3326,17,11,1229,687,0.6071428571428571,542,0.6414405010438413
1999,3328,14,13,1160,862,0.5185185185185185,298,0.5736894164193868
1999,3329,13,15,915,864,0.4642857142857143,51,0.5143338954468802
1999,3330,26,3,2124,206,0.896551724137931,1918,0.911587982832618
1999,3331,15,12,1127,680,0.5555555555555556,447,0.6236856668511345
1999,3332,24,5,1725,342,0.8275862068965517,1383,0.8345428156748912
1999,3333,11,16,724,922,0.4074074074074074,-198,0.4398541919805589
1999,3334,14,13,1017,797,0.5185185185185185,220,0.5606394707828004
1999,3335,12,14,897,874,0.46153846153846156,23,0.5064935064935064
1999,3336,21,7,1728,460,0.75,1268,0.7897623400365631
1999,3337,21,8,1535,540,0.7241379310344828,995,0.7397590361445783
1999,3338,8,19,528,1082,0.2962962962962963,-554,0.3279503105590062
1999,3339,16,12,1144,762,0.5714285714285714,382,0.6002098635886673
1999,3340,18,10,1310,613,0.6428571428571429,697,0.6812272490899636
1999,3341,4,21,238,1044,0.16,-806,0.1856474258970359
1999,3343,16,11,937,566,0.5925925925925926,371,0.6234198270126414
1999,3344,5,22,435,1257,0.18518518518518517,-822,0.2570921985815603
1999,3345,28,1,2185,72,0.9655172413793104,2113,0.9680992467877714
1999,3346,9,18,630,1005,0.3333333333333333,-375,0.3853211009174312
1999,3347,11,17,759,931,0.39285714285714285,-172,0.44911242603550294
1999,3348,4,22,305,1236,0.15384615384615385,-931,0.19792342634652824
1999,3349,18,11,1314,609,0.6206896551724138,705,0.6833073322932918
1999,3350,15,13,1217,967,0.5357142857142857,250,0.5572344322344323
1999,3351,7,20,523,1340,0.25925925925925924,-817,0.28073000536768655
1999,3352,9,17,579,992,0.34615384615384615,-413,0.36855506047103753
1999,3353,26,5,1874,288,0.8387096774193549,1586,0.8667900092506938
1999,3354,7,20,417,1147,0.25925925925925924,-730,0.2666240409207161
1999,3356,6,21,414,1122,0.2222222222222222,-708,0.26953125
1999,3358,13,14,1003,816,0.48148148148148145,187,0.5514018691588785
1999,3359,8,18,617,1125,0.3076923076923077,-508,0.3541905855338691
1999,3360,14,13,913,703,0.5185185185185185,210,0.5649752475247525
1999,3361,7,19,539,1061,0.2692307692307692,-522,0.336875
1999,3362,7,20,500,1101,0.25925925925925924,-601,0.3123048094940662
1999,3363,2,25,122,1172,0.07407407407407407,-1050,0.09428129829984544
1999,3364,26,3,2235,233,0.896551724137931,2002,0.9055915721231766
1999,3365,22,6,1656,358,0.7857142857142857,1298,0.8222442899702085
1999,3368,8,16,513,894,0.3333333333333333,-381,0.3646055437100213
1999,3369,17,9,1344,567,0.6538461538461539,777,0.7032967032967034
1999,3371,6,21,434,1199,0.2222222222222222,-765,0.2657685241886099
1999,3372,17,11,1351,766,0.6071428571428571,585,0.6381672177609825
1999,3373,21,8,1663,517,0.7241379310344828,1146,0.7628440366972477
1999,3374,19,10,1422,661,0.6551724137931034,761,0.6826692270763323
1999,3375,4,19,287,990,0.17391304347826086,-703,0.22474549725920126
1999,3376,11,16,963,1039,0.4074074074074074,-76,0.481018981018981
1999,3378,14,13,1041,825,0.5185185185185185,216,0.5578778135048231
1999,3379,11,17,826,1083,0.39285714285714285,-257,0.4326872708224201
1999,3380,10,15,649,985,0.4,-336,0.39718482252141984
1999,3381,14,12,1013,735,0.5384615384615384,278,0.5795194508009154
1999,3382,10,17,763,1069,0.37037037037037035,-306,0.4164847161572052
1999,3383,10,17,631,921,0.37037037037037035,-290,0.4065721649484536
1999,3384,18,11,1313,683,0.6206896551724138,630,0.6578156312625251
1999,3385,12,18,886,1044,0.4,-158,0.45906735751295336
1999,3386,22,7,1472,436,0.7586206896551724,1036,0.7714884696016772
1999,3387,16,12,1207,688,0.5714285714285714,519,0.6369393139841689
1999,3388,26,6,1897,322,0.8125,1575,0.8548895899053628
1999,3389,25,5,1708,317,0.8333333333333334,1391,0.8434567901234568
1999,3390,18,11,1388,706,0.6206896551724138,682,0.6628462273161414
1999,3391,7,20,500,1238,0.25925925925925924,-738,0.28768699654775604
1999,3393,10,17,815,1049,0.37037037037037035,-234,0.43723175965665234
1999,3395,16,12,1305,764,0.5714285714285714,541,0.6307394876752054
1999,3396,8,19,545,1000,0.2962962962962963,-455,0.35275080906148865
1999,3397,28,2,2482,137,0.9333333333333333,2345,0.9476899579992364
1999,3398,12,15,862,939,0.4444444444444444,-77,0.47862298722931707
1999,3399,20,8,1591,502,0.7142857142857143,1089,0.7601528905876732
1999,3400,16,11,1243,683,0.5925925925925926,560,0.6453790238836968
1999,3401,7,20,490,1276,0.25925925925925924,-786,0.27746319365798416
1999,3402,5,21,338,1201,0.19230769230769232,-863,0.21962313190383365
1999,3403,28,3,2134,179,0.9032258064516129,1955,0.922611327280588
1999,3404,21,8,1706,525,0.7241379310344828,1181,0.764679515912147
1999,3405,25,5,2078,333,0.8333333333333334,1745,0.8618830360846121
1999,3406,12,16,825,862,0.42857142857142855,-37,0.4890337877889745
1999,3407,8,19,548,1241,0.2962962962962963,-693,0.3063163778647289
1999,3408,24,5,1850,298,0.8275862068965517,1552,0.861266294227188
1999,3409,7,20,459,1160,0.25925925925925924,-701,0.2835083384805435
1999,3410,5,18,390,1016,0.21739130434782608,-626,0.2773826458036984
1999,3411,10,18,659,1080,0.35714285714285715,-421,0.378953421506613
1999,3412,13,14,931,824,0.48148148148148145,107,0.5304843304843305
1999,3414,11,16,733,938,0.4074074074074074,-205,0.4386594853381209
1999,3416,20,9,1479,603,0.6896551724137931,876,0.7103746397694525
1999,3417,23,7,2005,589,0.7666666666666667,1416,0.7729375481881264
1999,3418,1,26,62,1412,0.037037037037037035,-1350,0.04206241519674356
1999,3419,14,15,943,855,0.4827586206896552,88,0.5244716351501668
1999,3420,13,14,877,761,0.48148148148148145,116,0.5354090354090354
1999,3421,5,23,323,1150,0.17857142857142858,-827,0.21928038017651053
1999,3422,20,8,1531,540,0.7142857142857143,991,0.7392563978754225
1999,3423,10,17,628,948,0.37037037037037035,-320,0.39847715736040606
1999,3424,17,11,1201,678,0.6071428571428571,523,0.6391697711548696
1999,3425,7,20,495,1189,0.25925925925925924,-694,0.29394299287410924
1999,3426,17,10,1129,535,0.6296296296296297,594,0.6784855769230769
1999,3427,6,20,398,1081,0.23076923076923078,-683,0.2691007437457742
1999,3428,20,6,1353,350,0.7692307692307693,1003,0.7944803288314739
1999,3431,11,14,682,696,0.44,-14,0.4949201741654572
1999,3433,10,17,772,1015,0.37037037037037035,-243,0.43200895355344154
1999,3434,16,11,1158,654,0.5925925925925926,504,0.6390728476821192
1999,3435,13,14,1007,899,0.48148148148148145,108,0.5283315844700944
1999,3436,17,12,1282,730,0.5862068965517241,552,0.6371769383697813
1999,3437,14,14,876,747,0.5,129,0.5397412199630314
1999,3438,20,8,1588,545,0.7142857142857143,1043,0.7444913267698078
1999,3439,26,2,1892,146,0.9285714285714286,1746,0.9283611383709519
1999,3441,12,16,843,980,0.42857142857142855,-137,0.46242457487657707
1999,3442,7,19,474,1108,0.2692307692307692,-634,0.2996207332490518
1999,3443,21,7,1724,468,0.75,1256,0.7864963503649635
1999,3444,19,9,1511,565,0.6785714285714286,946,0.7278420038535646
1999,3447,16,12,1104,640,0.5714285714285714,464,0.6330275229357798
1999,3448,8,20,616,1175,0.2857142857142857,-559,0.34394193188163036
1999,3449,15,12,1206,760,0.5555555555555556,446,0.6134282807731435
1999,3450,11,16,863,1044,0.4074074074074074,-181,0.45254326166754066
1999,3451,11,16,703,891,0.4074074074074074,-188,0.4410288582183187
1999,3452,10,17,747,1199,0.37037037037037035,-452,0.38386433710174717
1999,3453,19,9,1412,586,0.6785714285714286,826,0.7067067067067067
1999,3454,11,16,778,994,0.4074074074074074,-216,0.43905191873589167
1999,3455,16,11,1096,606,0.5925925925925926,490,0.6439482961222092
1999,3456,15,12,1021,704,0.5555555555555556,317,0.5918840579710145
1999,3457,10,16,694,907,0.38461538461538464,-213,0.4334790755777639
1999,3458,14,13,1084,857,0.5185185185185185,227,0.5584750128799588
1999,3459,8,19,589,1226,0.2962962962962963,-637,0.3245179063360882
1999,3460,7,20,495,1072,0.25925925925925924,-577,0.31589023611997447
1999,3461,6,19,431,1147,0.24,-716,0.27313054499366285
1999,3462,23,8,1811,515,0.7419354838709677,1296,0.7785898538263113
1999,3463,10,16,684,870,0.38461538461538464,-186,0.44015444015444016
1999,3464,20,9,1572,575,0.6896551724137931,997,0.7321844434094085
2000,1102,6,20,446,1283,0.23076923076923078,-837,0.25795257374204744
2000,1103,16,11,1278,743,0.5925925925925926,535,0.632360217714003
2000,1104,13,16,1056,1038,0.4482758620689655,18,0.504297994269341
2000,1105,15,10,1177,649,0.6,528,0.6445783132530121
2000,1106,10,14,696,869,0.4166666666666667,-173,0.4447284345047923
2000,1107,8,17,560,993,0.32,-433,0.360592401802962
2000,1108,17,10,1352,631,0.6296296296296297,721,0.6817952597075139
2000,1110,10,18,735,1086,0.35714285714285715,-351,0.40362438220757824
2000,1111,20,8,1644,492,0.7142857142857143,1152,0.7696629213483146
2000,1112,26,6,2050,419,0.8125,1631,0.8302956662616444
2000,1113,17,12,1449,847,0.5862068965517241,602,0.6310975609756098
2000,1114,4,24,333,1552,0.14285714285714285,-1219,0.176657824933687
2000,1115,5,20,425,1204,0.2,-779,0.2608962553713935
2000,1116,19,14,1519,939,0.5757575757575758,580,0.6179820992676973
2000,1117,10,18,814,1190,0.35714285714285715,-376,0.406187624750499
2000,1119,3,23,170,1179,0.11538461538461539,-1009,0.12601927353595255
2000,1120,22,9,1607,577,0.7096774193548387,1030,0.7358058608058609
2000,1122,16,10,1218,695,0.6153846153846154,523,0.6366962885520125
2000,1123,21,8,1609,533,0.7241379310344828,1076,0.7511671335200747
2000,1124,13,15,978,873,0.4642857142857143,105,0.5283630470016207
2000,1125,4,20,306,1279,0.16666666666666666,-973,0.19305993690851736
2000,1126,14,14,1141,972,0.5,169,0.5399905347846663
2000,1129,12,15,822,858,0.4444444444444444,-36,0.48928571428571427
2000,1130,11,19,871,1178,0.36666666666666664,-307,0.4250854075158614
2000,1131,7,22,457,1305,0.2413793103448276,-848,0.2593643586833144
2000,1132,21,7,1623,460,0.75,1163,0.7791646663466154
2000,1133,14,16,996,962,0.4666666666666667,34,0.508682328907048
2000,1135,8,19,614,1223,0.2962962962962963,-609,0.3342406096897115
2000,1137,16,11,1067,647,0.5925925925925926,420,0.6225204200700116
2000,1138,5,23,374,1504,0.17857142857142858,-1130,0.19914802981895632
2000,1139,23,7,1627,412,0.7666666666666667,1215,0.7979401667484061
2000,1140,19,10,1408,614,0.6551724137931034,794,0.6963402571711177
2000,1141,5,23,392,1512,0.17857142857142858,-1120,0.20588235294117646
2000,1142,7,18,599,1309,0.28,-710,0.3139412997903564
2000,1143,16,14,1249,937,0.5333333333333333,312,0.5713632204940531
2000,1144,12,16,769,991,0.42857142857142855,-222,0.4369318181818182
2000,1145,10,20,823,1366,0.3333333333333333,-543,0.3759707629054363
2000,1147,7,16,487,880,0.30434782608695654,-393,0.3562545720555962
2000,1148,25,5,1863,341,0.8333333333333334,1522,0.8452813067150635
2000,1149,6,20,439,1225,0.23076923076923078,-786,0.26382211538461536
2000,1150,17,15,1267,934,0.53125,333,0.5756474329850069
2000,1151,9,18,654,1217,0.3333333333333333,-563,0.34954569748797437
2000,1152,9,18,622,1124,0.3333333333333333,-502,0.35624284077892326
2000,1153,28,3,2244,191,0.9032258064516129,2053,0.9215605749486653
2000,1154,6,19,450,1120,0.24,-670,0.28662420382165604
2000,1155,10,20,678,1255,0.3333333333333333,-577,0.35075012933264355
2000,1156,15,14,1219,969,0.5172413793103449,250,0.5571297989031079
2000,1157,10,18,744,1223,0.35714285714285715,-479,0.3782409761057448
2000,1158,20,6,1435,354,0.7692307692307693,1081,0.8021240916713248
2000,1159,11,16,759,929,0.4074074074074074,-170,0.4496445497630332
2000,1160,17,13,1346,884,0.5666666666666667,462,0.6035874439461884
2000,1161,17,12,1255,776,0.5862068965517241,479,0.6179222058099458
2000,1162,12,14,786,735,0.46153846153846156,51,0.5167652859960552
2000,1163,24,9,1873,612,0.7272727272727273,1261,0.7537223340040241
2000,1164,15,15,1157,860,0.5,297,0.5736241943480417
2000,1165,9,17,645,1040,0.34615384615384615,-395,0.3827893175074184
2000,1166,23,9,1741,600,0.71875,1141,0.7436992738146091
2000,1168,7,18,532,1232,0.28,-700,0.30158730158730157
2000,1169,19,10,1497,752,0.6551724137931034,745,0.665629168519342
2000,1170,8,18,524,1081,0.3076923076923077,-557,0.3264797507788162
2000,1171,8,18,601,1079,0.3076923076923077,-478,0.35773809523809524
2000,1172,12,13,882,921,0.48,-39,0.4891846921797005
2000,1173,22,8,1644,509,0.7333333333333333,1135,0.763585694379935
2000,1174,24,7,1919,465,0.7741935483870968,1454,0.8049496644295302
2000,1175,6,22,422,1336,0.21428571428571427,-914,0.24004550625711035
2000,1176,6,22,455,1395,0.21428571428571427,-940,0.24594594594594596
2000,1177,20,11,1506,690,0.6451612903225806,816,0.6857923497267759
2000,1178,18,12,1333,724,0.6,609,0.648031113271755
2000,1179,11,18,751,1048,0.3793103448275862,-297,0.41745414118954977
2000,1180,13,17,858,1031,0.43333333333333335,-173,0.45420857596611963
2000,1181,27,4,2449,314,0.8709677419354839,2135,0.8863554107853782
2000,1182,9,20,729,1280,0.3103448275862069,-551,0.3628670980587357
2000,1183,15,12,1264,891,0.5555555555555556,373,0.5865429234338747
2000,1184,4,21,303,1392,0.16,-1089,0.17876106194690267
2000,1185,13,13,972,869,0.5,103,0.5279739272134709
2000,1186,13,10,1027,641,0.5652173913043478,386,0.6157074340527577
2000,1187,9,18,629,1083,0.3333333333333333,-454,0.36740654205607476
2000,1189,10,15,782,1013,0.4,-231,0.43565459610027857
2000,1190,12,15,904,927,0.4444444444444444,-23,0.4937192790824686
2000,1191,18,12,1348,721,0.6,627,0.6515224746254229
2000,1192,16,11,1080,644,0.5925925925925926,436,0.6264501160092807
2000,1193,14,15,1102,1120,0.4827586206896552,-18,0.495949594959496
2000,1194,1,28,66,1700,0.034482758620689655,-1634,0.03737259343148358
2000,1196,24,7,2123,506,0.7741935483870968,1617,0.8075313807531381
2000,1197,9,22,677,1322,0.2903225806451613,-645,0.3386693346673337
2000,1198,15,14,1133,943,0.5172413793103449,190,0.5457610789980732
2000,1199,12,17,837,1037,0.41379310344827586,-200,0.4466382070437567
2000,1200,14,15,1170,1019,0.4827586206896552,151,0.5344906349931475
2000,1201,24,9,2069,674,0.7272727272727273,1395,0.7542836310608823
2000,1202,11,18,829,1157,0.3793103448275862,-328,0.4174219536757301
2000,1203,15,15,1263,1154,0.5,109,0.522548613984278
2000,1204,15,12,1236,824,0.5555555555555556,412,0.6
2000,1206,19,11,1392,742,0.6333333333333333,650,0.6522961574507966
2000,1207,17,14,1238,877,0.5483870967741935,361,0.5853427895981087
2000,1208,10,20,810,1337,0.3333333333333333,-527,0.37727061015370283
2000,1209,17,12,1287,795,0.5862068965517241,492,0.6181556195965417
2000,1210,13,17,1048,1071,0.43333333333333335,-23,0.49457291175082585
2000,1211,24,8,1964,530,0.75,1434,0.7874899759422614
2000,1214,17,12,1397,768,0.5862068965517241,629,0.6452655889145497
2000,1216,10,19,819,1254,0.3448275862068966,-435,0.3950795947901592
2000,1217,11,15,782,926,0.4230769230769231,-144,0.45784543325526933
2000,1218,17,12,1345,865,0.5862068965517241,480,0.6085972850678733
2000,1219,8,17,561,1078,0.32,-517,0.3422818791946309
2000,1220,24,6,1847,394,0.8,1453,0.824185631414547
2000,1221,10,18,683,994,0.35714285714285715,-311,0.40727489564698865
2000,1222,8,22,673,1609,0.26666666666666666,-936,0.29491673970201576
2000,1224,1,27,69,1757,0.03571428571428571,-1688,0.03778751369112815
2000,1225,10,17,787,1037,0.37037037037037035,-250,0.43146929824561403
2000,1226,6,19,459,1278,0.24,-819,0.26424870466321243
2000,1227,10,20,719,1239,0.3333333333333333,-520,0.3672114402451481
2000,1228,21,9,1678,602,0.7,1076,0.7359649122807017
2000,1229,9,20,687,1252,0.3103448275862069,-565,0.3543063434760186
2000,1231,20,8,1656,539,0.7142857142857143,1117,0.7544419134396355
2000,1232,22,9,1536,539,0.7096774193548387,997,0.7402409638554217
2000,1233,20,10,1615,769,0.6666666666666666,846,0.6774328859060402
2000,1234,14,16,1058,1006,0.4666666666666667,52,0.5125968992248062
2000,1235,26,4,2045,269,0.8666666666666667,1776,0.8837510803802938
2000,1237,7,21,468,1245,0.25,-777,0.2732049036777583
2000,1238,16,15,1153,931,0.5161290322580645,222,0.5532629558541267
2000,1239,7,19,590,1232,0.2692307692307692,-642,0.3238199780461032
2000,1240,16,11,1175,702,0.5925925925925926,473,0.6259989344698987
2000,1241,20,9,1492,517,0.6896551724137931,975,0.7426580388252862
2000,1242,22,9,1890,545,0.7096774193548387,1345,0.7761806981519507
2000,1243,9,19,675,1232,0.32142857142857145,-557,0.35395909805977976
2000,1245,19,7,1464,469,0.7307692307692307,995,0.7573719606828764
2000,1246,21,9,1493,590,0.7,903,0.7167546807489198
2000,1247,11,17,797,1048,0.39285714285714285,-251,0.43197831978319784
2000,1248,22,6,1661,414,0.7857142857142857,1247,0.8004819277108434
2000,1249,15,15,1028,866,0.5,162,0.542766631467793
2000,1250,6,21,437,1259,0.2222222222222222,-822,0.25766509433962265
2000,1251,10,14,706,901,0.4166666666666667,-195,0.4393279402613566
2000,1253,22,5,1798,359,0.8148148148148148,1439,0.8335651367640241
2000,1254,7,19,503,1138,0.2692307692307692,-635,0.3065204143814747
2000,1256,21,8,1604,507,0.7241379310344828,1097,0.7598294647086689
2000,1257,18,11,1440,655,0.6206896551724138,785,0.6873508353221957
2000,1259,7,21,517,1316,0.25,-799,0.28205128205128205
2000,1260,14,14,1006,847,0.5,159,0.5429033998920669
2000,1261,26,5,2083,311,0.8387096774193549,1772,0.8700918964076859
2000,1263,23,7,1820,465,0.7666666666666667,1355,0.7964989059080962
2000,1264,12,15,994,1086,0.4444444444444444,-92,0.4778846153846154
2000,1265,14,14,1045,918,0.5,127,0.5323484462557311
2000,1266,15,13,993,764,0.5357142857142857,229,0.5651678998292544
2000,1267,19,9,1630,623,0.6785714285714286,1007,0.723479804704838
2000,1268,24,9,1925,614,0.7272727272727273,1311,0.7581725088617566
2000,1269,16,15,1186,911,0.5161290322580645,275,0.5655698617072008
2000,1270,6,21,440,1331,0.2222222222222222,-891,0.2484472049689441
2000,1271,12,17,831,1088,0.41379310344827586,-257,0.43303804064616985
2000,1272,14,16,1113,1074,0.4666666666666667,39,0.5089163237311386
2000,1273,10,21,736,1347,0.3225806451612903,-611,0.35333653384541525
2000,1274,21,10,1507,618,0.6774193548387096,889,0.7091764705882353
2000,1275,15,15,1025,895,0.5,130,0.5338541666666666
2000,1276,15,13,1245,880,0.5357142857142857,365,0.5858823529411765
2000,1277,26,7,1997,462,0.7878787878787878,1535,0.8121187474583164
2000,1278,12,16,917,1048,0.42857142857142855,-131,0.4666666666666667
2000,1279,16,13,1233,847,0.5517241379310345,386,0.5927884615384615
2000,1280,14,16,1134,1034,0.4666666666666667,100,0.5230627306273062
2000,1281,18,12,1442,790,0.6,652,0.6460573476702509
2000,1282,14,13,1036,905,0.5185185185185185,131,0.5337454920144256
2000,1283,22,10,1516,616,0.6875,900,0.7110694183864915
2000,1284,12,16,721,903,0.42857142857142855,-182,0.44396551724137934
2000,1285,15,11,1134,745,0.5769230769230769,389,0.6035125066524747
2000,1286,7,16,572,1117,0.30434782608695654,-545,0.33866193013617524
2000,1287,6,18,482,1293,0.25,-811,0.27154929577464787
2000,1288,5,24,376,1508,0.1724137931034483,-1132,0.19957537154989385
2000,1290,7,21,623,1350,0.25,-727,0.3157627977698936
2000,1291,9,20,649,1234,0.3103448275862069,-585,0.34466277217206587
2000,1292,13,13,1105,882,0.5,223,0.5561147458480121
2000,1293,22,9,1801,651,0.7096774193548387,1150,0.7345024469820555
2000,1296,12,15,912,940,0.4444444444444444,-28,0.4924406047516199
2000,1298,21,6,1646,384,0.7777777777777778,1262,0.8108374384236453
2000,1299,14,14,1149,968,0.5,181,0.5427491733585262
2000,1301,17,12,1225,790,0.5862068965517241,435,0.607940446650124
2000,1304,11,19,825,1225,0.36666666666666664,-400,0.4024390243902439
2000,1305,8,20,577,1229,0.2857142857142857,-652,0.3194905869324474
2000,1306,3,25,228,1583,0.10714285714285714,-1355,0.12589729431253452
2000,1307,16,13,1233,876,0.5517241379310345,357,0.5846372688477952
2000,1308,21,9,1532,559,0.7,973,0.7326637972262076
2000,1309,11,18,734,1004,0.3793103448275862,-270,0.4223245109321059
2000,1310,17,12,1353,888,0.5862068965517241,465,0.6037483266398929
2000,1311,9,17,586,1000,0.34615384615384615,-414,0.3694829760403531
2000,1313,12,16,947,1181,0.42857142857142855,-234,0.4450187969924812
2000,1314,18,13,1438,941,0.5806451612903226,497,0.6044556536359815
2000,1317,7,20,600,1440,0.25925925925925924,-840,0.29411764705882354
2000,1318,7,21,552,1303,0.25,-751,0.29757412398921834
2000,1319,18,10,1419,615,0.6428571428571429,804,0.6976401179941003
2000,1320,14,15,934,864,0.4827586206896552,70,0.5194660734149055
2000,1321,5,25,317,1228,0.16666666666666666,-911,0.2051779935275081
2000,1322,15,13,1033,813,0.5357142857142857,220,0.5595882990249187
2000,1323,18,14,1404,883,0.5625,521,0.6139046786182772
2000,1324,12,17,979,1102,0.41379310344827586,-123,0.470446900528592
2000,1325,20,13,1517,869,0.6060606060606061,648,0.6357921207041073
2000,1326,22,6,1630,403,0.7857142857142857,1227,0.8017707820954255
2000,1328,26,6,2028,382,0.8125,1646,0.84149377593361
2000,1329,23,6,1851,350,0.7931034482758621,1501,0.8409813721035893
2000,1330,11,19,770,1172,0.36666666666666664,-402,0.3964984552008239
2000,1331,12,17,929,1147,0.41379310344827586,-218,0.447495183044316
2000,1332,21,7,1634,470,0.75,1164,0.776615969581749
2000,1333,11,16,798,1045,0.4074074074074074,-247,0.4329896907216495
2000,1334,10,18,696,1046,0.35714285714285715,-350,0.399540757749713
2000,1335,21,7,1468,416,0.75,1052,0.7791932059447984
2000,1336,15,15,1128,1077,0.5,51,0.5115646258503401
2000,1337,24,8,1818,519,0.75,1299,0.7779204107830552
2000,1338,13,15,966,898,0.4642857142857143,68,0.5182403433476395
2000,1339,7,18,477,1069,0.28,-592,0.30853816300129366
2000,1340,12,14,929,989,0.46153846153846156,-60,0.48435870698644423
2000,1341,6,21,495,1513,0.2222222222222222,-1018,0.24651394422310757
2000,1343,18,10,1172,547,0.6428571428571429,625,0.6817917393833625
2000,1344,10,19,683,1122,0.3448275862068966,-439,0.378393351800554
2000,1345,20,9,1586,560,0.6896551724137931,1026,0.739049394221808
2000,1346,17,10,1315,662,0.6296296296296297,653,0.6651492159838138
2000,1347,17,10,1283,678,0.6296296296296297,605,0.6542580316165222
2000,1348,5,25,358,1511,0.16666666666666666,-1153,0.19154628143392188
2000,1349,3,22,184,1254,0.12,-1070,0.12795549374130738
2000,1350,18,12,1239,772,0.6,467,0.6161113873694679
2000,1351,16,14,1196,920,0.5333333333333333,276,0.5652173913043478
2000,1352,17,12,1287,740,0.5862068965517241,547,0.6349284657128762
2000,1353,15,15,1153,960,0.5,193,0.5456696639848556
2000,1354,20,13,1506,815,0.6060606060606061,691,0.6488582507539854
2000,1356,19,12,1398,797,0.6129032258064516,601,0.6369020501138952
2000,1357,3,25,240,1614,0.10714285714285714,-1374,0.12944983818770225
2000,1358,20,7,1466,458,0.7407407407407407,1008,0.761954261954262
2000,1359,20,9,1521,571,0.6896551724137931,950,0.7270554493307839
2000,1360,19,9,1389,567,0.6785714285714286,822,0.7101226993865031
2000,1361,4,23,276,1396,0.14814814814814814,-1120,0.16507177033492823
2000,1362,18,9,1325,591,0.6666666666666666,734,0.691544885177453
2000,1363,11,15,656,864,0.4230769230769231,-208,0.43157894736842106
2000,1364,12,14,867,857,0.46153846153846156,10,0.5029002320185615
2000,1365,18,12,1248,732,0.6,516,0.6303030303030303
2000,1368,8,17,558,910,0.32,-352,0.3801089918256131
2000,1369,22,6,1606,341,0.7857142857142857,1265,0.8248587570621468
2000,1371,20,9,1524,566,0.6896551724137931,958,0.7291866028708134
2000,1372,4,21,254,1405,0.16,-1151,0.15310427968655818
2000,1373,23,8,2076,617,0.7419354838709677,1459,0.7708874860750092
2000,1374,20,8,1588,556,0.7142857142857143,1032,0.7406716417910447
2000,1375,20,10,1427,656,0.6666666666666666,771,0.6850696111377821
2000,1376,15,17,1125,1065,0.46875,60,0.5136986301369864
2000,1378,17,13,1400,935,0.5666666666666667,465,0.5995717344753747
2000,1379,17,12,1209,712,0.5862068965517241,497,0.629359708485164
2000,1380,16,11,1248,762,0.5925925925925926,486,0.6208955223880597
2000,1381,14,13,1138,806,0.5185185185185185,332,0.5853909465020576
2000,1382,21,9,1516,540,0.7,976,0.7373540856031129
2000,1383,17,12,1361,869,0.5862068965517241,492,0.6103139013452915
2000,1384,10,18,750,1055,0.35714285714285715,-305,0.4155124653739612
2000,1385,24,7,1850,446,0.7741935483870968,1404,0.8057491289198606
2000,1386,13,16,1009,1034,0.4482758620689655,-25,0.49388154674498286
2000,1387,19,13,1364,715,0.59375,649,0.656084656084656
2000,1388,7,20,527,1108,0.25925925925925924,-581,0.3223241590214067
2000,1389,5,23,408,1550,0.17857142857142858,-1142,0.2083758937691522
2000,1390,25,3,1999,239,0.8928571428571429,1760,0.8932082216264522
2000,1391,12,15,897,937,0.4444444444444444,-40,0.48909487459105777
2000,1392,5,21,293,1157,0.19230769230769232,-864,0.20206896551724138
2000,1393,24,5,1874,337,0.8275862068965517,1537,0.8475802804161013
2000,1395,17,14,1626,1086,0.5483870967741935,540,0.5995575221238938
2000,1396,26,5,1832,290,0.8387096774193549,1542,0.8633364750235627
2000,1397,23,6,1906,424,0.7931034482758621,1482,0.8180257510729614
2000,1398,7,22,515,1449,0.2413793103448276,-934,0.26221995926680247
2000,1399,14,12,1192,848,0.5384615384615384,344,0.5843137254901961
2000,1400,23,8,1784,532,0.7419354838709677,1252,0.770293609671848
2000,1401,8,20,580,1245,0.2857142857142857,-665,0.3178082191780822
2000,1402,10,17,737,1073,0.37037037037037035,-336,0.40718232044198893
2000,1403,11,16,846,1027,0.4074074074074074,-181,0.45168179391350777
2000,1404,8,19,600,1238,0.2962962962962963,-638,0.3264417845484222
2000,1405,18,13,1333,864,0.5806451612903226,469,0.6067364588074647
2000,1406,11,17,733,1168,0.39285714285714285,-435,0.3855865334034719
2000,1407,16,11,1239,767,0.5925925925925926,472,0.6176470588235294
2000,1408,20,10,1436,606,0.6666666666666666,830,0.703232125367287
2000,1409,29,4,2405,276,0.8787878787878788,2129,0.897053338306602
2000,1410,9,14,638,1017,0.391304347826087,-379,0.38549848942598186
2000,1411,12,13,920,872,0.48,48,0.5133928571428571
2000,1412,14,14,1173,880,0.5,293,0.5713589868485144
2000,1414,12,14,870,832,0.46153846153846156,38,0.5111633372502937
2000,1416,13,18,1031,1153,0.41935483870967744,-122,0.47206959706959706
2000,1417,19,11,1550,716,0.6333333333333333,834,0.6840247131509267
2000,1418,24,8,1840,456,0.75,1384,0.8013937282229965
2000,1419,17,9,1361,653,0.6538461538461539,708,0.6757696127110229
2000,1420,10,18,715,1069,0.35714285714285715,-354,0.4007847533632287
2000,1421,10,19,769,1229,0.3448275862068966,-460,0.38488488488488487
2000,1422,14,13,1079,840,0.5185185185185185,239,0.5622720166753518
2000,1423,18,12,1179,637,0.6,542,0.6492290748898678
2000,1424,23,7,1960,526,0.7666666666666667,1434,0.7884151246983105
2000,1425,16,14,1378,964,0.5333333333333333,414,0.5883859948761742
2000,1426,13,12,1055,881,0.52,174,0.5449380165289256
2000,1427,12,12,940,863,0.5,77,0.5213533000554631
2000,1428,20,8,1532,470,0.7142857142857143,1062,0.7652347652347652
2000,1429,24,5,1709,298,0.8275862068965517,1411,0.8515196811160937
2000,1431,13,15,1126,1032,0.4642857142857143,94,0.5217794253938832
2000,1433,14,14,1057,900,0.5,157,0.540112416964742
2000,1434,16,12,1166,667,0.5714285714285714,499,0.6361156573922532
2000,1435,19,10,1517,658,0.6551724137931034,859,0.6974712643678161
2000,1436,16,12,1269,736,0.5714285714285714,533,0.6329177057356609
2000,1437,19,12,1401,768,0.6129032258064516,633,0.6459197786998617
2000,1438,19,11,1641,774,0.6333333333333333,867,0.6795031055900621
2000,1439,16,15,1144,853,0.5161290322580645,291,0.5728592889334001
2000,1440,2,23,134,1556,0.08,-1422,0.07928994082840236
2000,1441,11,14,906,974,0.44,-68,0.4819148936170213
2000,1442,6,22,414,1362,0.21428571428571427,-948,0.23310810810810811
2000,1443,11,18,869,1126,0.3793103448275862,-257,0.4355889724310777
2000,1444,10,18,797,1247,0.35714285714285715,-450,0.38992172211350296
2000,1447,10,16,887,1115,0.38461538461538464,-228,0.44305694305694304
2000,1448,17,14,1267,881,0.5483870967741935,386,0.589851024208566
2000,1449,9,20,606,1289,0.3103448275862069,-683,0.31978891820580474
2000,1450,6,22,441,1337,0.21428571428571427,-896,0.24803149606299213
2000,1451,15,10,1261,641,0.6,620,0.6629863301787592
2000,1452,14,14,1055,919,0.5,136,0.5344478216818642
2000,1453,14,16,897,802,0.4666666666666667,95,0.5279576221306651
2000,1454,14,14,1059,905,0.5,154,0.5392057026476579
2000,1455,11,17,805,1049,0.39285714285714285,-244,0.4341963322545847
2000,1456,10,17,754,1076,0.37037037037037035,-322,0.41202185792349727
2000,1457,18,8,1381,492,0.6923076923076923,889,0.7373198077949813
2000,1458,18,13,1170,689,0.5806451612903226,481,0.6293706293706294
2000,1459,12,16,916,1001,0.42857142857142855,-85,0.477829942618675
2000,1460,11,17,780,937,0.39285714285714285,-157,0.45428072218986604
2000,1461,18,12,1549,908,0.6,641,0.6304436304436305
2000,1462,20,11,1655,695,0.6451612903225806,960,0.7042553191489361
2000,1463,7,20,436,1149,0.25925925925925924,-713,0.2750788643533123
2000,1464,11,16,721,1063,0.4074074074074074,-342,0.40414798206278024
2000,3102,3,24,230,1350,0.1111111111111111,-1120,0.14556962025316456
2000,3103,11,18,825,1092,0.3793103448275862,-267,0.4303599374021909
2000,3104,15,13,1131,767,0.5357142857142857,364,0.5958904109589042
2000,3105,7,21,536,1187,0.25,-651,0.3110853163087638
2000,3106,11,13,824,722,0.4583333333333333,102,0.5329883570504528
2000,3107,8,15,544,860,0.34782608695652173,-316,0.38746438746438744
2000,3108,21,8,1559,456,0.7241379310344828,1103,0.773697270471464
2000,3110,12,16,861,981,0.42857142857142855,-120,0.46742671009771986
2000,3111,13,15,958,1006,0.4642857142857143,-48,0.48778004073319753
2000,3112,24,6,1915,436,0.8,1479,0.8145470012760527
2000,3113,14,14,1031,847,0.5,184,0.5489882854100107
2000,3114,5,23,375,1369,0.17857142857142858,-994,0.21502293577981652
2000,3115,3,17,198,1005,0.15,-807,0.16458852867830423
2000,3116,14,14,1117,929,0.5,188,0.5459433040078201
2000,3117,18,11,1411,724,0.6206896551724138,687,0.6608899297423888
2000,3119,8,18,564,1088,0.3076923076923077,-524,0.3414043583535109
2000,3120,21,7,1642,425,0.75,1217,0.7943880019351718
2000,3122,14,15,1113,1012,0.4827586206896552,101,0.5237647058823529
2000,3123,17,12,1315,811,0.5862068965517241,504,0.6185324553151458
2000,3124,7,20,522,1182,0.25925925925925924,-660,0.30633802816901406
2000,3125,16,7,1224,434,0.6956521739130435,790,0.738238841978287
2000,3126,13,14,961,851,0.48148148148148145,110,0.5303532008830022
2000,3129,15,14,1052,847,0.5172413793103449,205,0.5539757767245919
2000,3130,25,8,1861,480,0.7575757575757576,1381,0.7949594190516873
2000,3131,8,22,591,1145,0.26666666666666666,-554,0.34043778801843316
2000,3132,12,17,987,1145,0.41379310344827586,-158,0.4629455909943715
2000,3133,7,20,487,1138,0.25925925925925924,-651,0.2996923076923077
2000,3135,8,19,575,995,0.2962962962962963,-420,0.3662420382165605
2000,3137,15,14,1064,929,0.5172413793103449,135,0.5338685398896137
2000,3138,18,12,1248,720,0.6,528,0.6341463414634146
2000,3139,10,16,768,999,0.38461538461538464,-231,0.43463497453310695
2000,3140,21,8,1550,461,0.7241379310344828,1089,0.7707608155146694
2000,3141,9,19,638,1213,0.32142857142857145,-575,0.34467855213398163
2000,3142,9,18,693,1177,0.3333333333333333,-484,0.37058823529411766
2000,3143,11,17,738,1001,0.39285714285714285,-263,0.4243818286371478
2000,3144,19,8,1420,520,0.7037037037037037,900,0.7319587628865979
2000,3145,10,20,768,1299,0.3333333333333333,-531,0.37155297532656023
2000,3148,8,19,548,999,0.2962962962962963,-451,0.35423400129282484
2000,3149,5,19,326,1056,0.20833333333333334,-730,0.23589001447178004
2000,3150,11,20,773,1222,0.3548387096774194,-449,0.387468671679198
2000,3151,24,4,1811,253,0.8571428571428571,1558,0.877422480620155
2000,3152,1,26,74,1311,0.037037037037037035,-1237,0.053429602888086646
2000,3153,17,12,1190,725,0.5862068965517241,465,0.6214099216710183
2000,3155,18,11,1193,642,0.6206896551724138,551,0.6501362397820164
2000,3156,14,14,1117,922,0.5,195,0.5478175576262874
2000,3157,17,10,1121,510,0.6296296296296297,611,0.6873083997547517
2000,3158,2,23,129,1176,0.08,-1047,0.09885057471264368
2000,3159,13,15,875,910,0.4642857142857143,-35,0.49019607843137253
2000,3160,10,19,753,1198,0.3448275862068966,-445,0.3859559200410046
2000,3161,20,9,1528,564,0.6896551724137931,964,0.7304015296367112
2000,3162,7,18,468,1007,0.28,-539,0.31728813559322033
2000,3163,30,1,2566,71,0.967741935483871,2495,0.9730754645430413
2000,3164,12,15,859,957,0.4444444444444444,-98,0.47301762114537443
2000,3165,11,14,811,781,0.44,30,0.5094221105527639
2000,3166,12,15,809,882,0.4444444444444444,-73,0.47841513897102306
2000,3168,2,26,156,1500,0.07142857142857142,-1344,0.09420289855072464
2000,3169,16,10,1127,555,0.6153846153846154,572,0.6700356718192628
2000,3170,5,20,325,1092,0.2,-767,0.22935779816513763
2000,3171,19,7,1491,434,0.7307692307692307,1057,0.7745454545454545
2000,3172,10,17,744,1035,0.37037037037037035,-291,0.418212478920742
2000,3173,15,14,1175,873,0.5172413793103449,302,0.57373046875
2000,3174,21,8,1608,505,0.7241379310344828,1103,0.7610033128253668
2000,3175,11,16,773,1001,0.4074074074074074,-228,0.43573844419391206
2000,3176,16,11,1044,635,0.5925925925925926,409,0.6217986896962477
2000,3177,17,11,1279,666,0.6071428571428571,613,0.6575835475578407
2000,3178,18,8,1392,506,0.6923076923076923,886,0.7334035827186512
2000,3179,24,6,1874,364,0.8,1510,0.837354781054513
2000,3180,10,20,668,1081,0.3333333333333333,-413,0.3819325328759291
2000,3181,26,5,1987,320,0.8387096774193549,1667,0.8612917208495882
2000,3182,8,20,547,1089,0.2857142857142857,-542,0.3343520782396088
2000,3183,7,19,519,1104,0.2692307692307692,-585,0.3197781885397412
2000,3184,13,15,1121,1061,0.4642857142857143,60,0.5137488542621448
2000,3185,16,14,1255,886,0.5333333333333333,369,0.5861746847267632
2000,3186,10,16,691,865,0.38461538461538464,-174,0.4440874035989717
2000,3187,16,14,1201,851,0.5333333333333333,350,0.5852826510721247
2000,3189,12,15,833,836,0.4444444444444444,-3,0.49910125823846613
2000,3190,15,13,1220,789,0.5357142857142857,431,0.6072672971627675
2000,3191,23,6,1736,390,0.7931034482758621,1346,0.8165569143932268
2000,3192,11,17,736,1014,0.39285714285714285,-278,0.4205714285714286
2000,3193,24,7,1795,416,0.7741935483870968,1379,0.8118498417005879
2000,3194,13,14,1025,911,0.48148148148148145,114,0.5294421487603306
2000,3196,17,12,1443,798,0.5862068965517241,645,0.643908969210174
2000,3197,12,16,833,912,0.42857142857142855,-79,0.4773638968481375
2000,3198,16,13,1178,776,0.5517241379310345,402,0.6028659160696008
2000,3199,12,17,942,1078,0.41379310344827586,-136,0.46633663366336636
2000,3200,4,24,298,1272,0.14285714285714285,-974,0.18980891719745224
2000,3201,11,18,770,1053,0.3793103448275862,-283,0.4223806911684037
2000,3202,20,10,1560,586,0.6666666666666666,974,0.7269338303821062
2000,3203,25,5,1949,294,0.8333333333333334,1655,0.8689255461435578
2000,3204,9,18,720,1191,0.3333333333333333,-471,0.37676609105180536
2000,3206,11,19,829,1162,0.36666666666666664,-333,0.41637368156705173
2000,3207,17,12,1198,669,0.5862068965517241,529,0.6416711301553294
2000,3208,29,3,2329,200,0.90625,2129,0.9209173586397785
2000,3209,20,6,1499,374,0.7692307692307693,1125,0.800320341697811
2000,3210,15,13,1159,783,0.5357142857142857,376,0.5968074150360453
2000,3211,9,19,617,1205,0.32142857142857145,-588,0.3386388583973655
2000,3212,24,5,2181,368,0.8275862068965517,1813,0.8556296586896822
2000,3214,15,14,1223,919,0.5172413793103449,304,0.5709617180205415
2000,3216,14,14,861,849,0.5,12,0.5035087719298246
2000,3217,16,9,1149,561,0.64,588,0.6719298245614035
2000,3218,20,8,1437,470,0.7142857142857143,967,0.7535395909805978
2000,3219,5,20,346,1061,0.2,-715,0.2459132906894101
2000,3220,11,16,734,878,0.4074074074074074,-144,0.45533498759305213
2000,3221,23,6,1814,329,0.7931034482758621,1485,0.8464769015398973
2000,3222,7,22,498,1317,0.2413793103448276,-819,0.2743801652892562
2000,3224,18,10,1340,608,0.6428571428571429,732,0.6878850102669405
2000,3225,13,15,930,942,0.4642857142857143,-12,0.4967948717948718
2000,3226,14,15,961,774,0.4827586206896552,187,0.5538904899135446
2000,3227,14,15,940,870,0.4827586206896552,70,0.5193370165745856
2000,3228,22,10,1761,690,0.6875,1071,0.7184822521419829
2000,3229,6,20,390,1035,0.23076923076923078,-645,0.2736842105263158
2000,3231,10,17,740,1023,0.37037037037037035,-283,0.41973908111174135
2000,3232,9,19,643,1120,0.32142857142857145,-477,0.3647192285876347
2000,3233,8,20,605,1221,0.2857142857142857,-616,0.3313253012048193
2000,3234,9,18,694,1122,0.3333333333333333,-428,0.38215859030837
2000,3235,25,5,2051,351,0.8333333333333334,1700,0.8538717735220649
2000,3237,11,17,787,1013,0.39285714285714285,-226,0.43722222222222223
2000,3238,5,19,352,1088,0.20833333333333334,-736,0.24444444444444444
2000,3240,6,19,448,1166,0.24,-718,0.27757125154894674
2000,3241,20,10,1521,675,0.6666666666666666,846,0.6926229508196722
2000,3242,20,9,1466,578,0.6896551724137931,888,0.7172211350293543
2000,3243,13,17,922,999,0.43333333333333335,-77,0.4799583550234253
2000,3245,26,5,2116,363,0.8387096774193549,1753,0.8535699878983461
2000,3246,15,14,1111,809,0.5172413793103449,302,0.5786458333333333
2000,3247,12,17,835,1009,0.41379310344827586,-174,0.45281995661605207
2000,3248,7,22,497,1268,0.2413793103448276,-771,0.28158640226628895
2000,3249,10,17,686,887,0.37037037037037035,-201,0.4361093452002543
2000,3250,13,16,1023,1032,0.4482758620689655,-9,0.4978102189781022
2000,3251,22,7,1610,397,0.7586206896551724,1213,0.802192326856004
2000,3253,21,10,1578,599,0.6774193548387096,979,0.7248507119889757
2000,3254,13,16,934,1019,0.4482758620689655,-85,0.4782386072708653
2000,3256,28,2,2513,135,0.9333333333333333,2378,0.9490181268882175
2000,3257,14,13,1008,778,0.5185185185185185,230,0.5643896976483762
2000,3258,13,15,977,909,0.4642857142857143,68,0.5180275715800636
2000,3259,12,17,780,978,0.41379310344827586,-198,0.44368600682593856
2000,3260,3,23,203,1528,0.11538461538461539,-1325,0.1172732524552282
2000,3261,22,6,1601,333,0.7857142857142857,1268,0.827817993795243
2000,3263,20,10,1360,583,0.6666666666666666,777,0.6999485331960885
2000,3264,17,12,1219,689,0.5862068965517241,530,0.6388888888888888
2000,3265,12,17,761,885,0.41379310344827586,-124,0.4623329283110571
2000,3266,22,6,1574,382,0.7857142857142857,1192,0.8047034764826176
2000,3267,7,20,489,1192,0.25925925925925924,-703,0.2908982748364069
2000,3268,14,15,1050,899,0.4827586206896552,151,0.538737814263725
2000,3269,14,15,890,800,0.4827586206896552,90,0.5266272189349113
2000,3270,13,14,890,780,0.48148148148148145,110,0.5329341317365269
2000,3271,9,19,640,1108,0.32142857142857145,-468,0.36613272311212813
2000,3272,16,12,1204,769,0.5714285714285714,435,0.6102382159148505
2000,3273,11,12,652,637,0.4782608695652174,15,0.5058184639255237
2000,3274,14,15,1043,838,0.4827586206896552,205,0.5544922913343966
2000,3275,15,13,1154,758,0.5357142857142857,396,0.6035564853556485
2000,3276,22,7,1657,451,0.7586206896551724,1206,0.7860531309297912
2000,3277,17,11,1363,686,0.6071428571428571,677,0.6652025378233285
2000,3278,10,17,675,873,0.37037037037037035,-198,0.436046511627907
2000,3279,12,16,901,916,0.42857142857142855,-15,0.49587231700605394
2000,3280,23,7,1882,455,0.7666666666666667,1427,0.80530594779632
2000,3281,17,11,1328,731,0.6071428571428571,597,0.6449732880038854
2000,3282,7,19,502,1131,0.2692307692307692,-629,0.30740967544396813
2000,3283,23,9,1682,598,0.71875,1084,0.737719298245614
2000,3284,15,13,1137,863,0.5357142857142857,274,0.5685
2000,3285,21,7,1420,361,0.75,1059,0.7973048848961257
2000,3286,3,21,217,1195,0.125,-978,0.1536827195467422
2000,3287,1,25,82,1654,0.038461538461538464,-1572,0.04723502304147465
2000,3288,17,12,1375,786,0.5862068965517241,589,0.6362795002313744
2000,3290,7,20,511,1165,0.25925925925925924,-654,0.3048926014319809
2000,3291,19,9,1427,531,0.6785714285714286,896,0.7288049029622063
2000,3292,16,11,1246,664,0.5925925925925926,582,0.6523560209424084
2000,3293,14,15,996,904,0.4827586206896552,92,0.5242105263157895
2000,3296,6,23,393,1295,0.20689655172413793,-902,0.23281990521327015
2000,3298,5,22,304,1222,0.18518518518518517,-918,0.19921363040629095
2000,3299,3,25,192,1416,0.10714285714285714,-1224,0.11940298507462686
2000,3301,20,8,1488,498,0.7142857142857143,990,0.7492447129909365
2000,3304,18,12,1434,823,0.6,611,0.6353566681435534
2000,3305,20,10,1509,609,0.6666666666666666,900,0.7124645892351275
2000,3306,13,15,880,841,0.4642857142857143,39,0.5113306217315514
2000,3307,18,10,1302,531,0.6428571428571429,771,0.7103109656301145
2000,3308,8,17,522,897,0.32,-375,0.3678646934460888
2000,3309,11,17,901,1032,0.39285714285714285,-131,0.4661148473874806
2000,3310,14,14,1117,962,0.5,155,0.5372775372775372
2000,3311,4,22,290,1237,0.15384615384615385,-947,0.1899148657498363
2000,3313,19,10,1377,646,0.6551724137931034,731,0.680672268907563
2000,3314,18,12,1352,792,0.6,560,0.6305970149253731
2000,3317,17,11,1249,675,0.6071428571428571,574,0.6491683991683992
2000,3318,17,13,1087,751,0.5666666666666667,336,0.5914036996735582
2000,3319,10,18,663,940,0.35714285714285715,-277,0.4135995009357455
2000,3320,16,13,1137,744,0.5517241379310345,393,0.6044657097288676
2000,3321,7,21,428,1056,0.25,-628,0.2884097035040431
2000,3322,22,6,1598,364,0.7857142857142857,1234,0.8144750254841998
2000,3323,25,4,1960,259,0.8620689655172413,1701,0.8832807570977917
2000,3324,16,12,1234,819,0.5714285714285714,415,0.6010716025328787
2000,3325,11,16,874,1068,0.4074074074074074,-194,0.45005149330587024
2000,3326,12,15,840,809,0.4444444444444444,31,0.509399636143117
2000,3328,23,7,1899,466,0.7666666666666667,1433,0.8029598308668076
2000,3329,14,16,1049,1043,0.4666666666666667,6,0.501434034416826
2000,3330,27,5,2246,304,0.84375,1942,0.8807843137254902
2000,3331,10,16,680,890,0.38461538461538464,-210,0.43312101910828027
2000,3332,23,7,1664,454,0.7666666666666667,1210,0.785646836638338
2000,3333,14,16,905,928,0.4666666666666667,-23,0.49372613202400434
2000,3334,19,11,1345,691,0.6333333333333333,654,0.6606090373280943
2000,3335,17,10,1356,700,0.6296296296296297,656,0.6595330739299611
2000,3336,26,4,2037,249,0.8666666666666667,1788,0.8910761154855643
2000,3337,20,9,1490,542,0.6896551724137931,948,0.7332677165354331
2000,3338,15,12,1075,690,0.5555555555555556,385,0.6090651558073654
2000,3339,11,19,760,1087,0.36666666666666664,-327,0.41147807255008123
2000,3340,9,17,616,843,0.34615384615384615,-227,0.42220699108978754
2000,3341,9,17,597,972,0.34615384615384615,-375,0.38049713193116635
2000,3343,9,19,563,1062,0.32142857142857145,-499,0.3464615384615385
2000,3344,10,15,756,902,0.4,-146,0.4559710494571773
2000,3345,22,7,1545,427,0.7586206896551724,1118,0.7834685598377282
2000,3346,9,18,598,1074,0.3333333333333333,-476,0.3576555023923445
2000,3347,10,17,641,903,0.37037037037037035,-262,0.41515544041450775
2000,3348,2,25,117,1248,0.07407407407407407,-1131,0.08571428571428572
2000,3349,21,9,1530,521,0.7,1009,0.7459775719161384
2000,3350,13,16,1173,1128,0.4482758620689655,45,0.5097783572359843
2000,3351,14,14,1073,946,0.5,127,0.5314512134720158
2000,3352,11,15,736,959,0.4230769230769231,-223,0.4342182890855457
2000,3353,22,7,1450,406,0.7586206896551724,1044,0.78125
2000,3354,6,22,433,1372,0.21428571428571427,-939,0.23988919667590028
2000,3356,8,20,490,1034,0.2857142857142857,-544,0.3215223097112861
2000,3357,13,14,917,790,0.48148148148148145,127,0.5371997656707674
2000,3358,12,14,808,848,0.46153846153846156,-40,0.48792270531400966
2000,3359,16,10,1200,621,0.6153846153846154,579,0.6589785831960461
2000,3360,17,12,1152,633,0.5862068965517241,519,0.6453781512605042
2000,3361,9,19,554,1047,0.32142857142857145,-493,0.34603372891942535
2000,3362,11,16,766,939,0.4074074074074074,-173,0.449266862170088
2000,3363,2,24,135,1278,0.07692307692307693,-1143,0.09554140127388536
2000,3364,30,4,2479,272,0.8823529411764706,2207,0.9011268629589241
2000,3365,20,8,1514,502,0.7142857142857143,1012,0.7509920634920635
2000,3368,9,18,582,1021,0.3333333333333333,-439,0.363069245165315
2000,3369,11,17,886,1076,0.39285714285714285,-190,0.45158002038735984
2000,3371,10,16,672,844,0.38461538461538464,-172,0.44327176781002636
2000,3372,27,3,2166,148,0.9,2018,0.9360414866032843
2000,3373,11,18,878,1195,0.3793103448275862,-317,0.42354076218041486
2000,3374,21,8,1603,492,0.7241379310344828,1111,0.7651551312649165
2000,3375,8,21,582,1129,0.27586206896551724,-547,0.34015195791934544
2000,3376,13,15,969,934,0.4642857142857143,35,0.509196006305833
2000,3378,12,15,908,942,0.4444444444444444,-34,0.4908108108108108
2000,3379,17,12,1227,772,0.5862068965517241,455,0.6138069034517258
2000,3380,10,15,707,1011,0.4,-304,0.41152502910360883
2000,3381,10,15,693,938,0.4,-245,0.4248927038626609
2000,3382,11,19,807,1054,0.36666666666666664,-247,0.4336378291241268
2000,3383,2,25,146,1287,0.07407407407407407,-1141,0.10188415910676901
2000,3384,22,7,1713,453,0.7586206896551724,1260,0.7908587257617729
2000,3385,11,18,733,984,0.3793103448275862,-251,0.42690739662201516
2000,3386,24,5,1663,321,0.8275862068965517,1342,0.8382056451612904
2000,3387,12,17,870,961,0.41379310344827586,-91,0.4751501911523758
2000,3388,19,8,1319,475,0.7037037037037037,844,0.7352285395763657
2000,3389,23,7,1589,384,0.7666666666666667,1205,0.8053725291434364
2000,3390,20,8,1559,524,0.7142857142857143,1035,0.7484397503600576
2000,3391,9,15,619,890,0.375,-271,0.41020543406229293
2000,3392,18,10,1207,560,0.6428571428571429,647,0.6830786644029428
2000,3393,10,18,775,1054,0.35714285714285715,-279,0.423728813559322
2000,3394,13,12,991,696,0.52,295,0.5874333135743924
2000,3395,16,14,1284,872,0.5333333333333333,412,0.5955473098330241
2000,3396,10,19,648,1054,0.3448275862068966,-406,0.3807285546415981
2000,3397,28,3,2336,182,0.9032258064516129,2154,0.9277204130262113
2000,3398,8,18,607,1051,0.3076923076923077,-444,0.3661037394451146
2000,3399,24,8,1841,531,0.75,1310,0.7761382799325464
2000,3400,21,12,1663,820,0.6363636363636364,843,0.6697543294401933
2000,3401,11,16,860,954,0.4074074074074074,-94,0.474090407938258
2000,3402,15,11,1074,632,0.5769230769230769,442,0.6295427901524033
2000,3403,25,4,1822,212,0.8620689655172413,1610,0.895771878072763
2000,3404,11,16,834,1034,0.4074074074074074,-200,0.4464668094218415
2000,3405,14,14,1022,823,0.5,199,0.5539295392953929
2000,3406,9,19,596,1088,0.32142857142857145,-492,0.35391923990498814
2000,3407,7,17,572,1173,0.2916666666666667,-601,0.32779369627507166
2000,3408,26,4,2187,265,0.8666666666666667,1922,0.8919249592169658
2000,3409,14,15,951,868,0.4827586206896552,83,0.5228147333699835
2000,3410,4,20,237,1158,0.16666666666666666,-921,0.16989247311827957
2000,3411,10,17,754,980,0.37037037037037035,-226,0.4348327566320646
2000,3412,19,13,1350,860,0.59375,490,0.6108597285067874
2000,3414,12,16,876,1020,0.42857142857142855,-144,0.4620253164556962
2000,3416,9,18,630,993,0.3333333333333333,-363,0.38817005545286504
2000,3417,18,10,1463,623,0.6428571428571429,840,0.7013422818791947
2000,3418,12,16,905,924,0.42857142857142855,-19,0.49480590486604703
2000,3419,16,13,1053,728,0.5517241379310345,325,0.5912408759124088
2000,3420,7,20,492,1174,0.25925925925925924,-682,0.29531812725090034
2000,3421,9,16,557,807,0.36,-250,0.4083577712609971
2000,3422,19,11,1409,666,0.6333333333333333,743,0.6790361445783133
2000,3423,18,13,1227,795,0.5806451612903226,432,0.6068249258160238
2000,3424,16,12,1186,789,0.5714285714285714,397,0.6005063291139241
2000,3425,15,13,1098,774,0.5357142857142857,324,0.5865384615384616
2000,3426,13,14,817,692,0.48148148148148145,125,0.5414181577203446
2000,3427,5,18,326,936,0.21739130434782608,-610,0.2583201267828843
2000,3428,22,7,1506,361,0.7586206896551724,1145,0.8066416711301553
2000,3431,5,22,342,1144,0.18518518518518517,-802,0.23014804845222073
2000,3433,15,16,1148,979,0.4838709677419355,169,0.5397273154677951
2000,3434,18,13,1335,788,0.5806451612903226,547,0.628827131417805
2000,3435,20,12,1520,646,0.625,874,0.7017543859649122
2000,3436,25,5,1940,325,0.8333333333333334,1615,0.8565121412803532
2000,3437,15,14,989,721,0.5172413793103449,268,0.5783625730994152
2000,3438,23,8,1717,532,0.7419354838709677,1185,0.76345042240996
2000,3439,19,10,1333,583,0.6551724137931034,750,0.6957202505219207
2000,3441,11,17,780,1072,0.39285714285714285,-292,0.42116630669546434
2000,3442,17,11,1136,620,0.6071428571428571,516,0.6469248291571754
2000,3443,21,9,1640,594,0.7,1046,0.7341092211280215
2000,3444,18,12,1391,779,0.6,612,0.6410138248847926
2000,3447,16,14,1098,810,0.5333333333333333,288,0.5754716981132075
2000,3448,7,21,443,1163,0.25,-720,0.27584059775840597
2000,3449,8,22,600,1400,0.26666666666666666,-800,0.3
2000,3450,4,24,278,1466,0.14285714285714285,-1188,0.15940366972477063
2000,3451,13,15,912,806,0.4642857142857143,106,0.5308498253783469
2000,3452,6,22,464,1156,0.21428571428571427,-692,0.28641975308641976
2000,3453,21,8,1495,434,0.7241379310344828,1061,0.7750129600829445
2000,3454,16,12,1178,780,0.5714285714285714,398,0.6016343207354443
2000,3455,20,10,1472,613,0.6666666666666666,859,0.7059952038369305
2000,3456,6,22,411,1283,0.21428571428571427,-872,0.2426210153482881
2000,3457,6,16,397,820,0.2727272727272727,-423,0.32621199671322926
2000,3458,15,12,1129,765,0.5555555555555556,364,0.5960929250263991
2000,3459,7,18,498,1025,0.28,-527,0.32698621142481943
2000,3460,7,19,490,1041,0.2692307692307692,-551,0.3200522534291313
2000,3461,9,17,673,1100,0.34615384615384615,-427,0.3795826283135928
2000,3462,26,4,2046,283,0.8666666666666667,1763,0.8784886217260627
2000,3463,11,16,763,941,0.4074074074074074,-178,0.4477699530516432
2000,3464,22,8,1730,505,0.7333333333333333,1225,0.7740492170022372
2001,1102,8,21,488,1179,0.27586206896551724,-691,0.2927414517096581
2001,1103,12,16,906,995,0.42857142857142855,-89,0.4765912677538138
2001,1104,21,10,1713,665,0.6774193548387096,1048,0.7203532380151387
2001,1105,16,11,1220,743,0.5925925925925926,477,0.6214977075904228
2001,1106,20,7,1439,457,0.7407407407407407,982,0.7589662447257384
2001,1107,5,20,392,1301,0.2,-909,0.23154164205552275
2001,1108,15,15,1284,960,0.5,324,0.5721925133689839
2001,1110,7,20,456,1123,0.25925925925925924,-667,0.2887903736542115
2001,1111,9,19,680,1102,0.32142857142857145,-422,0.38159371492704824
2001,1112,22,7,1845,505,0.7586206896551724,1340,0.7851063829787234
2001,1113,13,16,1040,1081,0.4482758620689655,-41,0.49033474776049035
2001,1114,14,11,1047,667,0.56,380,0.6108518086347725
2001,1115,2,25,130,1532,0.07407407407407407,-1402,0.07821901323706378
2001,1116,20,10,1747,668,0.6666666666666666,1079,0.7233954451345755
2001,1117,15,13,1130,868,0.5357142857142857,262,0.5655655655655656
2001,1119,7,18,522,1245,0.28,-723,0.29541595925297115
2001,1120,17,13,1379,977,0.5666666666666667,402,0.5853140916808149
2001,1122,20,10,1637,702,0.6666666666666666,935,0.6998717400598546
2001,1123,16,12,1222,707,0.5714285714285714,515,0.6334888543286677
2001,1124,17,11,1291,668,0.6071428571428571,623,0.6590096988259316
2001,1125,9,14,726,975,0.391304347826087,-249,0.42680776014109345
2001,1126,7,18,465,1056,0.28,-591,0.3057199211045365
2001,1129,15,14,1167,911,0.5172413793103449,256,0.5615976900866217
2001,1130,25,4,2032,292,0.8620689655172413,1740,0.8743545611015491
2001,1131,14,14,1023,890,0.5,133,0.534762153685311
2001,1132,13,14,1024,959,0.48148148148148145,65,0.5163893091275845
2001,1133,18,11,1222,693,0.6206896551724138,529,0.6381201044386423
2001,1135,15,12,1198,770,0.5555555555555556,428,0.608739837398374
2001,1137,12,15,862,880,0.4444444444444444,-18,0.49483352468427094
2001,1138,4,24,272,1601,0.14285714285714285,-1329,0.14522156967431926
2001,1139,21,7,1493,461,0.75,1032,0.7640736949846468
2001,1140,23,8,1657,524,0.7419354838709677,1133,0.759743237047226
2001,1141,18,8,1322,498,0.6923076923076923,824,0.7263736263736263
2001,1142,5,16,433,1149,0.23809523809523808,-716,0.27370417193426044
2001,1143,20,10,1587,647,0.6666666666666666,940,0.7103849597135183
2001,1144,7,21,553,1266,0.25,-713,0.3040131940626718
2001,1145,20,11,1599,796,0.6451612903225806,803,0.6676409185803758
2001,1147,4,16,307,938,0.2,-631,0.2465863453815261
2001,1148,14,14,1110,940,0.5,170,0.5414634146341464
2001,1149,7,19,470,1173,0.2692307692307692,-703,0.2860620815581254
2001,1150,21,10,1758,694,0.6774193548387096,1064,0.7169657422512234
2001,1151,15,13,1124,880,0.5357142857142857,244,0.5608782435129741
2001,1152,4,23,275,1422,0.14814814814814814,-1147,0.16205067766647024
2001,1153,23,9,1834,537,0.71875,1297,0.7735132855335302
2001,1154,12,12,794,791,0.5,3,0.5009463722397476
2001,1155,12,19,936,1362,0.3870967741935484,-426,0.4073107049608355
2001,1156,17,13,1202,828,0.5666666666666667,374,0.5921182266009852
2001,1157,8,20,604,1380,0.2857142857142857,-776,0.30443548387096775
2001,1158,20,7,1379,415,0.7407407407407407,964,0.7686733556298774
2001,1159,10,15,773,968,0.4,-195,0.44399770246984493
2001,1160,14,15,1257,1083,0.4827586206896552,174,0.5371794871794872
2001,1161,13,13,955,796,0.5,159,0.5454026270702456
2001,1162,10,15,618,796,0.4,-178,0.43705799151343705
2001,1163,18,11,1434,704,0.6206896551724138,730,0.6707202993451824
2001,1164,13,15,920,886,0.4642857142857143,34,0.5094130675526024
2001,1165,6,20,411,1192,0.23076923076923078,-781,0.25639426076107297
2001,1166,24,7,1814,455,0.7741935483870968,1359,0.7994711326575584
2001,1168,3,22,212,1244,0.12,-1032,0.14560439560439561
2001,1169,20,9,1720,684,0.6896551724137931,1036,0.7154742096505824
2001,1170,3,21,222,1405,0.125,-1183,0.13644744929317762
2001,1171,7,19,488,1162,0.2692307692307692,-674,0.2957575757575758
2001,1172,12,17,849,1083,0.41379310344827586,-234,0.4394409937888199
2001,1173,19,12,1456,781,0.6129032258064516,675,0.6508717031738936
2001,1174,20,10,1609,643,0.6666666666666666,966,0.7144760213143873
2001,1175,13,15,934,851,0.4642857142857143,83,0.523249299719888
2001,1176,8,18,594,1118,0.3076923076923077,-524,0.3469626168224299
2001,1177,10,18,794,1194,0.35714285714285715,-400,0.3993963782696177
2001,1178,21,10,1534,640,0.6774193548387096,894,0.7056117755289788
2001,1179,12,16,969,996,0.42857142857142855,-27,0.49312977099236643
2001,1180,15,12,1210,815,0.5555555555555556,395,0.5975308641975309
2001,1181,29,4,2682,335,0.8787878787878788,2347,0.8889625455750746
2001,1182,9,21,699,1417,0.3,-718,0.33034026465028354
2001,1183,19,9,1642,673,0.6785714285714286,969,0.7092872570194384
2001,1184,4,19,292,1363,0.17391304347826086,-1071,0.17643504531722054
2001,1185,3,25,245,1427,0.10714285714285714,-1182,0.1465311004784689
2001,1186,15,11,1123,697,0.5769230769230769,426,0.6170329670329671
2001,1187,13,13,1019,860,0.5,159,0.542309739222991
2001,1189,7,20,498,1204,0.25925925925925924,-706,0.2925969447708578
2001,1190,15,10,1072,679,0.6,393,0.6122215876641919
2001,1191,13,16,937,1046,0.4482758620689655,-109,0.4725163893091276
2001,1192,13,15,941,978,0.4642857142857143,-37,0.49035956227201666
2001,1193,12,16,994,1075,0.42857142857142855,-81,0.4804253262445626
2001,1194,7,22,554,1437,0.2413793103448276,-883,0.2782521346057258
2001,1196,23,6,1963,423,0.7931034482758621,1540,0.8227158424140821
2001,1197,6,22,457,1421,0.21428571428571427,-964,0.24334398296059637
2001,1198,7,21,448,1202,0.25,-754,0.27151515151515154
2001,1199,8,21,617,1389,0.27586206896551724,-772,0.30757726819541376
2001,1200,12,17,945,1205,0.41379310344827586,-260,0.43953488372093025
2001,1201,25,6,2090,452,0.8064516129032258,1638,0.8221872541306058
2001,1202,9,16,664,951,0.36,-287,0.41114551083591333
2001,1203,14,18,1206,1264,0.4375,-58,0.4882591093117409
2001,1204,13,15,1052,1055,0.4642857142857143,-3,0.49928808732795443
2001,1206,18,11,1346,701,0.6206896551724138,645,0.6575476306790425
2001,1207,23,7,1924,445,0.7666666666666667,1479,0.8121570282819756
2001,1208,16,14,1264,925,0.5333333333333333,339,0.5774326176336226
2001,1209,25,4,2051,285,0.8620689655172413,1766,0.8779965753424658
2001,1210,17,12,1407,800,0.5862068965517241,607,0.6375169913910286
2001,1211,23,6,1955,439,0.7931034482758621,1516,0.816624895572264
2001,1212,8,18,671,1302,0.3076923076923077,-631,0.34009123162696403
2001,1214,24,6,1896,457,0.8,1439,0.8057798555036124
2001,1216,4,24,284,1537,0.14285714285714285,-1253,0.15595826468973092
2001,1217,14,12,1093,771,0.5384615384615384,322,0.5863733905579399
2001,1218,17,13,1343,842,0.5666666666666667,501,0.6146453089244851
2001,1219,5,20,314,1179,0.2,-865,0.2103148024112525
2001,1220,26,4,1934,275,0.8666666666666667,1659,0.8755092802172929
2001,1221,22,7,1561,405,0.7586206896551724,1156,0.7939979654120041
2001,1222,9,20,657,1240,0.3103448275862069,-583,0.3463363205060622
2001,1224,10,18,687,1227,0.35714285714285715,-540,0.35893416927899685
2001,1225,4,21,296,1262,0.16,-966,0.18998716302952504
2001,1226,12,14,981,948,0.46153846153846156,33,0.5085536547433903
2001,1227,11,17,878,1023,0.39285714285714285,-145,0.4618621778011573
2001,1228,24,7,1898,491,0.7741935483870968,1407,0.7944746755964839
2001,1229,21,8,1645,533,0.7241379310344828,1112,0.7552800734618916
2001,1231,21,12,1592,743,0.6363636363636364,849,0.6817987152034262
2001,1232,20,11,1526,730,0.6451612903225806,796,0.6764184397163121
2001,1233,21,10,1662,734,0.6774193548387096,928,0.6936560934891486
2001,1234,22,11,1699,746,0.6666666666666666,953,0.6948875255623722
2001,1235,24,5,1908,384,0.8275862068965517,1524,0.8324607329842932
2001,1237,9,18,659,1173,0.3333333333333333,-514,0.3597161572052402
2001,1238,7,22,506,1445,0.2413793103448276,-939,0.2593541773449513
2001,1239,15,10,1063,641,0.6,422,0.6238262910798122
2001,1240,9,18,671,1085,0.3333333333333333,-414,0.3821184510250569
2001,1241,12,17,867,1013,0.41379310344827586,-146,0.46117021276595743
2001,1242,22,6,1865,401,0.7857142857142857,1464,0.8230361871138571
2001,1243,11,18,791,1052,0.3793103448275862,-261,0.42919153553988065
2001,1245,22,9,1594,586,0.7096774193548387,1008,0.7311926605504587
2001,1246,22,9,1844,629,0.7096774193548387,1215,0.7456530529720987
2001,1247,12,17,927,1084,0.41379310344827586,-157,0.460964694181999
2001,1248,10,16,775,1171,0.38461538461538464,-396,0.3982528263103803
2001,1249,8,18,618,1011,0.3076923076923077,-393,0.37937384898710863
2001,1250,12,16,911,1027,0.42857142857142855,-116,0.47007223942208465
2001,1251,10,15,641,945,0.4,-304,0.4041614123581337
2001,1253,15,13,1163,921,0.5357142857142857,242,0.5580614203454894
2001,1254,12,16,914,985,0.42857142857142855,-71,0.4813059505002633
2001,1256,16,12,1184,708,0.5714285714285714,476,0.6257928118393234
2001,1257,12,19,937,1219,0.3870967741935484,-282,0.43460111317254174
2001,1258,8,19,576,1207,0.2962962962962963,-631,0.32305103757711723
2001,1259,6,23,410,1388,0.20689655172413793,-978,0.22803114571746386
2001,1260,7,21,528,1404,0.25,-876,0.2732919254658385
2001,1261,13,16,1054,1015,0.4482758620689655,39,0.5094248429192847
2001,1263,17,11,1391,781,0.6071428571428571,610,0.6404235727440147
2001,1264,14,15,1094,988,0.4827586206896552,106,0.5254562920268973
2001,1265,17,13,1237,882,0.5666666666666667,355,0.5837659273242095
2001,1266,15,14,1038,864,0.5172413793103449,174,0.5457413249211357
2001,1267,16,9,1237,617,0.64,620,0.6672060409924487
2001,1268,21,10,1878,780,0.6774193548387096,1098,0.7065462753950339
2001,1269,15,15,1077,963,0.5,114,0.5279411764705882
2001,1270,21,8,1794,604,0.7241379310344828,1190,0.7481234361968306
2001,1271,12,16,899,923,0.42857142857142855,-24,0.4934138309549945
2001,1272,16,14,1313,900,0.5333333333333333,413,0.5933122458201536
2001,1273,12,15,893,967,0.4444444444444444,-74,0.4801075268817204
2001,1274,16,12,1205,776,0.5714285714285714,429,0.6082786471479051
2001,1275,17,16,1116,881,0.5151515151515151,235,0.5588382573860792
2001,1276,9,18,749,1139,0.3333333333333333,-390,0.3967161016949153
2001,1277,24,4,1954,242,0.8571428571428571,1712,0.8897996357012751
2001,1278,15,13,1173,847,0.5357142857142857,326,0.5806930693069307
2001,1279,24,7,1762,453,0.7741935483870968,1309,0.7954853273137698
2001,1280,16,12,1300,807,0.5714285714285714,493,0.6169909824394875
2001,1281,18,12,1429,823,0.6,606,0.6345470692717584
2001,1282,13,15,885,857,0.4642857142857143,28,0.5080367393800229
2001,1283,13,16,912,938,0.4482758620689655,-26,0.492972972972973
2001,1284,21,9,1524,604,0.7,920,0.7161654135338346
2001,1285,9,16,677,1097,0.36,-420,0.38162344983089064
2001,1286,15,14,1185,972,0.5172413793103449,213,0.5493741307371349
2001,1287,10,16,761,1069,0.38461538461538464,-308,0.4158469945355191
2001,1288,6,23,423,1531,0.20689655172413793,-1108,0.2164790174002047
2001,1290,16,9,1327,656,0.64,671,0.6691880988401412
2001,1291,7,21,489,1290,0.25,-801,0.2748735244519393
2001,1292,4,22,337,1360,0.15384615384615385,-1023,0.19858573954036535
2001,1293,15,12,1249,885,0.5555555555555556,364,0.5852858481724461
2001,1296,4,22,253,1426,0.15384615384615385,-1173,0.1506849315068493
2001,1298,17,12,1418,768,0.5862068965517241,650,0.6486733760292772
2001,1299,12,17,904,1082,0.41379310344827586,-178,0.4551863041289023
2001,1301,13,16,1097,1044,0.4482758620689655,53,0.5123773937412424
2001,1304,13,16,1016,1034,0.4482758620689655,-18,0.49560975609756097
2001,1305,9,18,697,1198,0.3333333333333333,-501,0.36781002638522425
2001,1306,7,21,583,1449,0.25,-866,0.2869094488188976
2001,1307,18,12,1312,732,0.6,580,0.6418786692759295
2001,1308,13,14,1063,913,0.48148148148148145,150,0.5379554655870445
2001,1309,15,12,1077,758,0.5555555555555556,319,0.5869209809264305
2001,1310,15,13,1199,900,0.5357142857142857,299,0.5712243925678895
2001,1311,13,14,928,900,0.48148148148148145,28,0.5076586433260394
2001,1313,12,17,969,1157,0.41379310344827586,-188,0.4557855126999059
2001,1314,25,6,2062,405,0.8064516129032258,1657,0.8358329955411431
2001,1317,1,24,70,1664,0.04,-1594,0.040369088811995385
2001,1318,10,19,808,1321,0.3448275862068966,-513,0.37952090183184595
2001,1319,12,14,916,945,0.46153846153846156,-29,0.492208490059108
2001,1320,6,24,386,1407,0.2,-1021,0.21528165086447296
2001,1321,11,19,771,1030,0.36666666666666664,-259,0.4280955024986119
2001,1322,18,12,1326,841,0.6,485,0.6119058606368251
2001,1323,19,9,1591,608,0.6785714285714286,983,0.7235106866757617
2001,1324,11,15,868,1066,0.4230769230769231,-198,0.44881075491209926
2001,1325,18,11,1417,740,0.6206896551724138,677,0.6569309225776542
2001,1326,20,10,1499,639,0.6666666666666666,860,0.7011225444340505
2001,1328,26,6,2027,359,0.8125,1668,0.8495389773679799
2001,1329,19,9,1419,582,0.6785714285714286,837,0.7091454272863568
2001,1330,12,17,873,1065,0.41379310344827586,-192,0.4504643962848297
2001,1331,7,19,580,1253,0.2692307692307692,-673,0.31642116748499727
2001,1332,14,14,1175,1012,0.5,163,0.5372656607224509
2001,1333,9,19,606,1096,0.32142857142857145,-490,0.35605170387779084
2001,1334,15,12,1084,708,0.5555555555555556,376,0.6049107142857143
2001,1335,12,17,808,1117,0.41379310344827586,-309,0.41974025974025975
2001,1336,19,11,1534,778,0.6333333333333333,756,0.6634948096885813
2001,1337,21,8,1646,548,0.7241379310344828,1098,0.7502278942570647
2001,1338,17,13,1181,847,0.5666666666666667,334,0.5823471400394478
2001,1339,7,17,490,1150,0.2916666666666667,-660,0.29878048780487804
2001,1340,8,17,588,1133,0.32,-545,0.34166182452062754
2001,1341,5,20,397,1351,0.2,-954,0.22711670480549198
2001,1343,15,10,936,509,0.6,427,0.6477508650519032
2001,1344,20,9,1593,588,0.6896551724137931,1005,0.7303988995873453
2001,1345,15,14,1222,923,0.5172413793103449,299,0.5696969696969697
2001,1346,5,21,387,1444,0.19230769230769232,-1057,0.2113599126160568
2001,1347,18,10,1394,632,0.6428571428571429,762,0.6880552813425469
2001,1348,7,22,576,1437,0.2413793103448276,-861,0.28614008941877794
2001,1349,13,16,918,908,0.4482758620689655,10,0.5027382256297919
2001,1350,21,6,1558,336,0.7777777777777778,1222,0.82259767687434
2001,1351,16,12,1259,763,0.5714285714285714,496,0.6226508407517309
2001,1352,7,22,530,1434,0.2413793103448276,-904,0.269857433808554
2001,1353,11,16,752,1012,0.4074074074074074,-260,0.42630385487528344
2001,1354,19,13,1315,778,0.59375,537,0.6282847587195414
2001,1356,15,14,1164,940,0.5172413793103449,224,0.5532319391634981
2001,1357,7,21,530,1340,0.25,-810,0.28342245989304815
2001,1358,13,13,1035,921,0.5,114,0.5291411042944786
2001,1359,14,14,978,835,0.5,143,0.5394373965802537
2001,1360,15,13,1103,842,0.5357142857142857,261,0.5670951156812339
2001,1361,12,14,917,844,0.46153846153846156,73,0.5207268597387847
2001,1362,10,18,746,1157,0.35714285714285715,-411,0.3920126116657909
2001,1363,9,14,648,841,0.391304347826087,-193,0.43519140362659503
2001,1364,11,14,885,873,0.44,12,0.5034129692832765
2001,1365,19,12,1446,729,0.6129032258064516,717,0.6648275862068965
2001,1368,7,21,436,1160,0.25,-724,0.2731829573934837
2001,1369,14,12,1050,800,0.5384615384615384,250,0.5675675675675675
2001,1371,16,14,1310,917,0.5333333333333333,393,0.5882352941176471
2001,1372,7,17,407,975,0.2916666666666667,-568,0.2945007235890014
2001,1373,19,11,1539,790,0.6333333333333333,749,0.6607986260197509
2001,1374,16,12,1260,861,0.5714285714285714,399,0.594059405940594
2001,1375,20,10,1497,552,0.6666666666666666,945,0.7306002928257687
2001,1376,15,14,1081,896,0.5172413793103449,185,0.5467880627212949
2001,1378,18,13,1387,918,0.5806451612903226,469,0.6017353579175705
2001,1379,21,8,1533,488,0.7241379310344828,1045,0.7585353785254825
2001,1380,11,16,881,1081,0.4074074074074074,-200,0.4490316004077472
2001,1381,22,5,1665,296,0.8148148148148148,1369,0.8490566037735849
2001,1382,18,11,1429,727,0.6206896551724138,702,0.6628014842300557
2001,1383,18,11,1486,811,0.6206896551724138,675,0.6469307792773182
2001,1384,9,18,679,1133,0.3333333333333333,-454,0.37472406181015455
2001,1385,14,15,1116,1015,0.4827586206896552,101,0.5236977944626936
2001,1386,25,6,2016,460,0.8064516129032258,1556,0.81421647819063
2001,1387,17,14,1292,881,0.5483870967741935,411,0.5945697192820985
2001,1388,1,25,71,1501,0.038461538461538464,-1430,0.045165394402035625
2001,1389,4,24,305,1636,0.14285714285714285,-1331,0.15713549716640907
2001,1390,26,2,2167,148,0.9285714285714286,2019,0.9360691144708423
2001,1391,15,12,1174,831,0.5555555555555556,343,0.5855361596009975
2001,1392,12,11,885,683,0.5217391304347826,202,0.5644132653061225
2001,1393,24,8,1832,506,0.75,1326,0.7835757057313943
2001,1395,19,11,1887,874,0.6333333333333333,1013,0.6834480260775081
2001,1396,21,12,1560,744,0.6363636363636364,816,0.6770833333333334
2001,1397,22,10,1826,779,0.6875,1047,0.7009596928982725
2001,1398,8,19,713,1418,0.2962962962962963,-705,0.334584702017832
2001,1399,17,9,1365,618,0.6538461538461539,747,0.6883509833585476
2001,1400,24,8,1762,490,0.75,1272,0.7824156305506217
2001,1401,9,19,678,1272,0.32142857142857145,-594,0.3476923076923077
2001,1402,10,15,685,1018,0.4,-333,0.4022313564298297
2001,1403,9,18,662,1176,0.3333333333333333,-514,0.3601741022850925
2001,1404,7,18,566,1156,0.28,-590,0.32868757259001163
2001,1405,21,10,1622,621,0.6774193548387096,1001,0.7231386535889434
2001,1406,12,17,906,1091,0.41379310344827586,-185,0.45368052078117177
2001,1407,18,12,1446,811,0.6,635,0.6406734603455915
2001,1408,7,21,562,1434,0.25,-872,0.281563126252505
2001,1409,21,11,1675,786,0.65625,889,0.6806176351076798
2001,1410,7,16,545,1098,0.30434782608695654,-553,0.3317102860620816
2001,1411,7,22,509,1384,0.2413793103448276,-875,0.2688853671421025
2001,1412,17,14,1317,919,0.5483870967741935,398,0.5889982110912343
2001,1414,22,4,1556,230,0.8461538461538461,1326,0.8712206047032475
2001,1416,7,22,568,1473,0.2413793103448276,-905,0.27829495345418914
2001,1417,21,8,1737,608,0.7241379310344828,1129,0.7407249466950959
2001,1418,15,13,1196,927,0.5357142857142857,269,0.5633537447008949
2001,1419,9,17,740,1090,0.34615384615384615,-350,0.40437158469945356
2001,1420,18,11,1485,774,0.6206896551724138,711,0.6573705179282868
2001,1421,13,13,982,788,0.5,194,0.5548022598870056
2001,1422,18,11,1373,768,0.6206896551724138,605,0.641289117234937
2001,1423,19,10,1227,556,0.6551724137931034,671,0.688166012338755
2001,1424,14,13,1131,877,0.5185185185185185,254,0.5632470119521913
2001,1425,20,9,1637,605,0.6896551724137931,1032,0.7301516503122212
2001,1426,11,15,791,1096,0.4230769230769231,-305,0.41918388977212506
2001,1427,13,15,1002,1081,0.4642857142857143,-79,0.4810369659145463
2001,1428,16,11,1191,699,0.5925925925925926,492,0.6301587301587301
2001,1429,23,5,1652,327,0.8214285714285714,1325,0.8347650328448711
2001,1431,21,8,1724,577,0.7241379310344828,1147,0.7492394611038679
2001,1433,15,14,1128,982,0.5172413793103449,146,0.5345971563981042
2001,1434,21,8,1538,475,0.7241379310344828,1063,0.764033780427223
2001,1435,14,15,1058,990,0.4827586206896552,68,0.5166015625
2001,1436,12,17,998,1126,0.41379310344827586,-128,0.4698681732580038
2001,1437,18,12,1419,879,0.6,540,0.6174934725848564
2001,1438,20,8,1824,555,0.7142857142857143,1269,0.7667087011349306
2001,1439,8,19,597,1173,0.2962962962962963,-576,0.33728813559322035
2001,1440,7,19,502,1251,0.2692307692307692,-749,0.28636622932116373
2001,1441,5,24,374,1506,0.1724137931034483,-1132,0.19893617021276597
2001,1442,5,22,439,1433,0.18518518518518517,-994,0.234508547008547
2001,1443,21,6,1578,410,0.7777777777777778,1168,0.7937625754527163
2001,1444,7,21,500,1360,0.25,-860,0.26881720430107525
2001,1447,16,13,1413,980,0.5517241379310345,433,0.5904722106142917
2001,1448,19,10,1535,698,0.6551724137931034,837,0.6874160322436185
2001,1449,9,20,700,1260,0.3103448275862069,-560,0.35714285714285715
2001,1450,12,16,863,1011,0.42857142857142855,-148,0.4605122732123799
2001,1451,11,13,920,960,0.4583333333333333,-40,0.48936170212765956
2001,1452,16,11,1256,743,0.5925925925925926,513,0.6283141570785392
2001,1453,11,17,665,967,0.39285714285714285,-302,0.4074754901960784
2001,1454,13,13,955,810,0.5,145,0.5410764872521246
2001,1455,9,19,613,1177,0.32142857142857145,-564,0.3424581005586592
2001,1456,11,17,720,992,0.39285714285714285,-272,0.4205607476635514
2001,1457,16,10,1134,557,0.6153846153846154,577,0.6706091070372561
2001,1458,18,10,1120,554,0.6428571428571429,566,0.6690561529271206
2001,1459,8,16,669,945,0.3333333333333333,-276,0.4144981412639405
2001,1460,17,11,1272,684,0.6071428571428571,588,0.6503067484662577
2001,1461,19,9,1477,659,0.6785714285714286,818,0.6914794007490637
2001,1462,21,7,1636,423,0.75,1213,0.7945604662457504
2001,1463,10,17,710,1034,0.37037037037037035,-324,0.40711009174311924
2001,1464,17,11,1249,721,0.6071428571428571,528,0.6340101522842639
2001,3102,3,24,220,1132,0.1111111111111111,-912,0.16272189349112426
2001,3103,6,23,416,1243,0.20689655172413793,-827,0.25075346594333936
2001,3104,18,11,1207,634,0.6206896551724138,573,0.6556219445953286
2001,3105,7,19,516,1166,0.2692307692307692,-650,0.30677764565992865
2001,3106,17,9,1226,583,0.6538461538461539,643,0.677722498618021
2001,3107,4,20,283,1099,0.16666666666666666,-816,0.20477568740955138
2001,3108,20,10,1485,530,0.6666666666666666,955,0.7369727047146402
2001,3110,4,22,281,1236,0.15384615384615385,-955,0.1852340145023072
2001,3111,6,23,487,1486,0.20689655172413793,-999,0.2468322351748606
2001,3112,18,11,1507,762,0.6206896551724138,745,0.6641692375495813
2001,3113,19,9,1307,531,0.6785714285714286,776,0.7110990206746464
2001,3114,5,19,349,1042,0.20833333333333334,-693,0.25089863407620416
2001,3115,5,23,345,1224,0.17857142857142858,-879,0.2198852772466539
2001,3116,18,13,1486,768,0.5806451612903226,718,0.6592724046140195
2001,3117,14,14,1128,798,0.5,330,0.5856697819314641
2001,3119,18,10,1260,617,0.6428571428571429,643,0.6712839637719765
2001,3120,17,12,1327,712,0.5862068965517241,615,0.6508092202059833
2001,3122,17,12,1327,861,0.5862068965517241,466,0.606489945155393
2001,3123,19,9,1692,620,0.6785714285714286,1072,0.7318339100346021
2001,3124,20,8,1638,541,0.7142857142857143,1097,0.7517209729233594
2001,3125,10,12,703,816,0.45454545454545453,-113,0.4628044766293614
2001,3126,10,17,680,1077,0.37037037037037035,-397,0.3870233352305065
2001,3129,12,17,800,983,0.41379310344827586,-183,0.448681996634885
2001,3130,14,15,1034,892,0.4827586206896552,142,0.5368639667705088
2001,3131,10,19,745,1114,0.3448275862068966,-369,0.4007530930607854
2001,3132,11,18,873,1105,0.3793103448275862,-232,0.4413549039433772
2001,3133,9,17,601,1057,0.34615384615384615,-456,0.36248492159227985
2001,3135,9,17,584,974,0.34615384615384615,-390,0.3748395378690629
2001,3137,20,7,1609,459,0.7407407407407407,1150,0.778046421663443
2001,3138,19,9,1418,516,0.6785714285714286,902,0.733195449844881
2001,3139,8,19,500,1078,0.2962962962962963,-578,0.31685678073510776
2001,3140,18,12,1288,741,0.6,547,0.6347954657466732
2001,3141,3,23,218,1345,0.11538461538461539,-1127,0.13947536788227768
2001,3142,11,17,779,990,0.39285714285714285,-211,0.44036178631995476
2001,3143,12,16,844,965,0.42857142857142855,-121,0.4665561083471531
2001,3144,21,7,1550,443,0.75,1107,0.777722027094832
2001,3145,9,19,670,1307,0.32142857142857145,-637,0.3388973191704603
2001,3148,14,13,939,777,0.5185185185185185,162,0.5472027972027972
2001,3149,13,13,942,792,0.5,150,0.5432525951557093
2001,3150,9,17,608,964,0.34615384615384615,-356,0.38676844783715014
2001,3151,24,6,1886,395,0.8,1491,0.8268303375712407
2001,3152,10,19,638,922,0.3448275862068966,-284,0.40897435897435896
2001,3153,22,10,1572,596,0.6875,976,0.7250922509225092
2001,3155,20,9,1508,568,0.6896551724137931,940,0.7263969171483622
2001,3156,15,13,1276,866,0.5357142857142857,410,0.5957049486461251
2001,3157,12,13,777,732,0.48,45,0.5149105367793241
2001,3158,10,15,716,900,0.4,-184,0.4430693069306931
2001,3159,7,21,520,1289,0.25,-769,0.28745163073521285
2001,3160,20,8,1634,543,0.7142857142857143,1091,0.7505741846577859
2001,3161,23,5,1726,297,0.8214285714285714,1429,0.8531883341571923
2001,3162,8,17,455,952,0.32,-497,0.32338308457711445
2001,3163,28,2,2467,164,0.9333333333333333,2303,0.9376662865830483
2001,3164,10,17,700,1072,0.37037037037037035,-372,0.39503386004514673
2001,3165,15,12,1047,703,0.5555555555555556,344,0.5982857142857143
2001,3166,17,11,1305,682,0.6071428571428571,623,0.6567689984901862
2001,3168,1,25,57,1302,0.038461538461538464,-1245,0.04194260485651214
2001,3169,9,16,669,904,0.36,-235,0.4253019707565162
2001,3170,2,22,146,1253,0.08333333333333333,-1107,0.1043602573266619
2001,3171,12,15,791,873,0.4444444444444444,-82,0.4753605769230769
2001,3172,8,19,570,1126,0.2962962962962963,-556,0.33608490566037735
2001,3173,15,13,1040,807,0.5357142857142857,233,0.5630752571737954
2001,3174,25,5,1843,272,0.8333333333333334,1571,0.8713947990543736
2001,3175,16,13,1122,670,0.5517241379310345,452,0.6261160714285714
2001,3176,24,6,1642,380,0.8,1262,0.8120672601384767
2001,3177,17,13,1257,798,0.5666666666666667,459,0.6116788321167883
2001,3178,16,12,1270,833,0.5714285714285714,437,0.6038991916310034
2001,3179,22,6,1600,380,0.7857142857142857,1220,0.8080808080808081
2001,3180,19,9,1567,625,0.6785714285714286,942,0.7148722627737226
2001,3181,28,3,2117,199,0.9032258064516129,1918,0.9140759930915371
2001,3182,15,14,1029,823,0.5172413793103449,206,0.5556155507559395
2001,3183,7,20,513,1282,0.25925925925925924,-769,0.2857938718662953
2001,3184,18,7,1611,528,0.72,1083,0.7531556802244039
2001,3185,15,12,1140,795,0.5555555555555556,345,0.5891472868217055
2001,3186,8,18,582,1003,0.3076923076923077,-421,0.36719242902208205
2001,3187,15,12,1067,687,0.5555555555555556,380,0.6083238312428735
2001,3189,15,13,1089,725,0.5357142857142857,364,0.6003307607497244
2001,3190,7,21,539,1355,0.25,-816,0.2845828933474129
2001,3191,13,15,994,956,0.4642857142857143,38,0.5097435897435898
2001,3192,11,16,805,879,0.4074074074074074,-74,0.47802850356294535
2001,3193,25,5,1902,320,0.8333333333333334,1582,0.855985598559856
2001,3194,9,19,733,1256,0.32142857142857145,-523,0.36852689793866267
2001,3196,23,5,1856,338,0.8214285714285714,1518,0.845943482224248
2001,3197,12,14,880,852,0.46153846153846156,28,0.5080831408775982
2001,3198,20,9,1589,546,0.6896551724137931,1043,0.7442622950819672
2001,3199,18,11,1362,697,0.6206896551724138,665,0.661486158329286
2001,3200,5,23,309,1303,0.17857142857142858,-994,0.19168734491315137
2001,3201,9,19,635,1107,0.32142857142857145,-472,0.36452353616532723
2001,3202,18,10,1356,608,0.6428571428571429,748,0.6904276985743381
2001,3203,22,9,1656,552,0.7096774193548387,1104,0.75
2001,3204,21,7,1648,415,0.75,1233,0.7988366456616578
2001,3206,21,7,1434,411,0.75,1023,0.7772357723577236
2001,3207,16,14,1216,773,0.5333333333333333,443,0.6113624937154349
2001,3208,26,5,2143,341,0.8387096774193549,1802,0.8627214170692431
2001,3209,22,6,1651,391,0.7857142857142857,1260,0.8085210577864839
2001,3210,14,14,1139,904,0.5,235,0.557513460597161
2001,3211,4,23,277,1226,0.14814814814814814,-949,0.18429807052561545
2001,3212,14,12,1181,830,0.5384615384615384,351,0.5872700149179513
2001,3214,14,13,1070,958,0.5185185185185185,112,0.5276134122287969
2001,3216,15,14,1062,785,0.5172413793103449,277,0.5749864645370871
2001,3217,12,15,800,920,0.4444444444444444,-120,0.46511627906976744
2001,3218,23,5,1657,325,0.8214285714285714,1332,0.8360242179616549
2001,3219,10,15,682,914,0.4,-232,0.4273182957393484
2001,3220,8,19,556,1191,0.2962962962962963,-635,0.318259874069834
2001,3221,21,8,1585,478,0.7241379310344828,1107,0.7682985942801746
2001,3222,19,12,1505,789,0.6129032258064516,716,0.6560592850915432
2001,3224,20,9,1770,615,0.6896551724137931,1155,0.7421383647798742
2001,3225,7,20,511,1229,0.25925925925925924,-718,0.29367816091954024
2001,3226,19,4,1261,215,0.8260869565217391,1046,0.8543360433604336
2001,3227,10,19,722,988,0.3448275862068966,-266,0.4222222222222222
2001,3228,16,15,1233,959,0.5161290322580645,274,0.5625
2001,3229,5,21,327,1304,0.19230769230769232,-977,0.2004904966278357
2001,3231,19,10,1412,607,0.6551724137931034,805,0.6993561168895492
2001,3232,10,18,753,1118,0.35714285714285715,-365,0.4024585783003741
2001,3233,9,18,625,1065,0.3333333333333333,-440,0.3698224852071006
2001,3234,20,9,1615,606,0.6896551724137931,1009,0.7271499324628545
2001,3235,25,5,2048,324,0.8333333333333334,1724,0.863406408094435
2001,3237,10,18,756,1180,0.35714285714285715,-424,0.390495867768595
2001,3238,7,18,510,1072,0.28,-562,0.3223767383059418
2001,3239,13,15,818,807,0.4642857142857143,11,0.5033846153846154
2001,3240,7,18,481,987,0.28,-506,0.3276566757493188
2001,3241,20,9,1491,527,0.6896551724137931,964,0.7388503468780971
2001,3242,12,17,944,1041,0.41379310344827586,-97,0.4755667506297229
2001,3243,12,16,826,925,0.42857142857142855,-99,0.47173043974871504
2001,3245,21,7,1704,413,0.75,1291,0.8049126121870571
2001,3246,8,19,616,1051,0.2962962962962963,-435,0.3695260947810438
2001,3247,15,14,1061,831,0.5172413793103449,230,0.5607822410147991
2001,3248,7,19,457,1073,0.2692307692307692,-616,0.29869281045751633
2001,3249,12,16,785,930,0.42857142857142855,-145,0.4577259475218659
2001,3250,16,13,1181,802,0.5517241379310345,379,0.5955622793746849
2001,3251,18,11,1164,628,0.6206896551724138,536,0.6495535714285714
2001,3253,17,13,1414,859,0.5666666666666667,555,0.622085349758029
2001,3254,15,14,1213,899,0.5172413793103449,314,0.5743371212121212
2001,3256,28,4,2191,235,0.875,1956,0.9031327287716405
2001,3257,19,7,1447,449,0.7307692307692307,998,0.7631856540084389
2001,3258,21,9,1505,551,0.7,954,0.7320038910505836
2001,3259,18,10,1230,561,0.6428571428571429,669,0.6867671691792295
2001,3260,11,17,868,1014,0.39285714285714285,-146,0.461211477151966
2001,3261,19,10,1433,624,0.6551724137931034,809,0.6966456003889159
2001,3263,12,15,845,894,0.4444444444444444,-49,0.48591144335825187
2001,3264,14,13,1039,801,0.5185185185185185,238,0.5646739130434782
2001,3265,6,22,494,1290,0.21428571428571427,-796,0.2769058295964126
2001,3266,13,16,791,952,0.4482758620689655,-161,0.4538152610441767
2001,3267,5,19,375,1215,0.20833333333333334,-840,0.2358490566037736
2001,3268,17,11,1185,655,0.6071428571428571,530,0.6440217391304348
2001,3269,12,16,779,868,0.42857142857142855,-89,0.4729811778992107
2001,3270,5,22,342,1278,0.18518518518518517,-936,0.2111111111111111
2001,3271,5,21,322,1079,0.19230769230769232,-757,0.22983583154889364
2001,3272,17,12,1315,758,0.5862068965517241,557,0.6343463579353594
2001,3273,4,23,309,1214,0.14814814814814814,-905,0.20288903479973736
2001,3274,12,15,883,819,0.4444444444444444,64,0.518801410105758
2001,3275,18,11,1460,736,0.6206896551724138,724,0.6648451730418944
2001,3276,18,11,1339,645,0.6206896551724138,694,0.6748991935483871
2001,3277,10,17,734,866,0.37037037037037035,-132,0.45875
2001,3278,7,20,555,1262,0.25925925925925924,-707,0.3054485415520088
2001,3279,15,13,1091,752,0.5357142857142857,339,0.5919696147585458
2001,3280,15,13,1186,814,0.5357142857142857,372,0.593
2001,3281,19,9,1474,641,0.6785714285714286,833,0.6969267139479906
2001,3282,2,25,124,1218,0.07407407407407407,-1094,0.09239940387481371
2001,3283,25,5,2129,371,0.8333333333333334,1758,0.8516
2001,3284,13,12,1005,762,0.52,243,0.568760611205433
2001,3285,20,9,1476,528,0.6896551724137931,948,0.7365269461077845
2001,3286,16,9,1091,527,0.64,564,0.6742892459826947
2001,3287,8,18,678,1323,0.3076923076923077,-645,0.33883058470764615
2001,3288,9,18,679,1099,0.3333333333333333,-420,0.38188976377952755
2001,3290,1,23,69,1201,0.041666666666666664,-1132,0.05433070866141732
2001,3291,11,13,776,889,0.4583333333333333,-113,0.46606606606606604
2001,3292,14,12,1113,784,0.5384615384615384,329,0.5867158671586716
2001,3293,8,18,542,1072,0.3076923076923077,-530,0.3358116480793061
2001,3296,16,16,1120,861,0.5,259,0.5653710247349824
2001,3298,11,17,794,1077,0.39285714285714285,-283,0.4243719935863175
2001,3299,4,20,272,1269,0.16666666666666666,-997,0.1765087605451006
2001,3301,20,10,1377,588,0.6666666666666666,789,0.7007633587786259
2001,3304,11,18,795,1072,0.3793103448275862,-277,0.4258168184252812
2001,3305,15,13,1195,750,0.5357142857142857,445,0.6143958868894601
2001,3306,10,18,693,983,0.35714285714285715,-290,0.41348448687350836
2001,3307,18,12,1309,736,0.6,573,0.6400977995110024
2001,3308,6,18,416,1069,0.25,-653,0.2801346801346801
2001,3309,15,14,1084,828,0.5172413793103449,256,0.5669456066945606
2001,3310,10,18,738,1153,0.35714285714285715,-415,0.390269698572184
2001,3311,9,19,648,1090,0.32142857142857145,-442,0.37284234752589185
2001,3313,13,15,930,920,0.4642857142857143,10,0.5027027027027027
2001,3314,14,14,1137,1006,0.5,131,0.5305646290247317
2001,3317,19,10,1402,599,0.6551724137931034,803,0.7006496751624188
2001,3318,13,16,892,993,0.4482758620689655,-101,0.47320954907161805
2001,3319,13,17,809,917,0.43333333333333335,-108,0.4687137891077636
2001,3320,18,9,1347,582,0.6666666666666666,765,0.6982892690513219
2001,3321,4,23,296,1287,0.14814814814814814,-991,0.18698673404927352
2001,3322,22,7,1599,416,0.7586206896551724,1183,0.7935483870967742
2001,3323,28,2,2164,129,0.9333333333333333,2035,0.9437418229393807
2001,3324,18,12,1397,699,0.6,698,0.6665076335877863
2001,3325,9,19,730,1345,0.32142857142857145,-615,0.35180722891566263
2001,3326,16,12,1254,772,0.5714285714285714,482,0.6189536031589339
2001,3328,26,5,2227,352,0.8387096774193549,1875,0.8635129895308259
2001,3329,14,13,1007,711,0.5185185185185185,296,0.5861466821885913
2001,3330,19,8,1499,494,0.7037037037037037,1005,0.7521324636226794
2001,3331,16,10,1080,594,0.6153846153846154,486,0.6451612903225806
2001,3332,16,11,1146,692,0.5925925925925926,454,0.6235038084874864
2001,3333,15,12,1102,767,0.5555555555555556,335,0.5896201177100053
2001,3334,17,11,1251,716,0.6071428571428571,535,0.6359938993390951
2001,3335,21,5,1494,340,0.8076923076923077,1154,0.8146128680479825
2001,3336,19,9,1575,643,0.6785714285714286,932,0.7100991884580703
2001,3337,20,10,1532,670,0.6666666666666666,862,0.695731153496821
2001,3338,9,18,692,1028,0.3333333333333333,-336,0.40232558139534885
2001,3339,12,14,832,825,0.46153846153846156,7,0.5021122510561256
2001,3340,4,23,273,1267,0.14814814814814814,-994,0.17727272727272728
2001,3341,11,14,756,782,0.44,-26,0.49154746423927176
2001,3343,2,24,127,1179,0.07692307692307693,-1052,0.09724349157733538
2001,3344,11,17,877,1024,0.39285714285714285,-147,0.4613361388742767
2001,3345,26,6,2036,401,0.8125,1635,0.8354534263438654
2001,3346,16,13,1160,830,0.5517241379310345,330,0.5829145728643216
2001,3347,9,17,623,973,0.34615384615384615,-350,0.39035087719298245
2001,3348,10,18,644,1033,0.35714285714285715,-389,0.3840190816935003
2001,3349,17,12,1139,697,0.5862068965517241,442,0.6203703703703703
2001,3350,15,12,1249,882,0.5555555555555556,367,0.5861098076020648
2001,3351,6,23,418,1442,0.20689655172413793,-1024,0.22473118279569892
2001,3352,3,23,229,1414,0.11538461538461539,-1185,0.1393791844187462
2001,3353,22,7,1516,384,0.7586206896551724,1132,0.7978947368421052
2001,3354,15,11,1105,667,0.5769230769230769,438,0.623589164785553
2001,3356,6,20,416,1317,0.23076923076923078,-901,0.2400461627236007
2001,3357,15,13,1025,718,0.5357142857142857,307,0.5880665519219737
2001,3358,5,21,384,1200,0.19230769230769232,-816,0.24242424242424243
2001,3359,8,20,526,1032,0.2857142857142857,-506,0.337612323491656
2001,3360,9,16,645,904,0.36,-259,0.41639767591994836
2001,3361,12,15,763,847,0.4444444444444444,-84,0.47391304347826085
2001,3362,12,16,920,990,0.42857142857142855,-70,0.4816753926701571
2001,3363,11,16,782,1023,0.4074074074074074,-241,0.4332409972299169
2001,3364,22,8,1648,491,0.7333333333333333,1157,0.7704534829359514
2001,3365,19,7,1360,426,0.7307692307692307,934,0.761478163493841
2001,3368,10,16,738,806,0.38461538461538464,-68,0.47797927461139894
2001,3369,12,12,952,795,0.5,157,0.5449341728677733
2001,3371,16,12,1044,615,0.5714285714285714,429,0.6292947558770343
2001,3372,26,6,1880,313,0.8125,1567,0.8572731418148655
2001,3373,24,5,1844,361,0.8275862068965517,1483,0.836281179138322
2001,3374,17,12,1227,743,0.5862068965517241,484,0.6228426395939086
2001,3375,12,17,801,816,0.41379310344827586,-15,0.49536178107606677
2001,3376,12,17,920,995,0.41379310344827586,-75,0.4804177545691906
2001,3378,4,24,250,1310,0.14285714285714285,-1060,0.16025641025641027
2001,3379,12,16,841,883,0.42857142857142855,-42,0.48781902552204176
2001,3380,17,10,1198,575,0.6296296296296297,623,0.6756909193457417
2001,3381,14,11,1000,644,0.56,356,0.6082725060827251
2001,3382,7,21,525,1334,0.25,-809,0.2824098977945132
2001,3383,2,25,151,1417,0.07407407407407407,-1266,0.09630102040816327
2001,3384,9,16,683,998,0.36,-315,0.40630577037477694
2001,3385,8,20,502,1053,0.2857142857142857,-551,0.32282958199356915
2001,3386,14,14,961,846,0.5,115,0.5318206972883232
2001,3387,14,14,939,783,0.5,156,0.5452961672473867
2001,3388,25,5,1811,280,0.8333333333333334,1531,0.8660927785748446
2001,3389,16,11,1225,790,0.5925925925925926,435,0.607940446650124
2001,3390,18,10,1413,682,0.6428571428571429,731,0.6744630071599045
2001,3391,21,7,1608,483,0.75,1125,0.7690100430416069
2001,3392,14,10,956,613,0.5833333333333334,343,0.6093052899936265
2001,3393,12,15,880,900,0.4444444444444444,-20,0.4943820224719101
2001,3394,11,10,835,578,0.5238095238095238,257,0.5909412597310687
2001,3395,24,7,1774,452,0.7741935483870968,1322,0.7969451931716083
2001,3396,19,10,1375,586,0.6551724137931034,789,0.7011728709841918
2001,3397,29,2,2425,150,0.9354838709677419,2275,0.941747572815534
2001,3398,8,18,660,1318,0.3076923076923077,-658,0.33367037411526795
2001,3399,23,6,1926,417,0.7931034482758621,1509,0.8220230473751601
2001,3400,20,12,1518,702,0.625,816,0.6837837837837838
2001,3401,12,16,910,1014,0.42857142857142855,-104,0.47297297297297297
2001,3402,8,18,536,933,0.3076923076923077,-397,0.3648740639891082
2001,3403,23,6,1740,367,0.7931034482758621,1373,0.8258186995728524
2001,3404,11,16,849,1109,0.4074074074074074,-260,0.43360572012257403
2001,3405,24,4,1856,235,0.8571428571428571,1621,0.8876135820181731
2001,3406,3,24,194,1304,0.1111111111111111,-1110,0.1295060080106809
2001,3407,14,14,1036,842,0.5,194,0.5516506922257721
2001,3408,22,9,1630,559,0.7096774193548387,1071,0.7446322521699407
2001,3409,8,20,575,1101,0.2857142857142857,-526,0.34307875894988066
2001,3410,8,14,576,813,0.36363636363636365,-237,0.4146868250539957
2001,3411,13,13,814,765,0.5,49,0.5155161494616846
2001,3412,18,9,1340,571,0.6666666666666666,769,0.7012035583464155
2001,3414,13,14,917,763,0.48148148148148145,154,0.5458333333333333
2001,3416,10,18,644,1032,0.35714285714285715,-388,0.38424821002386633
2001,3417,6,23,454,1325,0.20689655172413793,-871,0.25519955030916247
2001,3418,8,21,601,1201,0.27586206896551724,-600,0.3335183129855716
2001,3419,20,9,1459,547,0.6896551724137931,912,0.7273180458624128
2001,3420,12,14,777,764,0.46153846153846156,13,0.5042180402336145
2001,3421,6,18,453,982,0.25,-529,0.31567944250871083
2001,3422,22,8,1603,475,0.7333333333333333,1128,0.7714148219441771
2001,3423,8,18,544,975,0.3076923076923077,-431,0.35813034891375906
2001,3424,18,9,1295,548,0.6666666666666666,747,0.7026587086272382
2001,3425,13,15,952,943,0.4642857142857143,9,0.5023746701846966
2001,3426,6,20,371,1086,0.23076923076923078,-715,0.2546328071379547
2001,3427,16,13,1105,626,0.5517241379310345,479,0.6383593298671288
2001,3428,25,3,1662,166,0.8928571428571429,1496,0.9091903719912473
2001,3431,6,17,438,921,0.2608695652173913,-483,0.32229580573951433
2001,3433,14,12,1068,783,0.5384615384615384,285,0.5769854132901134
2001,3434,6,22,427,1356,0.21428571428571427,-929,0.23948401570386987
2001,3435,21,9,1762,568,0.7,1194,0.7562231759656652
2001,3436,19,11,1424,666,0.6333333333333333,758,0.6813397129186602
2001,3437,21,8,1458,420,0.7241379310344828,1038,0.7763578274760383
2001,3438,18,13,1413,825,0.5806451612903226,588,0.631367292225201
2001,3439,20,8,1380,434,0.7142857142857143,946,0.7607497243660419
2001,3441,13,14,1017,913,0.48148148148148145,104,0.5269430051813472
2001,3442,15,11,1046,650,0.5769230769230769,396,0.6167452830188679
2001,3443,17,13,1325,899,0.5666666666666667,426,0.595773381294964
2001,3444,9,19,697,1193,0.32142857142857145,-496,0.36878306878306877
2001,3447,12,15,824,853,0.4444444444444444,-29,0.4913536076326774
2001,3448,11,17,810,967,0.39285714285714285,-157,0.4558244231851435
2001,3449,19,9,1481,572,0.6785714285714286,909,0.7213833414515344
2001,3450,11,16,810,994,0.4074074074074074,-184,0.4490022172949002
2001,3451,12,15,805,799,0.4444444444444444,6,0.5018703241895262
2001,3452,5,22,387,1335,0.18518518518518517,-948,0.22473867595818817
2001,3453,21,8,1609,498,0.7241379310344828,1111,0.7636449928808733
2001,3454,18,10,1305,608,0.6428571428571429,697,0.6821745948771563
2001,3455,10,17,793,1067,0.37037037037037035,-274,0.42634408602150536
2001,3456,9,19,576,1043,0.32142857142857145,-467,0.355775169857937
2001,3457,6,20,418,1107,0.23076923076923078,-689,0.2740983606557377
2001,3458,18,9,1465,602,0.6666666666666666,863,0.7087566521528785
2001,3459,9,18,683,1060,0.3333333333333333,-377,0.3918531267928858
2001,3460,6,22,425,1266,0.21428571428571427,-841,0.25133057362507394
2001,3461,9,17,641,955,0.34615384615384615,-314,0.4016290726817043
2001,3462,27,2,2177,133,0.9310344827586207,2044,0.9424242424242424
2001,3463,9,16,641,907,0.36,-266,0.4140826873385013
2001,3464,10,18,723,1182,0.35714285714285715,-459,0.3795275590551181
2002,1102,9,19,568,1037,0.32142857142857145,-469,0.35389408099688474
2002,1103,9,21,748,1330,0.3,-582,0.3599615014436959
2002,1104,26,7,2098,416,0.7878787878787878,1682,0.8345266507557677
2002,1105,15,10,1291,712,0.6,579,0.6445332001997004
2002,1106,18,11,1254,639,0.6206896551724138,615,0.6624405705229794
2002,1107,8,20,455,1138,0.2857142857142857,-683,0.28562460765850595
2002,1108,20,9,1733,581,0.6896551724137931,1152,0.7489196197061365
2002,1110,18,12,1274,703,0.6,571,0.6444107233181589
2002,1111,7,18,560,1281,0.28,-721,0.3041825095057034
2002,1112,22,9,1854,718,0.7096774193548387,1136,0.7208398133748056
2002,1113,14,14,1144,994,0.5,150,0.5350795135640786
2002,1114,16,11,1229,748,0.5925925925925926,481,0.6216489630753668
2002,1115,2,26,151,1701,0.07142857142857142,-1550,0.08153347732181425
2002,1116,14,15,1139,1031,0.4827586206896552,108,0.5248847926267282
2002,1117,13,15,1020,937,0.4642857142857143,83,0.5212059274399591
2002,1119,10,16,745,967,0.38461538461538464,-222,0.4351635514018692
2002,1120,12,16,830,1005,0.42857142857142855,-175,0.45231607629427795
2002,1122,11,18,818,1198,0.3793103448275862,-380,0.40575396825396826
2002,1123,19,11,1567,755,0.6333333333333333,812,0.6748492678725236
2002,1124,12,16,1010,1082,0.42857142857142855,-72,0.48279158699808794
2002,1125,11,17,841,1179,0.39285714285714285,-338,0.4163366336633663
2002,1126,11,17,812,1106,0.39285714285714285,-294,0.4233576642335766
2002,1127,9,19,635,1176,0.32142857142857145,-541,0.3506350082827167
2002,1129,12,17,833,968,0.41379310344827586,-135,0.4625208217656857
2002,1130,20,11,1582,715,0.6451612903225806,867,0.6887244231606443
2002,1131,22,9,1521,574,0.7096774193548387,947,0.7260143198090692
2002,1132,23,8,1719,569,0.7419354838709677,1150,0.7513111888111889
2002,1133,9,20,629,1130,0.3103448275862069,-501,0.35758953951108585
2002,1135,16,10,1302,689,0.6153846153846154,613,0.6539427423405324
2002,1137,13,16,891,900,0.4482758620689655,-9,0.49748743718592964
2002,1138,12,18,887,1131,0.4,-244,0.43954410307234887
2002,1139,23,5,1642,317,0.8214285714285714,1325,0.8381827462991323
2002,1140,16,11,1132,735,0.5925925925925926,397,0.6063202999464381
2002,1141,8,19,615,1270,0.2962962962962963,-655,0.32625994694960214
2002,1142,13,12,943,770,0.52,173,0.5504962054874489
2002,1143,22,8,1679,499,0.7333333333333333,1180,0.77089072543618
2002,1144,7,19,563,1253,0.2692307692307692,-690,0.31002202643171806
2002,1145,10,20,740,1225,0.3333333333333333,-485,0.37659033078880405
2002,1147,6,10,464,652,0.375,-188,0.4157706093189964
2002,1148,27,4,2001,225,0.8709677419354839,1776,0.898921832884097
2002,1149,9,16,641,925,0.36,-284,0.40932311621966794
2002,1150,18,11,1473,669,0.6206896551724138,804,0.6876750700280112
2002,1151,14,14,1100,923,0.5,177,0.5437469105289174
2002,1152,1,24,81,1450,0.04,-1369,0.052906596995427824
2002,1153,30,3,2354,193,0.9090909090909091,2161,0.9242245779348253
2002,1154,13,12,1005,807,0.52,198,0.554635761589404
2002,1155,13,17,1078,1179,0.43333333333333335,-101,0.4776251661497563
2002,1156,12,16,923,959,0.42857142857142855,-36,0.4904357066950053
2002,1157,7,19,547,1246,0.2692307692307692,-699,0.30507529280535417
2002,1158,20,8,1469,465,0.7142857142857143,1004,0.7595656670113754
2002,1159,15,11,1119,731,0.5769230769230769,388,0.6048648648648649
2002,1160,14,14,1202,1033,0.5,169,0.537807606263982
2002,1161,10,17,711,1127,0.37037037037037035,-416,0.3868335146898803
2002,1162,10,16,608,818,0.38461538461538464,-210,0.426367461430575
2002,1163,24,6,1934,404,0.8,1530,0.8272027373823782
2002,1164,5,25,357,1389,0.16666666666666666,-1032,0.20446735395189003
2002,1165,4,22,292,1189,0.15384615384615385,-897,0.19716407832545577
2002,1166,22,8,1732,546,0.7333333333333333,1186,0.7603160667251976
2002,1168,4,22,319,1284,0.15384615384615385,-965,0.19900187149095447
2002,1169,11,16,785,1025,0.4074074074074074,-240,0.43370165745856354
2002,1170,5,19,406,1308,0.20833333333333334,-902,0.23687281213535588
2002,1171,8,18,530,1079,0.3076923076923077,-549,0.32939714108141704
2002,1172,18,9,1245,593,0.6666666666666666,652,0.6773667029379761
2002,1173,20,10,1593,607,0.6666666666666666,986,0.7240909090909091
2002,1174,14,16,1033,969,0.4666666666666667,64,0.515984015984016
2002,1175,16,13,1118,762,0.5517241379310345,356,0.5946808510638298
2002,1176,6,19,445,1135,0.24,-690,0.28164556962025317
2002,1177,9,19,710,1271,0.32142857142857145,-561,0.3584048460373549
2002,1178,18,12,1276,692,0.6,584,0.6483739837398373
2002,1179,14,15,1046,961,0.4827586206896552,85,0.521175884404584
2002,1180,14,14,1116,924,0.5,192,0.5470588235294118
2002,1181,29,3,2638,233,0.90625,2405,0.9188436084987809
2002,1182,9,19,698,1094,0.32142857142857145,-396,0.38950892857142855
2002,1183,12,16,953,1090,0.42857142857142855,-137,0.4664708761625061
2002,1184,3,20,276,1337,0.13043478260869565,-1061,0.17110973341599503
2002,1185,5,24,358,1551,0.1724137931034483,-1193,0.18753273965426925
2002,1186,15,13,1068,848,0.5357142857142857,220,0.55741127348643
2002,1187,9,18,652,1058,0.3333333333333333,-406,0.38128654970760234
2002,1189,10,15,764,937,0.4,-173,0.44914756025867136
2002,1190,15,10,1277,695,0.6,582,0.6475659229208925
2002,1191,7,21,524,1369,0.25,-845,0.2768092974115161
2002,1192,4,25,348,1725,0.13793103448275862,-1377,0.1678726483357453
2002,1193,12,17,907,1171,0.41379310344827586,-264,0.43647738209817133
2002,1194,18,10,1374,685,0.6428571428571429,689,0.6673142302088393
2002,1196,22,8,1869,544,0.7333333333333333,1325,0.774554496477414
2002,1197,9,19,664,1199,0.32142857142857145,-535,0.3564143853998926
2002,1198,8,20,517,1224,0.2857142857142857,-707,0.29695577254451466
2002,1199,10,17,797,1114,0.37037037037037035,-317,0.4170591313448456
2002,1200,8,20,626,1354,0.2857142857142857,-728,0.31616161616161614
2002,1201,18,14,1354,961,0.5625,393,0.5848812095032397
2002,1202,13,13,920,821,0.5,99,0.5284319356691557
2002,1203,12,16,908,1038,0.42857142857142855,-130,0.46659815005138744
2002,1204,11,11,957,769,0.5,188,0.5544611819235226
2002,1206,19,9,1419,541,0.6785714285714286,878,0.7239795918367347
2002,1207,18,11,1506,819,0.6206896551724138,687,0.6477419354838709
2002,1208,21,9,1659,626,0.7,1033,0.7260393873085339
2002,1209,19,10,1576,668,0.6551724137931034,908,0.7023172905525846
2002,1210,15,16,1193,1177,0.4838709677419355,16,0.5033755274261603
2002,1211,28,3,2306,200,0.9032258064516129,2106,0.9201915403032721
2002,1212,8,19,679,1428,0.2962962962962963,-749,0.3222591362126246
2002,1214,25,6,1992,481,0.8064516129032258,1511,0.8054993934492519
2002,1216,14,18,932,1017,0.4375,-85,0.47819394561313494
2002,1217,14,12,964,702,0.5384615384615384,262,0.5786314525810324
2002,1218,27,5,2013,296,0.84375,1717,0.8718059766132525
2002,1219,9,17,686,1085,0.34615384615384615,-399,0.38735177865612647
2002,1220,12,20,861,1245,0.375,-384,0.40883190883190884
2002,1221,18,14,1269,755,0.5625,514,0.6269762845849802
2002,1222,17,14,1337,908,0.5483870967741935,429,0.5955456570155901
2002,1224,18,13,1416,907,0.5806451612903226,509,0.6095566078346966
2002,1225,8,19,484,974,0.2962962962962963,-490,0.3319615912208505
2002,1226,7,17,571,1093,0.2916666666666667,-522,0.34314903846153844
2002,1227,17,13,1278,874,0.5666666666666667,404,0.5938661710037175
2002,1228,23,8,1835,559,0.7419354838709677,1276,0.766499582289056
2002,1229,17,14,1176,905,0.5483870967741935,271,0.565112926477655
2002,1231,19,11,1417,658,0.6333333333333333,759,0.6828915662650602
2002,1232,6,22,409,1321,0.21428571428571427,-912,0.23641618497109826
2002,1233,13,17,943,1189,0.43333333333333335,-246,0.4423076923076923
2002,1234,19,15,1494,986,0.5588235294117647,508,0.6024193548387097
2002,1235,11,19,849,1248,0.36666666666666664,-399,0.40486409155937053
2002,1237,12,15,941,1028,0.4444444444444444,-87,0.4779075672930422
2002,1238,9,19,699,1348,0.32142857142857145,-649,0.34147532975085493
2002,1239,14,12,1048,771,0.5384615384615384,277,0.5761407366684992
2002,1240,10,16,784,1043,0.38461538461538464,-259,0.42911877394636017
2002,1241,13,15,1016,930,0.4642857142857143,86,0.5220966084275437
2002,1242,27,3,2508,223,0.9,2285,0.9183449285975833
2002,1243,12,16,863,1047,0.42857142857142855,-184,0.4518324607329843
2002,1245,26,5,2032,323,0.8387096774193549,1709,0.8628450106157113
2002,1246,19,9,1473,631,0.6785714285714286,842,0.7000950570342205
2002,1247,15,17,1051,1077,0.46875,-26,0.49389097744360905
2002,1248,14,14,1087,929,0.5,158,0.5391865079365079
2002,1249,14,14,1048,915,0.5,133,0.5338767193071828
2002,1250,4,23,302,1476,0.14814814814814814,-1174,0.16985376827896512
2002,1251,2,23,164,1428,0.08,-1264,0.10301507537688442
2002,1253,11,17,833,1116,0.39285714285714285,-283,0.42739866598255516
2002,1254,5,22,464,1591,0.18518518518518517,-1127,0.22579075425790754
2002,1256,18,9,1324,600,0.6666666666666666,724,0.6881496881496881
2002,1257,18,12,1524,779,0.6,745,0.6617455492835432
2002,1258,8,20,629,1292,0.2857142857142857,-663,0.3274336283185841
2002,1259,5,23,353,1296,0.17857142857142858,-943,0.21406913280776227
2002,1260,15,13,1136,871,0.5357142857142857,265,0.5660189337319382
2002,1261,17,14,1295,837,0.5483870967741935,458,0.6074108818011257
2002,1263,11,18,764,1071,0.3793103448275862,-307,0.41634877384196184
2002,1264,20,8,1575,532,0.7142857142857143,1043,0.7475083056478405
2002,1265,19,9,1474,605,0.6785714285714286,869,0.708994708994709
2002,1266,26,6,1973,371,0.8125,1602,0.8417235494880546
2002,1267,13,15,1094,1045,0.4642857142857143,49,0.5114539504441328
2002,1268,26,4,2276,283,0.8666666666666667,1993,0.889409925752247
2002,1269,13,16,889,976,0.4482758620689655,-87,0.4766756032171582
2002,1270,20,8,1407,549,0.7142857142857143,858,0.7193251533742331
2002,1271,11,18,790,1120,0.3793103448275862,-330,0.41361256544502617
2002,1272,21,9,1790,612,0.7,1178,0.7452123230641132
2002,1273,5,23,384,1467,0.17857142857142858,-1083,0.20745542949756887
2002,1274,24,7,1843,472,0.7741935483870968,1371,0.7961123110151188
2002,1275,13,18,950,1031,0.41935483870967744,-81,0.4795557799091368
2002,1276,10,18,750,1110,0.35714285714285715,-360,0.4032258064516129
2002,1277,18,11,1329,682,0.6206896551724138,647,0.6608652411735455
2002,1278,17,12,1423,745,0.5862068965517241,678,0.6563653136531366
2002,1279,18,10,1361,663,0.6428571428571429,698,0.6724308300395256
2002,1280,26,7,2015,433,0.7878787878787878,1582,0.8231209150326797
2002,1281,21,11,1750,794,0.65625,956,0.6878930817610063
2002,1282,15,11,983,658,0.5769230769230769,325,0.599024984765387
2002,1283,17,15,1233,1034,0.53125,199,0.5438906043228937
2002,1284,18,12,1344,708,0.6,636,0.6549707602339181
2002,1285,14,14,1109,895,0.5,214,0.5533932135728543
2002,1286,16,9,1180,565,0.64,615,0.6762177650429799
2002,1287,14,11,1136,752,0.56,384,0.6016949152542372
2002,1288,3,25,226,1604,0.10714285714285714,-1378,0.12349726775956284
2002,1289,2,22,145,1210,0.08333333333333333,-1065,0.1070110701107011
2002,1290,11,16,955,1117,0.4074074074074074,-162,0.4609073359073359
2002,1291,3,24,172,1468,0.1111111111111111,-1296,0.1048780487804878
2002,1292,12,15,843,893,0.4444444444444444,-50,0.48559907834101385
2002,1293,17,11,1407,764,0.6071428571428571,643,0.6480884385076002
2002,1296,11,16,913,1174,0.4074074074074074,-261,0.43747005270723527
2002,1298,9,20,730,1274,0.3103448275862069,-544,0.36427145708582837
2002,1299,10,17,740,1078,0.37037037037037035,-338,0.40704070407040704
2002,1301,22,10,1772,650,0.6875,1122,0.731626754748142
2002,1304,12,15,918,970,0.4444444444444444,-52,0.486228813559322
2002,1305,16,13,1260,865,0.5517241379310345,395,0.5929411764705882
2002,1306,10,17,768,1071,0.37037037037037035,-303,0.4176182707993475
2002,1307,16,13,1217,927,0.5517241379310345,290,0.5676305970149254
2002,1308,18,11,1435,777,0.6206896551724138,658,0.6487341772151899
2002,1309,13,14,911,856,0.48148148148148145,55,0.5155631013016412
2002,1310,18,14,1375,994,0.5625,381,0.5804136766568172
2002,1311,1,25,61,1475,0.038461538461538464,-1414,0.039713541666666664
2002,1313,10,19,740,1257,0.3448275862068966,-517,0.37055583375062595
2002,1314,8,20,714,1308,0.2857142857142857,-594,0.35311572700296734
2002,1317,12,13,975,925,0.48,50,0.5131578947368421
2002,1318,7,21,545,1444,0.25,-899,0.2740070387129211
2002,1319,11,14,859,812,0.44,47,0.514063435068821
2002,1320,14,15,1080,976,0.4827586206896552,104,0.5252918287937743
2002,1321,16,13,1017,712,0.5517241379310345,305,0.5882012724117988
2002,1322,12,18,959,1200,0.4,-241,0.444187123668365
2002,1323,20,10,1647,697,0.6666666666666666,950,0.7026450511945392
2002,1324,16,12,1312,789,0.5714285714285714,523,0.6244645406949072
2002,1325,17,11,1365,739,0.6071428571428571,626,0.6487642585551331
2002,1326,23,7,1750,476,0.7666666666666667,1274,0.7861635220125787
2002,1328,27,4,2152,273,0.8709677419354839,1879,0.8874226804123712
2002,1329,23,8,1754,478,0.7419354838709677,1276,0.78584229390681
2002,1330,13,16,892,1055,0.4482758620689655,-163,0.45814072932717
2002,1331,17,13,1434,854,0.5666666666666667,580,0.6267482517482518
2002,1332,22,8,1936,656,0.7333333333333333,1280,0.7469135802469136
2002,1333,9,17,636,1010,0.34615384615384615,-374,0.3863912515188335
2002,1334,18,10,1287,657,0.6428571428571429,630,0.6620370370370371
2002,1335,25,6,1858,409,0.8064516129032258,1449,0.819585355094839
2002,1336,7,21,483,1294,0.25,-811,0.2718064153066967
2002,1337,21,8,1752,595,0.7241379310344828,1157,0.7464848743076268
2002,1338,26,5,1910,326,0.8387096774193549,1584,0.8542039355992844
2002,1339,6,24,450,1704,0.2,-1254,0.20891364902506965
2002,1340,11,16,891,1068,0.4074074074074074,-177,0.4548238897396631
2002,1341,9,19,734,1283,0.32142857142857145,-549,0.3639067922657412
2002,1343,15,11,941,595,0.5769230769230769,346,0.6126302083333334
2002,1344,15,16,1154,1059,0.4838709677419355,95,0.5214640759150474
2002,1345,13,18,1040,1165,0.41935483870967744,-125,0.47165532879818595
2002,1346,14,16,1189,1181,0.4666666666666667,8,0.5016877637130802
2002,1347,14,16,1065,1050,0.4666666666666667,15,0.5035460992907801
2002,1348,8,20,544,1187,0.2857142857142857,-643,0.3142692085499711
2002,1349,10,19,734,1173,0.3448275862068966,-439,0.3848977451494494
2002,1350,19,13,1264,746,0.59375,518,0.6288557213930348
2002,1351,17,11,1284,695,0.6071428571428571,589,0.6488125315816069
2002,1352,12,18,908,1168,0.4,-260,0.4373795761078998
2002,1353,18,12,1295,737,0.6,558,0.6373031496062992
2002,1354,14,15,997,1003,0.4827586206896552,-6,0.4985
2002,1356,26,7,2011,494,0.7878787878787878,1517,0.8027944111776447
2002,1357,8,20,718,1390,0.2857142857142857,-672,0.340607210626186
2002,1358,14,14,1127,963,0.5,164,0.5392344497607655
2002,1359,15,14,992,763,0.5172413793103449,229,0.5652421652421652
2002,1360,14,13,1089,930,0.5185185185185185,159,0.5393759286775631
2002,1361,18,11,1344,777,0.6206896551724138,567,0.6336633663366337
2002,1362,11,14,858,900,0.44,-42,0.4880546075085324
2002,1363,9,20,602,1177,0.3103448275862069,-575,0.33839235525576167
2002,1364,19,10,1305,629,0.6551724137931034,676,0.6747673216132368
2002,1365,12,15,835,956,0.4444444444444444,-121,0.46621998883305416
2002,1368,6,20,385,1069,0.23076923076923078,-684,0.26478679504814306
2002,1369,4,21,356,1432,0.16,-1076,0.19910514541387025
2002,1371,11,18,852,1189,0.3793103448275862,-337,0.4174424301812837
2002,1372,12,15,871,834,0.4444444444444444,37,0.510850439882698
2002,1373,16,18,1182,1184,0.47058823529411764,-2,0.4995773457311919
2002,1374,14,14,1020,1007,0.5,13,0.5032067094227923
2002,1375,5,20,363,1237,0.2,-874,0.226875
2002,1376,17,14,1256,838,0.5483870967741935,418,0.5998089780324737
2002,1378,19,12,1530,844,0.6129032258064516,686,0.6444818871103623
2002,1379,9,17,648,964,0.34615384615384615,-316,0.40198511166253104
2002,1380,7,19,603,1347,0.2692307692307692,-744,0.30923076923076925
2002,1381,9,16,608,986,0.36,-378,0.38143036386449186
2002,1382,17,12,1431,919,0.5862068965517241,512,0.6089361702127659
2002,1383,18,11,1528,799,0.6206896551724138,729,0.6566394499355394
2002,1384,6,21,418,1284,0.2222222222222222,-866,0.245593419506463
2002,1385,20,11,1506,674,0.6451612903225806,832,0.6908256880733945
2002,1386,18,11,1422,812,0.6206896551724138,610,0.6365264100268576
2002,1387,15,16,1079,876,0.4838709677419355,203,0.5519181585677749
2002,1388,8,20,543,1132,0.2857142857142857,-589,0.32417910447761195
2002,1389,4,24,306,1518,0.14285714285714285,-1212,0.16776315789473684
2002,1390,19,9,1597,676,0.6785714285714286,921,0.702595688517378
2002,1391,8,16,655,1069,0.3333333333333333,-414,0.3799303944315545
2002,1392,6,22,388,1317,0.21428571428571427,-929,0.22756598240469209
2002,1393,20,11,1563,723,0.6451612903225806,840,0.6837270341207349
2002,1395,14,15,1232,1220,0.4827586206896552,12,0.5024469820554649
2002,1396,15,14,1140,891,0.5172413793103449,249,0.5612998522895125
2002,1397,14,16,1031,1118,0.4666666666666667,-87,0.47975802698929737
2002,1398,8,17,665,1236,0.32,-571,0.3498158863755918
2002,1399,21,6,1685,417,0.7777777777777778,1268,0.801617507136061
2002,1400,19,11,1550,810,0.6333333333333333,740,0.6567796610169492
2002,1401,8,22,556,1368,0.26666666666666666,-812,0.288981288981289
2002,1402,10,16,780,1102,0.38461538461538464,-322,0.41445270988310307
2002,1403,23,8,1923,541,0.7419354838709677,1382,0.7804383116883117
2002,1404,10,14,795,994,0.4166666666666667,-199,0.44438233650083847
2002,1405,15,14,1088,851,0.5172413793103449,237,0.5611139762764311
2002,1406,11,18,702,992,0.3793103448275862,-290,0.41440377804014167
2002,1407,18,10,1440,669,0.6428571428571429,771,0.6827880512091038
2002,1408,12,15,926,1004,0.4444444444444444,-78,0.47979274611398964
2002,1409,25,6,2014,471,0.8064516129032258,1543,0.8104627766599598
2002,1410,12,8,932,515,0.6,417,0.6440912232204561
2002,1411,11,17,871,1071,0.39285714285714285,-200,0.44850669412976313
2002,1412,13,17,1006,1104,0.43333333333333335,-98,0.4767772511848341
2002,1414,19,10,1398,614,0.6551724137931034,784,0.694831013916501
2002,1415,7,18,525,1082,0.28,-557,0.3266957062850031
2002,1416,16,12,1306,851,0.5714285714285714,455,0.6054705609643023
2002,1417,19,11,1467,751,0.6333333333333333,716,0.6614066726780884
2002,1418,18,10,1302,616,0.6428571428571429,686,0.6788321167883211
2002,1419,19,12,1480,694,0.6129032258064516,786,0.6807727690892365
2002,1420,20,9,1565,575,0.6896551724137931,990,0.7313084112149533
2002,1421,12,14,935,865,0.46153846153846156,70,0.5194444444444445
2002,1422,20,10,1531,645,0.6666666666666666,886,0.7035845588235294
2002,1423,22,9,1486,594,0.7096774193548387,892,0.7144230769230769
2002,1424,20,10,1670,674,0.6666666666666666,996,0.712457337883959
2002,1425,22,9,1765,640,0.7096774193548387,1125,0.7338877338877339
2002,1426,11,15,822,1134,0.4230769230769231,-312,0.42024539877300615
2002,1427,19,10,1528,701,0.6551724137931034,827,0.6855091969493046
2002,1428,19,8,1340,485,0.7037037037037037,855,0.7342465753424657
2002,1429,22,7,1508,400,0.7586206896551724,1108,0.790356394129979
2002,1431,8,22,625,1418,0.26666666666666666,-793,0.3059226627508566
2002,1433,20,11,1479,772,0.6451612903225806,707,0.657041314971124
2002,1434,24,7,1901,497,0.7741935483870968,1404,0.792743953294412
2002,1435,16,14,1261,902,0.5333333333333333,359,0.5829865926953306
2002,1436,21,8,1702,484,0.7241379310344828,1218,0.7785910338517841
2002,1437,17,12,1303,755,0.5862068965517241,548,0.6331389698736638
2002,1438,17,11,1429,812,0.6071428571428571,617,0.6376617581436859
2002,1439,10,18,760,1183,0.35714285714285715,-423,0.39114770972722596
2002,1440,7,18,607,1283,0.28,-676,0.32116402116402115
2002,1441,8,16,625,1185,0.3333333333333333,-560,0.3453038674033149
2002,1442,10,16,791,1066,0.38461538461538464,-275,0.42595584275713516
2002,1443,26,3,1996,224,0.896551724137931,1772,0.8990990990990991
2002,1444,17,13,1316,890,0.5666666666666667,426,0.5965548504079783
2002,1447,19,9,1623,672,0.6785714285714286,951,0.7071895424836602
2002,1448,20,12,1699,920,0.625,779,0.6487208858342879
2002,1449,10,18,803,1203,0.35714285714285715,-400,0.4002991026919242
2002,1450,6,21,528,1372,0.2222222222222222,-844,0.27789473684210525
2002,1451,15,11,1171,721,0.5769230769230769,450,0.61892177589852
2002,1452,7,20,576,1364,0.25925925925925924,-788,0.29690721649484536
2002,1453,8,21,572,1321,0.27586206896551724,-749,0.3021658742736397
2002,1454,13,13,1028,910,0.5,118,0.5304437564499485
2002,1455,15,15,1231,955,0.5,276,0.5631290027447392
2002,1456,9,19,613,1144,0.32142857142857145,-531,0.34889015367103016
2002,1457,15,11,1130,660,0.5769230769230769,470,0.6312849162011173
2002,1458,17,12,1235,694,0.5862068965517241,541,0.6402280974598238
2002,1459,7,18,485,1093,0.28,-608,0.3073510773130545
2002,1460,16,11,1249,740,0.5925925925925926,509,0.6279537456008044
2002,1461,20,8,1568,538,0.7142857142857143,1030,0.7445394112060779
2002,1462,25,5,1866,316,0.8333333333333334,1550,0.8551787351054079
2002,1463,20,8,1540,575,0.7142857142857143,965,0.7281323877068558
2002,1464,3,23,231,1400,0.11538461538461539,-1169,0.14163090128755365
2002,3102,3,22,220,1219,0.12,-999,0.15288394718554552
2002,3103,1,27,72,1479,0.03571428571428571,-1407,0.04642166344294004
2002,3104,16,11,1240,726,0.5925925925925926,514,0.6307222787385555
2002,3105,11,16,781,942,0.4074074074074074,-161,0.4532791642484039
2002,3106,22,7,1704,425,0.7586206896551724,1279,0.8003757632691404
2002,3107,4,22,246,1257,0.15384615384615385,-1011,0.16367265469061876
2002,3108,13,12,851,672,0.52,179,0.5587655942219304
2002,3110,12,15,922,974,0.4444444444444444,-52,0.48628691983122363
2002,3111,10,19,764,1228,0.3448275862068966,-464,0.38353413654618473
2002,3112,14,14,1137,939,0.5,198,0.5476878612716763
2002,3113,24,8,1660,475,0.75,1185,0.7775175644028103
2002,3114,8,19,568,1016,0.2962962962962963,-448,0.35858585858585856
2002,3115,6,18,358,862,0.25,-504,0.2934426229508197
2002,3116,19,10,1469,631,0.6551724137931034,838,0.6995238095238095
2002,3117,10,16,702,968,0.38461538461538464,-266,0.42035928143712575
2002,3119,10,17,708,1022,0.37037037037037035,-314,0.4092485549132948
2002,3120,15,12,1137,688,0.5555555555555556,449,0.623013698630137
2002,3122,18,11,1419,750,0.6206896551724138,669,0.6542185338865837
2002,3123,22,6,1775,391,0.7857142857142857,1384,0.8194829178208679
2002,3124,26,5,2077,340,0.8387096774193549,1737,0.8593297476210178
2002,3125,18,9,1409,622,0.6666666666666666,787,0.6937469226981783
2002,3126,14,11,966,605,0.56,361,0.6148949713558243
2002,3127,16,11,1044,579,0.5925925925925926,465,0.6432532347504621
2002,3128,14,11,873,622,0.56,251,0.5839464882943144
2002,3129,10,20,690,1103,0.3333333333333333,-413,0.384829894032348
2002,3130,23,7,1663,389,0.7666666666666667,1274,0.8104288499025342
2002,3131,17,11,1223,614,0.6071428571428571,609,0.6657593903102885
2002,3132,8,19,570,1141,0.2962962962962963,-571,0.3331385154880187
2002,3133,15,12,1113,757,0.5555555555555556,356,0.5951871657754011
2002,3135,5,20,339,1117,0.2,-778,0.23282967032967034
2002,3137,20,8,1540,521,0.7142857142857143,1019,0.7472100921882582
2002,3138,9,18,541,951,0.3333333333333333,-410,0.3626005361930295
2002,3139,3,26,233,1544,0.10344827586206896,-1311,0.13111986494091166
2002,3140,22,8,1654,521,0.7333333333333333,1133,0.7604597701149425
2002,3141,8,18,551,1032,0.3076923076923077,-481,0.34807327858496523
2002,3142,10,16,693,960,0.38461538461538464,-267,0.4192377495462795
2002,3143,7,21,497,1092,0.25,-595,0.31277533039647576
2002,3144,13,15,891,908,0.4642857142857143,-17,0.4952751528627015
2002,3145,12,16,1071,1128,0.42857142857142855,-57,0.4870395634379263
2002,3147,5,18,386,944,0.21739130434782608,-558,0.29022556390977444
2002,3148,5,22,314,1004,0.18518518518518517,-690,0.23823975720789076
2002,3149,10,15,690,815,0.4,-125,0.4584717607973422
2002,3150,15,13,969,715,0.5357142857142857,254,0.5754156769596199
2002,3151,23,7,1819,458,0.7666666666666667,1361,0.7988581466842336
2002,3152,11,17,734,883,0.39285714285714285,-149,0.45392702535559676
2002,3153,25,4,1915,268,0.8620689655172413,1647,0.8772331653687586
2002,3155,17,11,1170,689,0.6071428571428571,481,0.6293706293706294
2002,3156,11,15,866,929,0.4230769230769231,-63,0.48245125348189416
2002,3157,9,17,610,859,0.34615384615384615,-249,0.41524846834581347
2002,3158,11,14,814,856,0.44,-42,0.4874251497005988
2002,3159,13,17,1054,1151,0.43333333333333335,-97,0.4780045351473923
2002,3160,21,9,1732,577,0.7,1155,0.7501082719792118
2002,3161,24,6,1776,362,0.8,1414,0.8306828811973808
2002,3162,10,14,703,872,0.4166666666666667,-169,0.44634920634920633
2002,3163,33,0,2894,0,1.0,2894,1.0
2002,3164,13,13,825,711,0.5,114,0.537109375
2002,3165,14,12,939,771,0.5384615384615384,168,0.5491228070175439
2002,3166,24,6,1772,369,0.8,1403,0.8276506305464736
2002,3168,4,24,269,1291,0.14285714285714285,-1022,0.17243589743589743
2002,3169,2,23,154,1362,0.08,-1208,0.10158311345646438
2002,3171,11,16,833,993,0.4074074074074074,-160,0.45618838992332966
2002,3172,10,18,754,1207,0.35714285714285715,-453,0.3844977052524222
2002,3173,11,16,856,969,0.4074074074074074,-113,0.469041095890411
2002,3174,23,6,1623,323,0.7931034482758621,1300,0.8340184994861254
2002,3175,9,19,540,947,0.32142857142857145,-407,0.36314727639542704
2002,3176,16,13,1138,889,0.5517241379310345,249,0.5614208189442526
2002,3177,13,13,967,792,0.5,175,0.5497441728254691
2002,3178,15,14,1087,846,0.5172413793103449,241,0.5623383341955509
2002,3179,23,7,1751,458,0.7666666666666667,1293,0.7926663648709823
2002,3180,14,15,1030,900,0.4827586206896552,130,0.533678756476684
2002,3181,27,3,2327,214,0.9,2113,0.9157811885084612
2002,3182,14,15,1054,924,0.4827586206896552,130,0.5328614762386249
2002,3183,6,20,419,1175,0.23076923076923078,-756,0.26286072772898367
2002,3184,20,8,1695,551,0.7142857142857143,1144,0.7546749777382012
2002,3185,16,11,1111,694,0.5925925925925926,417,0.6155124653739612
2002,3186,10,15,670,822,0.4,-152,0.44906166219839144
2002,3187,6,21,378,1189,0.2222222222222222,-811,0.2412252712188896
2002,3189,14,11,935,651,0.56,284,0.5895334174022698
2002,3190,9,18,729,1192,0.3333333333333333,-463,0.3794898490369599
2002,3191,15,15,1128,945,0.5,183,0.5441389290882779
2002,3192,14,13,1050,768,0.5185185185185185,282,0.5775577557755776
2002,3193,13,16,1001,1026,0.4482758620689655,-25,0.4938332511100148
2002,3194,17,14,1384,1032,0.5483870967741935,352,0.5728476821192053
2002,3196,18,10,1388,598,0.6428571428571429,790,0.6988922457200403
2002,3197,11,18,773,986,0.3793103448275862,-213,0.4394542353610006
2002,3198,25,5,1938,305,0.8333333333333334,1633,0.8640213999108337
2002,3199,13,14,1006,884,0.48148148148148145,122,0.5322751322751322
2002,3200,5,24,336,1308,0.1724137931034483,-972,0.20437956204379562
2002,3201,8,20,599,1133,0.2857142857142857,-534,0.34584295612009236
2002,3202,17,12,1231,799,0.5862068965517241,432,0.6064039408866995
2002,3203,20,8,1404,478,0.7142857142857143,926,0.7460148777895855
2002,3204,13,14,1024,870,0.48148148148148145,154,0.5406546990496304
2002,3205,3,22,204,1290,0.12,-1086,0.13654618473895583
2002,3206,17,14,1203,740,0.5483870967741935,463,0.6191456510550695
2002,3207,11,16,775,906,0.4074074074074074,-131,0.46103509815585964
2002,3208,19,10,1416,598,0.6551724137931034,818,0.7030784508440914
2002,3209,21,9,1528,621,0.7,907,0.7110283852954863
2002,3210,14,13,1081,815,0.5185185185185185,266,0.5701476793248945
2002,3211,8,18,608,1171,0.3076923076923077,-563,0.34176503653738055
2002,3212,17,9,1284,576,0.6538461538461539,708,0.6903225806451613
2002,3214,17,14,1173,853,0.5483870967741935,320,0.5789733464955578
2002,3216,15,14,968,817,0.5172413793103449,151,0.542296918767507
2002,3217,21,6,1504,358,0.7777777777777778,1146,0.807733619763695
2002,3218,23,7,1539,380,0.7666666666666667,1159,0.801980198019802
2002,3219,12,15,874,960,0.4444444444444444,-86,0.4765539803707743
2002,3220,10,18,645,1024,0.35714285714285715,-379,0.3864589574595566
2002,3221,22,7,1723,479,0.7586206896551724,1244,0.7824704813805631
2002,3222,22,7,1608,430,0.7586206896551724,1178,0.78900883218842
2002,3224,19,10,1586,664,0.6551724137931034,922,0.7048888888888889
2002,3225,11,17,753,912,0.39285714285714285,-159,0.45225225225225224
2002,3226,9,16,688,1016,0.36,-328,0.40375586854460094
2002,3227,14,15,960,827,0.4827586206896552,133,0.5372132064913262
2002,3228,13,13,1038,894,0.5,144,0.5372670807453416
2002,3229,7,20,449,1125,0.25925925925925924,-676,0.2852604828462516
2002,3231,17,13,1257,774,0.5666666666666667,483,0.6189069423929099
2002,3232,11,16,798,1029,0.4074074074074074,-231,0.4367816091954023
2002,3233,8,21,545,1184,0.27586206896551724,-639,0.3152111046847889
2002,3234,17,10,1368,724,0.6296296296296297,644,0.6539196940726577
2002,3235,23,8,1833,575,0.7419354838709677,1258,0.7612126245847176
2002,3237,9,17,705,1044,0.34615384615384615,-339,0.40308747855917665
2002,3238,15,12,989,667,0.5555555555555556,322,0.5972222222222222
2002,3239,4,22,314,1206,0.15384615384615385,-892,0.20657894736842106
2002,3240,8,19,615,1148,0.2962962962962963,-533,0.3488372093023256
2002,3241,15,11,1067,571,0.5769230769230769,496,0.6514041514041514
2002,3242,3,25,232,1342,0.10714285714285714,-1110,0.1473951715374841
2002,3243,24,7,1912,417,0.7741935483870968,1495,0.8209531987977673
2002,3245,20,8,1536,489,0.7142857142857143,1047,0.7585185185185185
2002,3246,9,19,642,1171,0.32142857142857145,-529,0.3541092112520684
2002,3247,5,23,365,1371,0.17857142857142858,-1006,0.21025345622119815
2002,3248,3,26,211,1517,0.10344827586206896,-1306,0.12210648148148148
2002,3249,8,18,487,956,0.3076923076923077,-469,0.3374913374913375
2002,3250,11,16,747,981,0.4074074074074074,-234,0.4322916666666667
2002,3251,22,7,1521,386,0.7586206896551724,1135,0.7975878342947037
2002,3252,11,12,847,769,0.4782608695652174,78,0.5241336633663366
2002,3253,16,13,1296,827,0.5517241379310345,469,0.610456900612341
2002,3254,18,12,1350,667,0.6,683,0.6693108577094695
2002,3256,25,4,1988,245,0.8620689655172413,1743,0.890282131661442
2002,3257,16,11,1255,691,0.5925925925925926,564,0.6449126413155191
2002,3258,15,13,1035,807,0.5357142857142857,228,0.5618892508143323
2002,3259,12,17,862,1022,0.41379310344827586,-160,0.4575371549893843
2002,3260,15,14,1077,854,0.5172413793103449,223,0.5577421025375453
2002,3261,17,11,1355,691,0.6071428571428571,664,0.6622678396871945
2002,3263,14,11,937,652,0.56,285,0.5896790434235368
2002,3264,18,11,1238,655,0.6206896551724138,583,0.6539883782356049
2002,3265,11,16,839,992,0.4074074074074074,-153,0.4582195521572911
2002,3266,13,14,890,729,0.48148148148148145,161,0.5497220506485485
2002,3267,7,19,451,1045,0.2692307692307692,-594,0.3014705882352941
2002,3268,11,17,776,951,0.39285714285714285,-175,0.4493341053850608
2002,3269,12,18,787,939,0.4,-152,0.4559675550405562
2002,3270,6,21,374,1122,0.2222222222222222,-748,0.25
2002,3271,11,16,673,953,0.4074074074074074,-280,0.4138991389913899
2002,3272,10,17,726,1090,0.37037037037037035,-364,0.3997797356828194
2002,3273,16,13,1155,828,0.5517241379310345,327,0.5824508320726173
2002,3274,18,11,1255,647,0.6206896551724138,608,0.6598317560462671
2002,3275,19,11,1498,657,0.6333333333333333,841,0.6951276102088167
2002,3276,17,12,1278,814,0.5862068965517241,464,0.6108986615678776
2002,3277,15,11,986,681,0.5769230769230769,305,0.5914817036592681
2002,3278,21,7,1776,474,0.75,1302,0.7893333333333333
2002,3279,10,17,800,1085,0.37037037037037035,-285,0.4244031830238727
2002,3280,17,11,1444,750,0.6071428571428571,694,0.658158614402917
2002,3281,14,14,1062,794,0.5,268,0.572198275862069
2002,3282,6,21,413,1097,0.2222222222222222,-684,0.27350993377483446
2002,3283,16,12,1139,630,0.5714285714285714,509,0.6438665912945166
2002,3284,16,12,1161,732,0.5714285714285714,429,0.6133122028526149
2002,3285,17,10,1234,593,0.6296296296296297,641,0.675424192665572
2002,3286,17,9,1256,522,0.6538461538461539,734,0.7064116985376828
2002,3287,18,8,1475,553,0.6923076923076923,922,0.7273175542406312
2002,3288,2,25,128,1252,0.07407407407407407,-1124,0.0927536231884058
2002,3289,1,23,50,1234,0.041666666666666664,-1184,0.03894080996884735
2002,3290,1,22,55,1148,0.043478260869565216,-1093,0.0457190357439734
2002,3291,12,16,876,1068,0.42857142857142855,-192,0.4506172839506173
2002,3292,16,13,1249,838,0.5517241379310345,411,0.5984666986104457
2002,3293,9,17,637,1039,0.34615384615384615,-402,0.38007159904534604
2002,3296,17,11,1145,591,0.6071428571428571,554,0.6595622119815668
2002,3298,13,15,880,979,0.4642857142857143,-99,0.47337278106508873
2002,3299,4,24,245,1219,0.14285714285714285,-974,0.16734972677595628
2002,3301,14,15,957,878,0.4827586206896552,79,0.5215258855585831
2002,3304,14,16,1105,963,0.4666666666666667,142,0.5343326885880078
2002,3305,9,19,640,1026,0.32142857142857145,-386,0.38415366146458585
2002,3306,16,13,1069,781,0.5517241379310345,288,0.5778378378378378
2002,3307,21,8,1472,466,0.7241379310344828,1006,0.759545923632611
2002,3308,12,16,954,995,0.42857142857142855,-41,0.48948178553104155
2002,3309,11,17,769,996,0.39285714285714285,-227,0.43569405099150144
2002,3310,9,19,698,1183,0.32142857142857145,-485,0.37107921318447634
2002,3311,11,16,740,809,0.4074074074074074,-69,0.4777275661717237
2002,3313,22,8,1589,465,0.7333333333333333,1124,0.7736124634858812
2002,3314,23,8,1942,553,0.7419354838709677,1389,0.7783567134268538
2002,3317,19,8,1498,493,0.7037037037037037,1005,0.7523857358111502
2002,3318,6,22,463,1290,0.21428571428571427,-827,0.26411865373645177
2002,3319,15,11,1079,678,0.5769230769230769,401,0.614114968696642
2002,3320,14,16,1027,986,0.4666666666666667,41,0.5101838052657724
2002,3321,4,24,249,1413,0.14285714285714285,-1164,0.14981949458483754
2002,3322,21,6,1469,366,0.7777777777777778,1103,0.8005449591280654
2002,3323,19,9,1301,553,0.6785714285714286,748,0.7017259978425027
2002,3324,16,13,1122,755,0.5517241379310345,367,0.5977623867874268
2002,3325,13,16,1060,1067,0.4482758620689655,-7,0.4983544898918665
2002,3326,14,15,1149,901,0.4827586206896552,248,0.5604878048780488
2002,3328,25,3,1995,200,0.8928571428571429,1795,0.908883826879271
2002,3329,13,15,939,896,0.4642857142857143,43,0.511716621253406
2002,3330,25,5,1928,337,0.8333333333333334,1591,0.85121412803532
2002,3331,11,14,795,825,0.44,-30,0.49074074074074076
2002,3332,17,13,1268,863,0.5666666666666667,405,0.5950258094791178
2002,3333,15,14,1092,866,0.5172413793103449,226,0.557711950970378
2002,3334,19,11,1442,694,0.6333333333333333,748,0.6750936329588015
2002,3335,12,15,896,904,0.4444444444444444,-8,0.49777777777777776
2002,3336,21,11,1587,750,0.65625,837,0.6790757381258024
2002,3337,23,7,1738,470,0.7666666666666667,1268,0.7871376811594203
2002,3338,8,19,624,1180,0.2962962962962963,-556,0.3458980044345898
2002,3339,13,15,922,924,0.4642857142857143,-2,0.49945828819068255
2002,3340,11,17,778,947,0.39285714285714285,-169,0.4510144927536232
2002,3341,4,21,200,894,0.16,-694,0.18281535648994515
2002,3343,11,16,799,1002,0.4074074074074074,-203,0.4436424208772904
2002,3344,12,15,844,805,0.4444444444444444,39,0.5118253486961795
2002,3345,23,5,1743,314,0.8214285714285714,1429,0.8473505104521147
2002,3346,13,14,957,913,0.48148148148148145,44,0.5117647058823529
2002,3347,12,14,787,761,0.46153846153846156,26,0.5083979328165374
2002,3348,15,13,1014,732,0.5357142857142857,282,0.5807560137457045
2002,3349,21,8,1432,417,0.7241379310344828,1015,0.7744726879394267
2002,3350,14,16,1206,1149,0.4666666666666667,57,0.5121019108280255
2002,3351,7,20,517,1303,0.25925925925925924,-786,0.28406593406593406
2002,3352,3,22,281,1277,0.12,-996,0.1803594351732991
2002,3353,8,20,500,1060,0.2857142857142857,-560,0.32051282051282054
2002,3354,18,11,1190,630,0.6206896551724138,560,0.6538461538461539
2002,3356,6,21,413,1200,0.2222222222222222,-787,0.2560446373217607
2002,3357,17,11,1215,593,0.6071428571428571,622,0.6720132743362832
2002,3358,3,23,214,1323,0.11538461538461539,-1109,0.13923227065712426
2002,3359,3,24,186,1384,0.1111111111111111,-1198,0.11847133757961784
2002,3360,13,15,958,898,0.4642857142857143,60,0.5161637931034483
2002,3361,10,16,701,839,0.38461538461538464,-138,0.4551948051948052
2002,3362,18,11,1266,725,0.6206896551724138,541,0.6358613761928679
2002,3363,17,11,1218,687,0.6071428571428571,531,0.6393700787401575
2002,3364,25,5,1973,337,0.8333333333333334,1636,0.8541125541125542
2002,3365,21,9,1645,635,0.7,1010,0.7214912280701754
2002,3366,4,20,255,994,0.16666666666666666,-739,0.20416333066453163
2002,3368,10,19,733,1057,0.3448275862068966,-324,0.4094972067039106
2002,3369,13,12,966,835,0.52,131,0.5363686840644086
2002,3371,15,14,1011,710,0.5172413793103449,301,0.5874491574665892
2002,3372,24,5,1800,238,0.8275862068965517,1562,0.8832188420019627
2002,3373,23,6,1759,388,0.7931034482758621,1371,0.8192827200745226
2002,3374,12,17,833,1001,0.41379310344827586,-168,0.4541984732824427
2002,3375,16,11,1078,605,0.5925925925925926,473,0.6405228758169934
2002,3376,22,6,1702,342,0.7857142857142857,1360,0.8326810176125244
2002,3378,13,13,1063,811,0.5,252,0.5672358591248666
2002,3379,11,16,690,841,0.4074074074074074,-151,0.45068582625734815
2002,3380,24,3,1672,188,0.8888888888888888,1484,0.8989247311827957
2002,3381,8,15,582,918,0.34782608695652173,-336,0.388
2002,3382,13,15,892,876,0.4642857142857143,16,0.504524886877828
2002,3383,5,23,368,1371,0.17857142857142858,-1003,0.21161587119033928
2002,3384,19,11,1395,653,0.6333333333333333,742,0.68115234375
2002,3385,4,23,282,1097,0.14814814814814814,-815,0.20449601160261058
2002,3386,23,7,1702,423,0.7666666666666667,1279,0.8009411764705883
2002,3387,13,15,832,833,0.4642857142857143,-1,0.4996996996996997
2002,3388,16,12,1205,803,0.5714285714285714,402,0.6000996015936255
2002,3389,25,5,1799,336,0.8333333333333334,1463,0.8426229508196721
2002,3390,30,2,2472,125,0.9375,2347,0.9518675394686177
2002,3391,13,15,907,906,0.4642857142857143,1,0.5002757859900717
2002,3392,16,13,1100,692,0.5517241379310345,408,0.6138392857142857
2002,3393,18,12,1360,716,0.6,644,0.6551059730250481
2002,3394,14,12,1046,736,0.5384615384615384,310,0.5869809203142536
2002,3395,22,6,1633,396,0.7857142857142857,1237,0.8048299655002464
2002,3396,19,10,1266,642,0.6551724137931034,624,0.6635220125786163
2002,3397,25,4,2060,277,0.8620689655172413,1783,0.881471972614463
2002,3398,3,22,230,1315,0.12,-1085,0.1488673139158576
2002,3399,22,7,1668,495,0.7586206896551724,1173,0.7711511789181692
2002,3400,20,9,1493,581,0.6896551724137931,912,0.7198649951783992
2002,3401,13,16,991,986,0.4482758620689655,5,0.5012645422357107
2002,3402,11,16,715,892,0.4074074074074074,-177,0.44492843808338517
2002,3403,18,11,1373,728,0.6206896551724138,645,0.6534983341266064
2002,3404,7,20,512,1297,0.25925925925925924,-785,0.2830292979546711
2002,3405,16,11,1151,681,0.5925925925925926,470,0.6282751091703057
2002,3406,2,25,123,1141,0.07407407407407407,-1018,0.09731012658227849
2002,3407,11,17,778,1001,0.39285714285714285,-223,0.43732433951658234
2002,3408,22,9,1601,523,0.7096774193548387,1078,0.7537664783427496
2002,3409,17,11,1211,612,0.6071428571428571,599,0.664289632473944
2002,3410,4,20,283,1158,0.16666666666666666,-875,0.1963913948646773
2002,3411,8,17,544,960,0.32,-416,0.3617021276595745
2002,3412,11,16,898,859,0.4074074074074074,39,0.5110984632896983
2002,3414,8,20,537,1158,0.2857142857142857,-621,0.3168141592920354
2002,3415,15,13,1070,780,0.5357142857142857,290,0.5783783783783784
2002,3416,17,13,1238,770,0.5666666666666667,468,0.6165338645418327
2002,3417,9,20,599,1113,0.3103448275862069,-514,0.34988317757009346
2002,3418,7,19,500,1024,0.2692307692307692,-524,0.32808398950131235
2002,3419,9,17,643,900,0.34615384615384615,-257,0.41672067401166557
2002,3420,12,14,804,743,0.46153846153846156,61,0.519715578539108
2002,3421,1,26,71,1410,0.037037037037037035,-1339,0.04794058068872384
2002,3422,21,9,1573,544,0.7,1029,0.7430325932923949
2002,3423,16,14,1104,743,0.5333333333333333,361,0.5977260422306443
2002,3424,21,7,1575,397,0.75,1178,0.7986815415821501
2002,3425,14,13,1046,859,0.5185185185185185,187,0.5490813648293963
2002,3426,14,14,986,731,0.5,255,0.5742574257425742
2002,3427,16,12,889,566,0.5714285714285714,323,0.6109965635738832
2002,3428,12,13,834,757,0.48,77,0.524198617221873
2002,3431,3,24,240,1391,0.1111111111111111,-1151,0.14714898835070508
2002,3433,14,14,1083,853,0.5,230,0.559400826446281
2002,3434,22,6,1521,318,0.7857142857142857,1203,0.8270799347471451
2002,3435,27,6,2078,349,0.8181818181818182,1729,0.8562010712814174
2002,3436,21,8,1504,468,0.7241379310344828,1036,0.7626774847870182
2002,3437,19,10,1261,506,0.6551724137931034,755,0.7136389360498019
2002,3438,16,11,1064,749,0.5925925925925926,315,0.5868725868725869
2002,3439,17,10,1218,552,0.6296296296296297,666,0.688135593220339
2002,3441,16,11,1205,639,0.5925925925925926,566,0.653470715835141
2002,3442,13,12,894,701,0.52,193,0.5605015673981191
2002,3443,16,13,1231,837,0.5517241379310345,394,0.5952611218568665
2002,3444,15,13,1151,842,0.5357142857142857,309,0.5775213246362267
2002,3447,14,15,957,895,0.4827586206896552,62,0.5167386609071274
2002,3448,12,16,838,863,0.42857142857142855,-25,0.49265138154027044
2002,3449,17,11,1332,714,0.6071428571428571,618,0.6510263929618768
2002,3450,2,27,135,1518,0.06896551724137931,-1383,0.08166969147005444
2002,3451,22,6,1611,365,0.7857142857142857,1246,0.8152834008097166
2002,3452,14,14,1028,780,0.5,248,0.5685840707964602
2002,3453,24,6,1824,380,0.8,1444,0.8275862068965517
2002,3454,19,8,1415,512,0.7037037037037037,903,0.7343020238713025
2002,3455,14,15,1100,985,0.4827586206896552,115,0.5275779376498801
2002,3456,12,16,907,981,0.42857142857142855,-74,0.4804025423728814
2002,3457,9,16,663,875,0.36,-212,0.43107932379713915
2002,3458,19,11,1438,696,0.6333333333333333,742,0.6738519212746017
2002,3459,14,13,1121,836,0.5185185185185185,285,0.5728155339805825
2002,3460,6,21,447,1166,0.2222222222222222,-719,0.27712337259764414
2002,3461,12,15,912,870,0.4444444444444444,42,0.5117845117845118
2002,3462,12,18,941,1106,0.4,-165,0.4596971177332682
2002,3463,14,13,1019,782,0.5185185185185185,237,0.5657967795669073
2002,3464,10,16,769,930,0.38461538461538464,-161,0.4526191877575044
2003,1102,12,16,825,778,0.42857142857142855,47,0.5146600124766063
2003,1103,13,14,1141,986,0.48148148148148145,155,0.536436295251528
2003,1104,17,11,1270,670,0.6071428571428571,600,0.654639175257732
2003,1105,7,19,556,1310,0.2692307692307692,-754,0.2979635584137192
2003,1106,13,15,888,893,0.4642857142857143,-5,0.4985962942167322
2003,1107,7,21,492,1354,0.25,-862,0.26652221018418204
2003,1108,14,19,1050,1230,0.42424242424242425,-180,0.4605263157894737
2003,1110,16,14,1147,844,0.5333333333333333,303,0.5760924158714213
2003,1111,16,10,1410,755,0.6153846153846154,655,0.651270207852194
2003,1112,25,3,2155,231,0.8928571428571429,1924,0.9031852472757753
2003,1113,18,11,1453,750,0.6206896551724138,703,0.6595551520653654
2003,1114,16,12,1150,811,0.5714285714285714,339,0.5864354920958694
2003,1115,4,24,260,1266,0.14285714285714285,-1006,0.17038007863695936
2003,1116,9,19,643,1083,0.32142857142857145,-440,0.3725376593279258
2003,1117,11,15,883,966,0.4230769230769231,-83,0.4775554353704705
2003,1119,3,22,209,1133,0.12,-924,0.1557377049180328
2003,1120,19,11,1442,661,0.6333333333333333,781,0.6856871136471707
2003,1122,20,7,1449,433,0.7407407407407407,1016,0.7699256110520722
2003,1123,13,17,1053,1146,0.43333333333333335,-93,0.47885402455661663
2003,1124,14,14,1070,862,0.5,208,0.5538302277432712
2003,1125,16,12,1217,812,0.5714285714285714,405,0.5998028585510103
2003,1126,8,22,588,1353,0.26666666666666666,-765,0.3029366306027821
2003,1127,14,13,1003,794,0.5185185185185185,209,0.5581524763494713
2003,1128,17,9,1226,538,0.6538461538461539,688,0.6950113378684807
2003,1129,12,16,853,992,0.42857142857142855,-139,0.46233062330623304
2003,1130,18,11,1525,785,0.6206896551724138,740,0.6601731601731602
2003,1131,20,10,1450,593,0.6666666666666666,857,0.7097405775819873
2003,1132,11,16,788,1007,0.4074074074074074,-219,0.43899721448467965
2003,1133,11,18,875,1222,0.3793103448275862,-347,0.4172627563185503
2003,1135,17,11,1375,696,0.6071428571428571,679,0.6639304683727668
2003,1137,13,15,800,815,0.4642857142857143,-15,0.4953560371517028
2003,1138,5,23,376,1439,0.17857142857142858,-1063,0.2071625344352617
2003,1139,24,5,1671,318,0.8275862068965517,1353,0.8401206636500754
2003,1140,23,8,1703,543,0.7419354838709677,1160,0.7582368655387355
2003,1141,23,6,1917,384,0.7931034482758621,1533,0.833116036505867
2003,1142,15,14,1065,893,0.5172413793103449,172,0.5439223697650664
2003,1143,21,8,1598,562,0.7241379310344828,1036,0.7398148148148148
2003,1144,4,22,331,1360,0.15384615384615385,-1029,0.19574216439976344
2003,1145,10,18,776,1191,0.35714285714285715,-415,0.39450940518556177
2003,1147,10,14,819,924,0.4166666666666667,-105,0.46987951807228917
2003,1148,15,13,1086,805,0.5357142857142857,281,0.5742993125330513
2003,1149,12,14,861,821,0.46153846153846156,40,0.5118906064209274
2003,1150,13,16,973,1012,0.4482758620689655,-39,0.490176322418136
2003,1151,19,9,1510,725,0.6785714285714286,785,0.6756152125279642
2003,1152,3,27,203,1693,0.1,-1490,0.1070675105485232
2003,1153,17,11,1233,652,0.6071428571428571,581,0.6541114058355437
2003,1154,4,20,301,1213,0.16666666666666666,-912,0.19881109643328929
2003,1155,15,13,1146,770,0.5357142857142857,376,0.5981210855949896
2003,1156,8,22,578,1391,0.26666666666666666,-813,0.2935500253936008
2003,1157,11,15,807,942,0.4230769230769231,-135,0.4614065180102916
2003,1158,22,7,1679,448,0.7586206896551724,1231,0.7893747061589093
2003,1159,12,14,849,864,0.46153846153846156,-15,0.4956217162872154
2003,1160,20,11,1627,714,0.6451612903225806,913,0.6950021358393849
2003,1161,17,13,1349,871,0.5666666666666667,478,0.6076576576576577
2003,1162,2,25,113,1227,0.07407407407407407,-1114,0.08432835820895522
2003,1163,21,9,1789,612,0.7,1177,0.7451062057476051
2003,1164,11,17,743,882,0.39285714285714285,-139,0.4572307692307692
2003,1165,8,18,547,1011,0.3076923076923077,-464,0.35109114249037227
2003,1166,29,4,2340,275,0.8787878787878788,2065,0.8948374760994264
2003,1168,10,19,665,1160,0.3448275862068966,-495,0.3643835616438356
2003,1169,13,15,1011,945,0.4642857142857143,66,0.5168711656441718
2003,1170,11,17,840,992,0.39285714285714285,-152,0.4585152838427948
2003,1171,7,19,464,1076,0.2692307692307692,-612,0.3012987012987013
2003,1172,14,10,1131,705,0.5833333333333334,426,0.6160130718954249
2003,1173,24,5,1770,341,0.8275862068965517,1429,0.8384651823780199
2003,1174,15,14,1094,896,0.5172413793103449,198,0.549748743718593
2003,1175,15,12,1050,630,0.5555555555555556,420,0.625
2003,1176,17,15,1253,1015,0.53125,238,0.5524691358024691
2003,1177,16,12,1151,726,0.5714285714285714,425,0.6132125732551944
2003,1178,17,12,1299,759,0.5862068965517241,540,0.6311953352769679
2003,1179,8,20,582,1203,0.2857142857142857,-621,0.32605042016806723
2003,1180,18,11,1322,668,0.6206896551724138,654,0.664321608040201
2003,1181,24,6,2016,443,0.8,1573,0.8198454656364376
2003,1182,9,21,646,1355,0.3,-709,0.32283858070964516
2003,1183,13,15,1090,1072,0.4642857142857143,18,0.5041628122109159
2003,1184,7,17,586,1206,0.2916666666666667,-620,0.32700892857142855
2003,1185,12,14,980,1018,0.46153846153846156,-38,0.4904904904904905
2003,1186,17,12,1275,754,0.5862068965517241,521,0.6283883686545096
2003,1187,10,15,721,854,0.4,-133,0.4577777777777778
2003,1189,10,15,672,888,0.4,-216,0.4307692307692308
2003,1190,17,10,1409,743,0.6296296296296297,666,0.6547397769516728
2003,1191,12,16,918,1042,0.42857142857142855,-124,0.4683673469387755
2003,1192,15,14,1185,921,0.5172413793103449,264,0.5626780626780626
2003,1193,19,11,1397,722,0.6333333333333333,675,0.659273242095328
2003,1194,6,21,451,1414,0.2222222222222222,-963,0.2418230563002681
2003,1196,24,7,1899,454,0.7741935483870968,1445,0.8070548236294093
2003,1197,17,12,1286,787,0.5862068965517241,499,0.6203569705740473
2003,1198,7,21,449,1228,0.25,-779,0.26774001192605845
2003,1199,14,15,1044,930,0.4827586206896552,114,0.5288753799392097
2003,1200,2,26,159,1651,0.07142857142857142,-1492,0.08784530386740332
2003,1201,20,8,1450,556,0.7142857142857143,894,0.7228315054835494
2003,1202,11,17,819,988,0.39285714285714285,-169,0.45323741007194246
2003,1203,12,17,875,1195,0.41379310344827586,-320,0.4227053140096618
2003,1204,13,13,1078,887,0.5,191,0.5486005089058524
2003,1205,4,24,303,1579,0.14285714285714285,-1276,0.16099893730074388
2003,1206,16,12,1115,679,0.5714285714285714,436,0.6215161649944259
2003,1207,15,14,1179,1034,0.5172413793103449,145,0.5327609579755987
2003,1208,19,8,1562,576,0.7037037037037037,986,0.7305893358278766
2003,1209,13,15,986,1064,0.4642857142857143,-78,0.48097560975609754
2003,1210,14,14,1153,921,0.5,232,0.555930568948891
2003,1211,23,8,1805,584,0.7419354838709677,1221,0.7555462536626203
2003,1212,10,18,817,1174,0.35714285714285715,-357,0.4103465595178302
2003,1214,19,11,1414,730,0.6333333333333333,684,0.6595149253731343
2003,1216,15,13,1047,759,0.5357142857142857,288,0.579734219269103
2003,1217,11,15,806,1030,0.4230769230769231,-224,0.43899782135076254
2003,1218,18,11,1373,652,0.6206896551724138,721,0.6780246913580247
2003,1219,7,20,532,1318,0.25925925925925924,-786,0.2875675675675676
2003,1220,8,21,563,1296,0.27586206896551724,-733,0.30285099515868746
2003,1221,25,4,1776,235,0.8620689655172413,1541,0.8831427150671308
2003,1222,8,20,505,1126,0.2857142857142857,-621,0.3096259963212753
2003,1224,13,17,1038,1158,0.43333333333333335,-120,0.4726775956284153
2003,1225,12,15,793,878,0.4444444444444444,-85,0.47456612806702575
2003,1226,13,14,974,932,0.48148148148148145,42,0.5110178384050367
2003,1227,21,8,1668,520,0.7241379310344828,1148,0.7623400365630713
2003,1228,24,6,1877,386,0.8,1491,0.8294299602297834
2003,1229,8,21,564,1309,0.27586206896551724,-745,0.3011211959423385
2003,1231,20,12,1509,748,0.625,761,0.6685866194062915
2003,1232,7,24,477,1272,0.22580645161290322,-795,0.2727272727272727
2003,1233,17,12,1360,814,0.5862068965517241,546,0.62557497700092
2003,1234,15,13,1071,876,0.5357142857142857,195,0.5500770416024653
2003,1235,15,13,1168,803,0.5357142857142857,365,0.5925925925925926
2003,1236,9,20,692,1285,0.3103448275862069,-593,0.35002529084471423
2003,1237,19,13,1434,846,0.59375,588,0.6289473684210526
2003,1238,10,18,772,1200,0.35714285714285715,-428,0.39148073022312374
2003,1239,12,16,891,945,0.42857142857142855,-54,0.4852941176470588
2003,1240,19,10,1562,613,0.6551724137931034,949,0.7181609195402299
2003,1241,12,17,857,1072,0.41379310344827586,-215,0.4442716433385174
2003,1242,23,7,1967,473,0.7666666666666667,1494,0.8061475409836065
2003,1243,13,17,1007,1082,0.43333333333333335,-75,0.4820488271900431
2003,1245,20,9,1579,643,0.6896551724137931,936,0.7106210621062106
2003,1246,29,3,2290,191,0.90625,2099,0.9230149133413946
2003,1247,12,17,894,1087,0.41379310344827586,-193,0.4512872286723877
2003,1248,11,16,764,1021,0.4074074074074074,-257,0.4280112044817927
2003,1249,12,14,820,865,0.46153846153846156,-45,0.486646884272997
2003,1250,14,12,939,721,0.5384615384615384,218,0.5656626506024096
2003,1251,14,15,979,921,0.4827586206896552,58,0.5152631578947369
2003,1252,6,18,526,1319,0.25,-793,0.2850948509485095
2003,1253,4,22,276,1351,0.15384615384615385,-1075,0.16963736939151813
2003,1254,9,19,760,1342,0.32142857142857145,-582,0.3615604186489058
2003,1256,10,15,797,905,0.4,-108,0.4682726204465335
2003,1257,24,6,2011,444,0.8,1567,0.8191446028513238
2003,1258,11,19,842,1269,0.36666666666666664,-427,0.3988630980577925
2003,1259,4,24,284,1369,0.14285714285714285,-1085,0.17180883242589232
2003,1260,15,16,1172,1137,0.4838709677419355,35,0.5075790385448246
2003,1261,21,10,1653,617,0.6774193548387096,1036,0.728193832599119
2003,1263,12,16,978,1009,0.42857142857142855,-31,0.4921992954202315
2003,1264,23,6,1793,416,0.7931034482758621,1377,0.8116794929832504
2003,1265,13,16,997,1072,0.4482758620689655,-75,0.4818753020782987
2003,1266,23,5,1823,372,0.8214285714285714,1451,0.8305239179954442
2003,1267,13,15,992,1022,0.4642857142857143,-30,0.4925521350546177
2003,1268,19,9,1603,659,0.6785714285714286,944,0.7086648983200707
2003,1269,10,18,715,1005,0.35714285714285715,-290,0.41569767441860467
2003,1270,13,14,956,894,0.48148148148148145,62,0.5167567567567568
2003,1271,5,23,378,1382,0.17857142857142858,-1004,0.21477272727272728
2003,1272,23,6,1721,440,0.7931034482758621,1281,0.7963905599259602
2003,1273,22,6,1818,368,0.7857142857142857,1450,0.8316559926806953
2003,1274,11,17,836,1120,0.39285714285714285,-284,0.4274028629856851
2003,1275,12,15,778,798,0.4444444444444444,-20,0.4936548223350254
2003,1276,17,13,1262,808,0.5666666666666667,454,0.6096618357487923
2003,1277,19,12,1343,741,0.6129032258064516,602,0.6444337811900192
2003,1278,16,12,1287,797,0.5714285714285714,490,0.6175623800383877
2003,1279,14,15,986,947,0.4827586206896552,39,0.5100879461976203
2003,1280,21,9,1547,558,0.7,989,0.734916864608076
2003,1281,21,10,1590,635,0.6774193548387096,955,0.7146067415730337
2003,1282,9,20,700,1268,0.3103448275862069,-568,0.3556910569105691
2003,1283,17,12,1141,790,0.5862068965517241,351,0.5908855515277058
2003,1284,15,13,1077,771,0.5357142857142857,306,0.5827922077922078
2003,1285,12,16,878,1074,0.42857142857142855,-196,0.44979508196721313
2003,1286,9,16,606,969,0.36,-363,0.38476190476190475
2003,1287,17,9,1461,606,0.6538461538461539,855,0.706821480406386
2003,1288,7,22,530,1447,0.2413793103448276,-917,0.2680829539706626
2003,1289,4,20,284,1162,0.16666666666666666,-878,0.19640387275242047
2003,1290,14,13,1124,927,0.5185185185185185,197,0.5480253534861044
2003,1291,11,16,754,961,0.4074074074074074,-207,0.43965014577259476
2003,1292,14,14,1033,880,0.5,153,0.5399895452169368
2003,1293,15,12,1238,783,0.5555555555555556,455,0.6125680356259278
2003,1296,17,14,1237,921,0.5483870967741935,316,0.5732159406858202
2003,1298,7,19,486,1069,0.2692307692307692,-583,0.312540192926045
2003,1299,1,25,61,1521,0.038461538461538464,-1460,0.038558786346396964
2003,1301,18,12,1402,770,0.6,632,0.64548802946593
2003,1304,11,18,769,1070,0.3793103448275862,-301,0.4181620445894508
2003,1305,17,13,1324,965,0.5666666666666667,359,0.5784185233726518
2003,1306,5,23,348,1486,0.17857142857142858,-1138,0.18974918211559433
2003,1307,9,18,666,1213,0.3333333333333333,-547,0.3544438531133582
2003,1308,19,9,1449,598,0.6785714285714286,851,0.7078651685393258
2003,1309,13,14,985,892,0.48148148148148145,93,0.5247735748534896
2003,1310,17,12,1321,842,0.5862068965517241,479,0.6107258437355525
2003,1311,2,25,110,1332,0.07407407407407407,-1222,0.07628294036061026
2003,1313,14,15,950,876,0.4827586206896552,74,0.52026286966046
2003,1314,17,15,1259,1018,0.53125,241,0.5529205094422486
2003,1317,5,21,398,1397,0.19230769230769232,-999,0.22172701949860724
2003,1318,14,15,1073,1020,0.4827586206896552,53,0.5126612517916865
2003,1319,13,13,1005,859,0.5,146,0.5391630901287554
2003,1320,10,17,719,1040,0.37037037037037035,-321,0.40875497441728254
2003,1321,12,17,838,978,0.41379310344827586,-140,0.46145374449339205
2003,1322,6,21,429,1253,0.2222222222222222,-824,0.2550535077288942
2003,1323,22,9,1799,684,0.7096774193548387,1115,0.7245267821184052
2003,1324,15,11,1247,765,0.5769230769230769,482,0.6197813121272365
2003,1325,14,16,1074,1065,0.4666666666666667,9,0.5021037868162693
2003,1326,17,14,1195,802,0.5483870967741935,393,0.5983975963945919
2003,1328,24,6,1798,337,0.8,1461,0.8421545667447307
2003,1329,20,9,1468,525,0.6896551724137931,943,0.7365780230807827
2003,1330,12,15,874,925,0.4444444444444444,-51,0.4858254585881045
2003,1331,17,10,1357,700,0.6296296296296297,657,0.6596985901798736
2003,1332,23,9,2004,627,0.71875,1377,0.7616875712656784
2003,1333,12,15,856,966,0.4444444444444444,-110,0.4698133918770582
2003,1334,12,16,867,979,0.42857142857142855,-112,0.4696641386782232
2003,1335,22,5,1598,297,0.8148148148148148,1301,0.8432717678100264
2003,1336,7,21,488,1278,0.25,-790,0.27633069082672707
2003,1337,15,13,1260,935,0.5357142857142857,325,0.5740318906605922
2003,1338,26,4,1981,257,0.8666666666666667,1724,0.8851653261840929
2003,1339,10,17,701,1125,0.37037037037037035,-424,0.3838992332968237
2003,1340,4,21,284,1142,0.16,-858,0.19915848527349228
2003,1341,17,12,1228,814,0.5862068965517241,414,0.6013712047012733
2003,1343,15,11,991,705,0.5769230769230769,286,0.5843160377358491
2003,1344,16,13,1232,858,0.5517241379310345,374,0.5894736842105263
2003,1345,18,10,1423,586,0.6428571428571429,837,0.708312593330015
2003,1346,16,12,1230,851,0.5714285714285714,379,0.5910619894281596
2003,1347,10,20,671,1222,0.3333333333333333,-551,0.3544638140517697
2003,1348,18,11,1336,713,0.6206896551724138,623,0.6520253782332845
2003,1349,17,10,1301,666,0.6296296296296297,635,0.6614133197763091
2003,1350,15,13,1081,759,0.5357142857142857,322,0.5875
2003,1351,12,16,814,1061,0.42857142857142855,-247,0.4341333333333333
2003,1352,9,17,666,1178,0.34615384615384615,-512,0.3611713665943601
2003,1353,12,16,856,1038,0.42857142857142855,-182,0.45195353748680045
2003,1354,20,10,1539,645,0.6666666666666666,894,0.7046703296703297
2003,1356,24,6,1833,403,0.8,1430,0.8197674418604651
2003,1357,7,21,520,1410,0.25,-890,0.2694300518134715
2003,1358,21,6,1523,415,0.7777777777777778,1108,0.7858617131062952
2003,1359,12,15,844,859,0.4444444444444444,-15,0.49559600704638873
2003,1360,17,11,1342,749,0.6071428571428571,593,0.6417981826877093
2003,1361,14,13,1025,918,0.5185185185185185,107,0.5275347400926402
2003,1362,14,14,1081,864,0.5,217,0.5557840616966581
2003,1363,5,21,337,1336,0.19230769230769232,-999,0.20143454871488345
2003,1364,18,13,1200,804,0.5806451612903226,396,0.5988023952095808
2003,1365,12,15,831,903,0.4444444444444444,-72,0.47923875432525953
2003,1366,3,24,203,1461,0.1111111111111111,-1258,0.1219951923076923
2003,1368,9,16,628,976,0.36,-348,0.3915211970074813
2003,1369,9,19,700,1279,0.32142857142857145,-579,0.35371399696816574
2003,1371,17,12,1227,742,0.5862068965517241,485,0.6231589639410868
2003,1372,19,8,1412,490,0.7037037037037037,922,0.7423764458464774
2003,1373,19,10,1469,713,0.6551724137931034,756,0.6732355637030247
2003,1374,17,13,1326,859,0.5666666666666667,467,0.6068649885583524
2003,1375,12,14,895,934,0.46153846153846156,-39,0.48933843630399126
2003,1376,12,16,866,973,0.42857142857142855,-107,0.47090810222947255
2003,1378,14,14,1026,876,0.5,150,0.5394321766561514
2003,1379,13,16,959,980,0.4482758620689655,-21,0.49458483754512633
2003,1380,7,20,485,1330,0.25925925925925924,-845,0.26721763085399447
2003,1381,9,17,656,1083,0.34615384615384615,-427,0.37722829212190917
2003,1382,13,14,1092,1054,0.48148148148148145,38,0.5088536812674743
2003,1383,14,16,1217,1064,0.4666666666666667,153,0.5335379219640508
2003,1384,14,14,1012,900,0.5,112,0.5292887029288703
2003,1385,16,13,1200,870,0.5517241379310345,330,0.5797101449275363
2003,1386,23,6,1664,384,0.7931034482758621,1280,0.8125
2003,1387,16,13,1027,742,0.5517241379310345,285,0.5805539853024307
2003,1388,14,15,1026,897,0.4827586206896552,129,0.5335413416536662
2003,1389,10,19,787,1345,0.3448275862068966,-558,0.3691369606003752
2003,1390,23,8,1712,528,0.7419354838709677,1184,0.7642857142857142
2003,1391,6,20,463,1393,0.23076923076923078,-930,0.2494612068965517
2003,1392,11,15,823,848,0.4230769230769231,-25,0.49251944943147813
2003,1393,24,5,2007,316,0.8275862068965517,1691,0.8639690055962118
2003,1394,11,15,887,1065,0.4230769230769231,-178,0.45440573770491804
2003,1395,9,19,794,1352,0.32142857142857145,-558,0.3699906803355079
2003,1396,15,15,1121,881,0.5,240,0.5599400599400599
2003,1397,17,11,1190,730,0.6071428571428571,460,0.6197916666666666
2003,1398,1,24,87,1718,0.04,-1631,0.0481994459833795
2003,1399,17,12,1373,761,0.5862068965517241,612,0.6433926897844423
2003,1400,22,6,1721,487,0.7857142857142857,1234,0.7794384057971014
2003,1401,14,14,1062,953,0.5,109,0.5270471464019851
2003,1402,15,12,1156,776,0.5555555555555556,380,0.598343685300207
2003,1403,18,12,1456,750,0.6,706,0.6600181323662738
2003,1404,10,14,818,962,0.4166666666666667,-144,0.45955056179775283
2003,1405,13,16,987,1047,0.4482758620689655,-60,0.48525073746312686
2003,1406,4,24,246,1345,0.14285714285714285,-1099,0.15461973601508486
2003,1407,25,5,2038,343,0.8333333333333334,1695,0.8559428811423772
2003,1408,15,15,1164,967,0.5,197,0.5462224307836696
2003,1409,22,9,1647,632,0.7096774193548387,1015,0.7226853883282142
2003,1410,6,20,389,1197,0.23076923076923078,-808,0.24527112232030265
2003,1411,18,12,1392,792,0.6,600,0.6373626373626373
2003,1412,18,12,1455,855,0.6,600,0.6298701298701299
2003,1414,19,9,1398,540,0.6785714285714286,858,0.7213622291021672
2003,1415,5,18,338,1165,0.21739130434782608,-827,0.22488356620093147
2003,1416,20,11,1543,681,0.6451612903225806,862,0.6937949640287769
2003,1417,10,19,842,1339,0.3448275862068966,-497,0.38606143970655665
2003,1418,19,9,1499,630,0.6785714285714286,869,0.7040864255519023
2003,1419,11,16,817,1111,0.4074074074074074,-294,0.4237551867219917
2003,1420,7,20,496,1207,0.25925925925925924,-711,0.2912507339988256
2003,1421,13,16,1034,1031,0.4482758620689655,3,0.500726392251816
2003,1422,6,22,462,1497,0.21428571428571427,-1035,0.23583460949464014
2003,1423,24,6,1774,367,0.8,1407,0.828584773470341
2003,1424,21,10,1632,711,0.6774193548387096,921,0.6965428937259923
2003,1425,13,17,1113,1182,0.43333333333333335,-69,0.4849673202614379
2003,1426,14,13,956,735,0.5185185185185185,221,0.5653459491425192
2003,1427,9,17,705,1015,0.34615384615384615,-310,0.40988372093023256
2003,1428,23,7,1586,416,0.7666666666666667,1170,0.7922077922077922
2003,1429,22,8,1515,464,0.7333333333333333,1051,0.7655381505811015
2003,1431,5,24,417,1400,0.1724137931034483,-983,0.2294991744634012
2003,1433,18,10,1415,658,0.6428571428571429,757,0.6825856246985046
2003,1434,20,10,1533,601,0.6666666666666666,932,0.718369259606373
2003,1435,11,18,869,1129,0.3793103448275862,-260,0.43493493493493496
2003,1436,19,10,1364,602,0.6551724137931034,762,0.6937945066124109
2003,1437,15,15,1201,965,0.5,236,0.5544783010156972
2003,1438,14,15,1101,1027,0.4827586206896552,74,0.5173872180451128
2003,1439,11,18,829,1207,0.3793103448275862,-378,0.4071709233791749
2003,1440,8,19,523,1196,0.2962962962962963,-673,0.30424665503199533
2003,1441,6,18,433,1239,0.25,-806,0.2589712918660287
2003,1442,5,21,383,1292,0.19230769230769232,-909,0.22865671641791044
2003,1443,23,8,1721,545,0.7419354838709677,1176,0.7594880847308032
2003,1444,19,10,1401,625,0.6551724137931034,776,0.6915103652517275
2003,1447,21,10,1614,728,0.6774193548387096,886,0.6891545687446626
2003,1448,24,5,1933,341,0.8275862068965517,1592,0.8500439753737907
2003,1449,10,17,811,1144,0.37037037037037035,-333,0.4148337595907928
2003,1450,7,20,541,1365,0.25925925925925924,-824,0.2838405036726128
2003,1451,25,4,1895,257,0.8620689655172413,1638,0.8805762081784386
2003,1452,14,15,995,942,0.4827586206896552,53,0.5136809499225606
2003,1453,9,19,673,1229,0.32142857142857145,-556,0.3538380651945321
2003,1454,23,7,1799,514,0.7666666666666667,1285,0.7777777777777778
2003,1455,18,11,1353,739,0.6206896551724138,614,0.6467495219885278
2003,1456,12,16,856,943,0.42857142857142855,-87,0.47581989994441354
2003,1457,18,10,1349,595,0.6428571428571429,754,0.6939300411522634
2003,1458,22,7,1622,429,0.7586206896551724,1193,0.7908337396392003
2003,1459,10,15,796,1044,0.4,-248,0.4326086956521739
2003,1460,9,18,653,1169,0.3333333333333333,-516,0.358397365532382
2003,1461,19,10,1446,668,0.6551724137931034,778,0.6840113528855251
2003,1462,25,5,2050,297,0.8333333333333334,1753,0.8734554750745632
2003,1463,13,13,968,804,0.5,164,0.54627539503386
2003,1464,7,20,462,1194,0.25925925925925924,-732,0.27898550724637683
2003,3102,6,20,445,1061,0.23076923076923078,-616,0.2954847277556441
2003,3103,2,26,132,1359,0.07142857142857142,-1227,0.08853118712273642
2003,3104,13,15,930,835,0.4642857142857143,95,0.5269121813031161
2003,3105,8,18,520,989,0.3076923076923077,-469,0.3445990722332671
2003,3106,19,10,1345,515,0.6551724137931034,830,0.7231182795698925
2003,3107,9,18,637,1019,0.3333333333333333,-382,0.38466183574879226
2003,3108,18,12,1307,726,0.6,581,0.6428922774225283
2003,3110,18,11,1253,635,0.6206896551724138,618,0.6636652542372882
2003,3111,9,19,674,1188,0.32142857142857145,-514,0.3619763694951665
2003,3112,22,8,1720,488,0.7333333333333333,1232,0.7789855072463768
2003,3113,15,13,1081,707,0.5357142857142857,374,0.604586129753915
2003,3114,4,23,299,1280,0.14814814814814814,-981,0.18936035465484483
2003,3115,3,23,211,1174,0.11538461538461539,-963,0.1523465703971119
2003,3116,21,10,1499,611,0.6774193548387096,888,0.7104265402843601
2003,3117,11,18,761,1113,0.3793103448275862,-352,0.40608324439701177
2003,3119,13,16,950,912,0.4482758620689655,38,0.5102040816326531
2003,3120,18,11,1271,667,0.6206896551724138,604,0.6558307533539731
2003,3122,26,3,1978,160,0.896551724137931,1818,0.9251637043966323
2003,3123,20,9,1646,660,0.6896551724137931,986,0.7137901127493496
2003,3124,20,10,1712,576,0.6666666666666666,1136,0.7482517482517482
2003,3125,18,10,1231,633,0.6428571428571429,598,0.6604077253218884
2003,3126,14,14,958,784,0.5,174,0.5499425947187141
2003,3127,10,17,651,951,0.37037037037037035,-300,0.40636704119850187
2003,3128,14,10,932,539,0.5833333333333334,393,0.6335825968728755
2003,3129,10,20,683,1103,0.3333333333333333,-420,0.3824188129899216
2003,3130,20,8,1481,494,0.7142857142857143,987,0.7498734177215189
2003,3131,16,14,1132,821,0.5333333333333333,311,0.579621095750128
2003,3132,12,16,861,949,0.42857142857142855,-88,0.47569060773480665
2003,3133,13,15,940,939,0.4642857142857143,1,0.5002660989888238
2003,3135,15,12,1084,710,0.5555555555555556,374,0.6042363433667781
2003,3137,13,15,1028,1001,0.4642857142857143,27,0.5066535239034007
2003,3138,18,11,1249,640,0.6206896551724138,609,0.6611964002117523
2003,3139,6,23,394,1419,0.20689655172413793,-1025,0.21731936017650302
2003,3140,19,11,1361,649,0.6333333333333333,712,0.6771144278606965
2003,3141,10,17,615,943,0.37037037037037035,-328,0.39473684210526316
2003,3142,9,17,641,1017,0.34615384615384615,-376,0.3866103739445115
2003,3143,10,19,661,1010,0.3448275862068966,-349,0.39557151406343505
2003,3144,8,19,546,1166,0.2962962962962963,-620,0.3189252336448598
2003,3145,16,14,1225,916,0.5333333333333333,309,0.572162540868753
2003,3147,3,20,211,1212,0.13043478260869565,-1001,0.1482782853127196
2003,3148,8,20,507,1043,0.2857142857142857,-536,0.3270967741935484
2003,3149,11,15,746,886,0.4230769230769231,-140,0.4571078431372549
2003,3150,21,8,1586,496,0.7241379310344828,1090,0.7617675312199808
2003,3151,26,4,1969,239,0.8666666666666667,1730,0.8917572463768116
2003,3152,13,16,881,886,0.4482758620689655,-5,0.4985851726089417
2003,3153,23,7,1693,446,0.7666666666666667,1247,0.7914913510986442
2003,3155,14,15,996,897,0.4827586206896552,99,0.526148969889065
2003,3156,11,18,887,1245,0.3793103448275862,-358,0.4160412757973734
2003,3157,11,15,780,864,0.4230769230769231,-84,0.4744525547445255
2003,3158,8,19,613,1163,0.2962962962962963,-550,0.34515765765765766
2003,3159,9,18,645,1093,0.3333333333333333,-448,0.3711162255466053
2003,3160,22,7,1584,361,0.7586206896551724,1223,0.8143958868894602
2003,3161,17,12,1232,679,0.5862068965517241,553,0.6446886446886447
2003,3162,11,16,737,929,0.4074074074074074,-192,0.44237695078031214
2003,3163,31,1,2334,48,0.96875,2286,0.9798488664987406
2003,3164,11,18,770,954,0.3793103448275862,-184,0.4466357308584687
2003,3165,10,17,692,946,0.37037037037037035,-254,0.42246642246642246
2003,3166,21,8,1606,538,0.7241379310344828,1068,0.7490671641791045
2003,3168,7,21,509,1173,0.25,-664,0.30261593341260407
2003,3169,3,24,188,1309,0.1111111111111111,-1121,0.12558450233800936
2003,3170,1,24,62,1250,0.04,-1188,0.04725609756097561
2003,3171,15,12,1119,681,0.5555555555555556,438,0.6216666666666667
2003,3172,15,15,1087,899,0.5,188,0.5473313192346425
2003,3173,14,14,1000,818,0.5,182,0.5500550055005501
2003,3174,22,8,1411,394,0.7333333333333333,1017,0.7817174515235457
2003,3175,20,10,1386,570,0.6666666666666666,816,0.7085889570552147
2003,3176,12,18,871,1006,0.4,-135,0.4640383590836441
2003,3177,22,9,1672,554,0.7096774193548387,1118,0.7511230907457322
2003,3178,10,20,714,1190,0.3333333333333333,-476,0.375
2003,3179,16,12,1077,685,0.5714285714285714,392,0.6112372304199774
2003,3180,12,17,788,923,0.41379310344827586,-135,0.4605493863237873
2003,3181,31,1,2547,65,0.96875,2482,0.975114854517611
2003,3182,15,14,998,806,0.5172413793103449,192,0.5532150776053215
2003,3183,6,22,435,1322,0.21428571428571427,-887,0.24758110415480933
2003,3184,17,10,1393,691,0.6296296296296297,702,0.668426103646833
2003,3185,13,16,883,1042,0.4482758620689655,-159,0.4587012987012987
2003,3186,16,12,1050,733,0.5714285714285714,317,0.5888951205832866
2003,3187,12,16,932,994,0.42857142857142855,-62,0.48390446521287644
2003,3189,16,10,1027,550,0.6153846153846154,477,0.6512365250475587
2003,3190,8,19,639,1152,0.2962962962962963,-513,0.35678391959798994
2003,3191,11,16,797,1012,0.4074074074074074,-215,0.4405749032614704
2003,3192,7,20,557,1143,0.25925925925925924,-586,0.3276470588235294
2003,3193,12,17,872,981,0.41379310344827586,-109,0.47058823529411764
2003,3194,14,14,1079,950,0.5,129,0.531789058649581
2003,3196,9,19,698,1100,0.32142857142857145,-402,0.3882091212458287
2003,3197,14,13,1002,775,0.5185185185185185,227,0.5638716938660664
2003,3198,19,10,1443,599,0.6551724137931034,844,0.7066601371204702
2003,3199,16,12,1122,696,0.5714285714285714,426,0.6171617161716172
2003,3200,14,16,907,923,0.4666666666666667,-16,0.49562841530054647
2003,3201,19,12,1321,689,0.6129032258064516,632,0.6572139303482587
2003,3202,15,13,1130,710,0.5357142857142857,420,0.6141304347826086
2003,3203,24,6,1783,393,0.8,1390,0.8193933823529411
2003,3204,20,10,1443,611,0.6666666666666666,832,0.7025316455696202
2003,3205,5,22,389,1320,0.18518518518518517,-931,0.22761849034523113
2003,3206,14,12,985,731,0.5384615384615384,254,0.574009324009324
2003,3207,15,13,1112,727,0.5357142857142857,385,0.6046764545948885
2003,3208,19,9,1585,579,0.6785714285714286,1006,0.7324399260628466
2003,3209,19,10,1324,554,0.6551724137931034,770,0.7050053248136315
2003,3210,20,10,1487,571,0.6666666666666666,916,0.7225461613216715
2003,3211,16,12,1123,684,0.5714285714285714,439,0.6214720531267294
2003,3212,18,10,1282,598,0.6428571428571429,684,0.6819148936170213
2003,3214,23,8,1689,447,0.7419354838709677,1242,0.7907303370786517
2003,3216,7,21,484,1168,0.25,-684,0.2929782082324455
2003,3217,22,4,1627,201,0.8461538461538461,1426,0.8900437636761488
2003,3218,16,13,1074,679,0.5517241379310345,395,0.6126640045636053
2003,3219,16,12,1078,653,0.5714285714285714,425,0.6227614095898325
2003,3220,8,21,585,1281,0.27586206896551724,-696,0.3135048231511254
2003,3221,24,7,1755,385,0.7741935483870968,1370,0.8200934579439252
2003,3222,15,13,1186,835,0.5357142857142857,351,0.58683819891143
2003,3224,12,17,997,1108,0.41379310344827586,-111,0.47363420427553443
2003,3225,10,17,684,909,0.37037037037037035,-225,0.4293785310734463
2003,3226,5,20,365,1197,0.2,-832,0.23367477592829705
2003,3227,17,11,1289,660,0.6071428571428571,629,0.6613648024628014
2003,3228,17,11,1249,762,0.6071428571428571,487,0.6210840377921432
2003,3229,7,21,463,1198,0.25,-735,0.27874774232390126
2003,3231,13,15,906,830,0.4642857142857143,76,0.521889400921659
2003,3232,22,8,1833,560,0.7333333333333333,1273,0.7659841203510238
2003,3233,1,27,52,1487,0.03571428571428571,-1435,0.03378817413905133
2003,3234,16,14,1254,889,0.5333333333333333,365,0.5851609892673821
2003,3235,12,16,870,950,0.42857142857142855,-80,0.47802197802197804
2003,3236,9,18,733,1082,0.3333333333333333,-349,0.4038567493112948
2003,3237,8,19,570,1074,0.2962962962962963,-504,0.3467153284671533
2003,3238,21,6,1474,348,0.7777777777777778,1126,0.8090010976948409
2003,3239,5,21,313,1052,0.19230769230769232,-739,0.2293040293040293
2003,3240,14,14,1065,968,0.5,97,0.5238563698967044
2003,3241,17,12,1288,684,0.5862068965517241,604,0.6531440162271805
2003,3242,11,18,757,969,0.3793103448275862,-212,0.43858632676709153
2003,3243,28,4,2152,255,0.875,1897,0.894058994599086
2003,3245,16,13,1174,760,0.5517241379310345,414,0.6070320579110652
2003,3246,10,16,744,927,0.38461538461538464,-183,0.4452423698384201
2003,3247,15,14,1022,841,0.5172413793103449,181,0.5485775630703167
2003,3248,3,25,229,1477,0.10714285714285714,-1248,0.134232121922626
2003,3249,2,24,123,1150,0.07692307692307693,-1027,0.09662215239591516
2003,3250,12,15,854,941,0.4444444444444444,-87,0.47576601671309193
2003,3251,26,3,1871,188,0.896551724137931,1683,0.9086935405536668
2003,3252,11,15,737,899,0.4230769230769231,-162,0.4504889975550122
2003,3253,14,15,1048,852,0.4827586206896552,196,0.5515789473684211
2003,3254,15,15,927,752,0.5,175,0.5521143537820131
2003,3256,29,2,2343,92,0.9354838709677419,2251,0.962217659137577
2003,3257,15,14,1244,892,0.5172413793103449,352,0.5823970037453183
2003,3258,14,15,884,818,0.4827586206896552,66,0.5193889541715628
2003,3259,11,17,731,1011,0.39285714285714285,-280,0.4196326061997704
2003,3260,12,17,867,1003,0.41379310344827586,-136,0.4636363636363636
2003,3261,27,3,2101,197,0.9,1904,0.9142732811140122
2003,3263,25,5,1749,337,0.8333333333333334,1412,0.8384467881112176
2003,3264,20,9,1352,486,0.6896551724137931,866,0.735582154515778
2003,3265,13,16,862,876,0.4482758620689655,-14,0.49597238204833144
2003,3266,15,13,1124,781,0.5357142857142857,343,0.5900262467191602
2003,3267,11,17,739,1019,0.39285714285714285,-280,0.4203640500568828
2003,3268,10,18,736,1150,0.35714285714285715,-414,0.3902439024390244
2003,3269,14,14,930,812,0.5,118,0.5338691159586682
2003,3270,9,17,608,921,0.34615384615384615,-313,0.3976455199476782
2003,3271,12,17,899,1055,0.41379310344827586,-156,0.4600818833162743
2003,3272,13,15,907,910,0.4642857142857143,-3,0.4991744634012108
2003,3273,11,16,752,964,0.4074074074074074,-212,0.4382284382284382
2003,3274,17,12,1328,791,0.5862068965517241,537,0.6267107126002831
2003,3275,17,12,1335,828,0.5862068965517241,507,0.6171983356449375
2003,3276,13,16,980,920,0.4482758620689655,60,0.5157894736842106
2003,3277,17,11,1268,677,0.6071428571428571,591,0.6519280205655527
2003,3278,23,5,1877,339,0.8214285714285714,1538,0.8470216606498195
2003,3279,12,16,836,960,0.42857142857142855,-124,0.46547884187082406
2003,3280,23,7,1759,496,0.7666666666666667,1263,0.7800443458980044
2003,3281,15,13,1104,767,0.5357142857142857,337,0.5900587920897915
2003,3282,14,14,979,810,0.5,169,0.5472330911123533
2003,3283,18,12,1421,709,0.6,712,0.6671361502347418
2003,3284,18,11,1187,625,0.6206896551724138,562,0.6550772626931567
2003,3285,19,9,1291,525,0.6785714285714286,766,0.7109030837004405
2003,3286,19,8,1499,441,0.7037037037037037,1058,0.772680412371134
2003,3287,15,11,1195,748,0.5769230769230769,447,0.6150283067421514
2003,3288,1,27,43,1288,0.03571428571428571,-1245,0.032306536438767845
2003,3290,7,17,444,900,0.2916666666666667,-456,0.33035714285714285
2003,3291,10,18,804,1177,0.35714285714285715,-373,0.40585562847046946
2003,3292,18,12,1311,740,0.6,571,0.6392003900536324
2003,3293,8,20,588,1140,0.2857142857142857,-552,0.3402777777777778
2003,3296,12,16,801,972,0.42857142857142855,-171,0.4517766497461929
2003,3298,16,12,1101,771,0.5714285714285714,330,0.5881410256410257
2003,3299,6,21,403,1096,0.2222222222222222,-693,0.2688458972648432
2003,3301,11,17,757,1003,0.39285714285714285,-246,0.43011363636363636
2003,3304,8,20,556,1047,0.2857142857142857,-491,0.34684965689332503
2003,3305,9,19,662,1078,0.32142857142857145,-416,0.38045977011494253
2003,3306,13,16,833,943,0.4482758620689655,-110,0.46903153153153154
2003,3307,22,8,1566,426,0.7333333333333333,1140,0.786144578313253
2003,3308,16,12,1180,717,0.5714285714285714,463,0.6220347917764892
2003,3309,12,16,750,955,0.42857142857142855,-205,0.4398826979472141
2003,3310,20,9,1544,518,0.6896551724137931,1026,0.7487875848690592
2003,3311,8,18,473,897,0.3076923076923077,-424,0.3452554744525547
2003,3313,8,20,595,1155,0.2857142857142857,-560,0.34
2003,3314,27,5,2130,311,0.84375,1819,0.8725931995083982
2003,3317,12,16,893,934,0.42857142857142855,-41,0.48877941981390255
2003,3318,8,20,561,1221,0.2857142857142857,-660,0.3148148148148148
2003,3319,13,15,947,905,0.4642857142857143,42,0.5113390928725702
2003,3320,18,11,1321,735,0.6206896551724138,586,0.6425097276264592
2003,3321,8,20,499,1048,0.2857142857142857,-549,0.32255979314802846
2003,3322,17,10,1301,670,0.6296296296296297,631,0.6600710299340437
2003,3323,19,10,1373,554,0.6551724137931034,819,0.7125064867669954
2003,3324,12,16,804,967,0.42857142857142855,-163,0.45398080180688877
2003,3325,9,19,649,1118,0.32142857142857145,-469,0.36728919071873234
2003,3326,20,9,1434,513,0.6896551724137931,921,0.736517719568567
2003,3328,19,12,1374,704,0.6129032258064516,670,0.6612127045235804
2003,3329,8,21,495,1175,0.27586206896551724,-680,0.2964071856287425
2003,3330,21,10,1522,607,0.6774193548387096,915,0.71488961953969
2003,3331,16,10,1126,553,0.6153846153846154,573,0.6706372840976772
2003,3332,12,16,885,961,0.42857142857142855,-76,0.47941495124593714
2003,3333,13,14,847,761,0.48148148148148145,86,0.5267412935323383
2003,3334,16,14,1135,748,0.5333333333333333,387,0.602761550716941
2003,3335,15,12,1097,796,0.5555555555555556,301,0.5795034337031167
2003,3336,24,8,1939,542,0.75,1397,0.7815397017331721
2003,3337,22,7,1686,413,0.7586206896551724,1273,0.8032396379228204
2003,3338,12,16,994,966,0.42857142857142855,28,0.5071428571428571
2003,3339,11,17,754,1046,0.39285714285714285,-292,0.41888888888888887
2003,3340,13,15,901,812,0.4642857142857143,89,0.5259778166958552
2003,3341,9,16,533,808,0.36,-275,0.39746457867263235
2003,3343,9,19,720,1114,0.32142857142857145,-394,0.3925845147219193
2003,3344,9,18,633,1001,0.3333333333333333,-368,0.3873929008567931
2003,3345,26,5,1952,338,0.8387096774193549,1614,0.8524017467248908
2003,3346,18,10,1290,621,0.6428571428571429,669,0.6750392464678179
2003,3347,8,18,551,999,0.3076923076923077,-448,0.3554838709677419
2003,3348,16,15,1054,778,0.5161290322580645,276,0.5753275109170306
2003,3349,15,13,1025,780,0.5357142857142857,245,0.5678670360110804
2003,3350,19,10,1408,599,0.6551724137931034,809,0.7015445939212755
2003,3351,8,20,638,1282,0.2857142857142857,-644,0.33229166666666665
2003,3352,1,26,85,1419,0.037037037037037035,-1334,0.05651595744680851
2003,3353,20,7,1347,476,0.7407407407407407,871,0.7388919363686232
2003,3354,10,19,756,1095,0.3448275862068966,-339,0.40842787682333875
2003,3356,7,20,514,1191,0.25925925925925924,-677,0.30146627565982403
2003,3357,18,10,1251,553,0.6428571428571429,698,0.6934589800443459
2003,3358,7,20,472,1143,0.25925925925925924,-671,0.29226006191950465
2003,3359,5,20,321,984,0.2,-663,0.24597701149425288
2003,3360,13,17,896,986,0.43333333333333335,-90,0.4760892667375133
2003,3361,9,18,606,892,0.3333333333333333,-286,0.4045393858477971
2003,3362,12,17,779,954,0.41379310344827586,-175,0.44950952106174263
2003,3363,13,15,981,865,0.4642857142857143,116,0.5314192849404117
2003,3364,26,4,1966,263,0.8666666666666667,1703,0.8820098698968147
2003,3365,20,10,1474,597,0.6666666666666666,877,0.711733462095606
2003,3366,1,22,59,1025,0.043478260869565216,-966,0.0544280442804428
2003,3368,6,20,360,1012,0.23076923076923078,-652,0.26239067055393583
2003,3369,17,11,1359,737,0.6071428571428571,622,0.6483778625954199
2003,3371,14,14,919,710,0.5,209,0.5641497851442603
2003,3372,15,13,998,758,0.5357142857142857,240,0.5683371298405467
2003,3373,24,7,1785,407,0.7741935483870968,1378,0.8143248175182481
2003,3374,16,15,1107,905,0.5161290322580645,202,0.5501988071570576
2003,3375,19,10,1284,582,0.6551724137931034,702,0.6881028938906752
2003,3376,22,7,1663,496,0.7586206896551724,1167,0.7702640111162575
2003,3378,7,20,472,1162,0.25925925925925924,-690,0.28886168910648713
2003,3379,14,15,946,767,0.4827586206896552,179,0.5522475189725627
2003,3380,15,8,1090,458,0.6521739130434783,632,0.7041343669250646
2003,3381,7,18,481,1063,0.28,-582,0.3115284974093264
2003,3382,6,22,417,1197,0.21428571428571427,-780,0.258364312267658
2003,3383,2,25,134,1404,0.07407407407407407,-1270,0.08712613784135241
2003,3384,23,7,1586,434,0.7666666666666667,1152,0.7851485148514852
2003,3385,8,19,562,949,0.2962962962962963,-387,0.37193911317008604
2003,3386,18,10,1182,535,0.6428571428571429,647,0.6884100174723354
2003,3387,16,13,1158,728,0.5517241379310345,430,0.6139978791092259
2003,3388,11,17,735,1016,0.39285714285714285,-281,0.4197601370645346
2003,3389,14,14,959,811,0.5,148,0.5418079096045197
2003,3390,26,4,1865,260,0.8666666666666667,1605,0.8776470588235294
2003,3391,6,21,409,1241,0.2222222222222222,-832,0.24787878787878787
2003,3392,9,19,616,1049,0.32142857142857145,-433,0.36996996996996995
2003,3393,10,18,712,1122,0.35714285714285715,-410,0.3882224645583424
2003,3394,15,12,1012,640,0.5555555555555556,372,0.612590799031477
2003,3395,19,13,1366,818,0.59375,548,0.6254578754578755
2003,3396,14,15,893,882,0.4827586206896552,11,0.5030985915492958
2003,3397,27,4,2191,241,0.8709677419354839,1950,0.9009046052631579
2003,3398,4,22,309,1418,0.15384615384615385,-1109,0.1789229878401853
2003,3399,12,17,879,1055,0.41379310344827586,-176,0.4544984488107549
2003,3400,25,5,1906,326,0.8333333333333334,1580,0.8539426523297491
2003,3401,10,18,728,957,0.35714285714285715,-229,0.4320474777448071
2003,3402,18,13,1252,724,0.5806451612903226,528,0.6336032388663968
2003,3403,26,5,2014,330,0.8387096774193549,1684,0.8592150170648464
2003,3404,13,16,957,1052,0.4482758620689655,-95,0.4763563962170234
2003,3405,20,9,1411,539,0.6896551724137931,872,0.7235897435897436
2003,3406,3,25,186,1123,0.10714285714285714,-937,0.14209320091673033
2003,3407,16,12,1102,671,0.5714285714285714,431,0.6215454032712916
2003,3408,19,9,1366,546,0.6785714285714286,820,0.7144351464435147
2003,3409,14,16,975,996,0.4666666666666667,-21,0.4946727549467275
2003,3410,6,19,413,970,0.24,-557,0.29862617498192334
2003,3411,5,22,341,1142,0.18518518518518517,-801,0.2299393122049899
2003,3412,8,19,568,1047,0.2962962962962963,-479,0.35170278637770896
2003,3414,17,12,1212,694,0.5862068965517241,518,0.6358866736621196
2003,3415,7,20,459,1178,0.25925925925925924,-719,0.2803909590714722
2003,3416,19,11,1377,581,0.6333333333333333,796,0.7032686414708886
2003,3417,18,11,1354,763,0.6206896551724138,591,0.639584317430326
2003,3418,8,19,488,920,0.2962962962962963,-432,0.3465909090909091
2003,3419,15,14,1058,825,0.5172413793103449,233,0.5618693574083908
2003,3420,14,16,837,828,0.4666666666666667,9,0.5027027027027027
2003,3421,2,25,143,1266,0.07407407407407407,-1123,0.10149041873669269
2003,3422,14,13,990,708,0.5185185185185185,282,0.5830388692579506
2003,3423,22,6,1519,348,0.7857142857142857,1171,0.8136047134440278
2003,3424,17,11,1201,650,0.6071428571428571,551,0.6488384656942193
2003,3425,14,17,994,1077,0.45161290322580644,-83,0.47996137131820377
2003,3426,15,13,991,717,0.5357142857142857,274,0.5802107728337237
2003,3427,18,11,1115,571,0.6206896551724138,544,0.6613285883748518
2003,3428,22,6,1502,310,0.7857142857142857,1192,0.8289183222958058
2003,3431,10,19,772,1142,0.3448275862068966,-370,0.40334378265412746
2003,3433,11,18,811,977,0.3793103448275862,-166,0.45357941834451904
2003,3434,16,12,1115,646,0.5714285714285714,469,0.6331629755820557
2003,3435,21,9,1630,599,0.7,1031,0.7312696276357111
2003,3436,21,8,1508,464,0.7241379310344828,1044,0.7647058823529411
2003,3437,25,5,1649,250,0.8333333333333334,1399,0.8683517640863613
2003,3438,16,13,1060,771,0.5517241379310345,289,0.5789186237028946
2003,3439,21,9,1425,507,0.7,918,0.7375776397515528
2003,3441,21,7,1497,416,0.75,1081,0.78254051228437
2003,3442,18,8,1261,409,0.6923076923076923,852,0.7550898203592814
2003,3443,22,8,1712,465,0.7333333333333333,1247,0.7864033073036288
2003,3444,20,11,1708,749,0.6451612903225806,959,0.6951566951566952
2003,3447,15,13,1075,740,0.5357142857142857,335,0.5922865013774105
2003,3448,13,15,961,877,0.4642857142857143,84,0.5228509249183896
2003,3449,22,7,1767,435,0.7586206896551724,1332,0.8024523160762943
2003,3450,2,26,149,1406,0.07142857142857142,-1257,0.09581993569131833
2003,3451,21,8,1452,427,0.7241379310344828,1025,0.7727514635444386
2003,3452,15,13,1154,737,0.5357142857142857,417,0.6102591221575886
2003,3453,27,3,2145,210,0.9,1935,0.910828025477707
2003,3454,15,13,1105,772,0.5357142857142857,333,0.5887053809270112
2003,3455,14,14,1119,872,0.5,247,0.5620291310899046
2003,3456,8,20,550,1187,0.2857142857142857,-637,0.31663788140472077
2003,3457,7,18,498,1012,0.28,-514,0.32980132450331123
2003,3458,7,21,466,1156,0.25,-690,0.2872996300863132
2003,3459,2,24,126,1386,0.07692307692307693,-1260,0.08333333333333333
2003,3460,11,17,775,1049,0.39285714285714285,-274,0.42489035087719296
2003,3461,15,11,1078,633,0.5769230769230769,445,0.6300409117475161
2003,3462,20,9,1434,543,0.6896551724137931,891,0.7253414264036419
2003,3463,6,21,436,1362,0.2222222222222222,-926,0.2424916573971079
2003,3464,6,22,452,1356,0.21428571428571427,-904,0.25
2004,1102,22,6,1404,281,0.7857142857142857,1123,0.8332344213649852
2004,1103,13,15,973,1036,0.4642857142857143,-63,0.4843205574912892
2004,1104,17,12,1298,796,0.5862068965517241,502,0.6198662846227316
2004,1105,13,16,984,1040,0.4482758620689655,-56,0.48616600790513836
2004,1106,16,14,1087,756,0.5333333333333333,331,0.5897992403689637
2004,1107,5,23,329,1292,0.17857142857142858,-963,0.202961135101789
2004,1108,11,18,792,1063,0.3793103448275862,-271,0.4269541778975741
2004,1110,18,13,1242,850,0.5806451612903226,392,0.5936902485659655
2004,1111,8,21,611,1388,0.27586206896551724,-777,0.3056528264132066
2004,1112,20,9,1803,735,0.6896551724137931,1068,0.710401891252955
2004,1113,10,17,832,1168,0.37037037037037035,-336,0.416
2004,1114,14,12,1000,817,0.5384615384615384,183,0.550357732526142
2004,1115,1,26,61,1349,0.037037037037037035,-1288,0.04326241134751773
2004,1116,12,16,950,978,0.42857142857142855,-28,0.4927385892116183
2004,1117,15,11,1138,755,0.5769230769230769,383,0.601162176439514
2004,1119,4,21,240,991,0.16,-751,0.19496344435418358
2004,1120,14,14,1080,880,0.5,200,0.5510204081632653
2004,1122,19,9,1287,510,0.6785714285714286,777,0.7161936560934892
2004,1123,13,15,981,982,0.4642857142857143,-1,0.499745287824758
2004,1124,7,20,497,1186,0.25925925925925924,-689,0.29530600118835415
2004,1125,20,8,1471,554,0.7142857142857143,917,0.7264197530864197
2004,1126,8,21,568,1143,0.27586206896551724,-575,0.33196960841613093
2004,1127,14,16,888,914,0.4666666666666667,-26,0.49278579356270813
2004,1128,18,7,1362,446,0.72,916,0.7533185840707964
2004,1129,19,9,1433,595,0.6785714285714286,838,0.7066074950690335
2004,1130,23,9,1636,564,0.71875,1072,0.7436363636363637
2004,1131,23,5,1606,272,0.8214285714285714,1334,0.8551650692225772
2004,1132,12,17,909,1118,0.41379310344827586,-209,0.44844597927972374
2004,1133,15,15,1055,922,0.5,133,0.5336368234699039
2004,1135,13,13,1075,786,0.5,289,0.5776464266523375
2004,1137,12,15,817,910,0.4444444444444444,-93,0.4730746960046323
2004,1138,17,12,1361,814,0.5862068965517241,547,0.6257471264367817
2004,1139,15,14,1031,773,0.5172413793103449,258,0.5715077605321508
2004,1140,19,8,1484,465,0.7037037037037037,1019,0.7614161108260646
2004,1141,5,24,407,1585,0.1724137931034483,-1178,0.2043172690763052
2004,1142,10,16,799,1022,0.38461538461538464,-223,0.4387699066447007
2004,1143,13,15,986,887,0.4642857142857143,99,0.5264281900694073
2004,1144,3,24,244,1614,0.1111111111111111,-1370,0.13132400430570507
2004,1145,10,19,692,1305,0.3448275862068966,-613,0.34651977966950426
2004,1147,14,12,1035,727,0.5384615384615384,308,0.5874006810442679
2004,1148,14,14,1070,909,0.5,161,0.5406771096513391
2004,1149,4,22,252,1246,0.15384615384615385,-994,0.16822429906542055
2004,1150,21,8,1754,547,0.7241379310344828,1207,0.762277270751847
2004,1151,16,11,1325,793,0.5925925925925926,532,0.625590179414542
2004,1152,11,20,791,1222,0.3548387096774194,-431,0.3929458519622454
2004,1153,24,6,1870,437,0.8,1433,0.8105765062852189
2004,1154,3,21,218,1126,0.125,-908,0.16220238095238096
2004,1155,10,18,775,1064,0.35714285714285715,-289,0.4214246873300707
2004,1156,2,25,161,1568,0.07407407407407407,-1407,0.0931174089068826
2004,1157,12,15,836,1019,0.4444444444444444,-183,0.45067385444743935
2004,1158,19,9,1438,624,0.6785714285714286,814,0.6973811833171678
2004,1159,13,14,921,860,0.48148148148148145,61,0.5171252105558675
2004,1160,17,10,1350,651,0.6296296296296297,699,0.6746626686656672
2004,1161,12,16,955,997,0.42857142857142855,-42,0.48924180327868855
2004,1162,9,17,701,1046,0.34615384615384615,-345,0.4012593016599886
2004,1163,27,6,2212,398,0.8181818181818182,1814,0.8475095785440613
2004,1164,18,14,1181,788,0.5625,393,0.5997968511934992
2004,1165,10,16,801,1034,0.38461538461538464,-233,0.4365122615803815
2004,1166,20,8,1410,504,0.7142857142857143,906,0.7366771159874608
2004,1168,10,17,782,1118,0.37037037037037035,-336,0.41157894736842104
2004,1169,13,16,955,1002,0.4482758620689655,-47,0.48799182422074605
2004,1170,11,15,848,976,0.4230769230769231,-128,0.4649122807017544
2004,1171,2,24,124,1327,0.07692307692307693,-1203,0.08545830461750517
2004,1172,14,12,1036,798,0.5384615384615384,238,0.5648854961832062
2004,1173,24,8,1711,464,0.75,1247,0.7866666666666666
2004,1174,16,12,1202,785,0.5714285714285714,417,0.6049320583794665
2004,1175,13,15,890,831,0.4642857142857143,59,0.5171411969785009
2004,1176,13,13,936,873,0.5,63,0.5174129353233831
2004,1177,21,9,1524,602,0.7,922,0.7168391345249294
2004,1178,19,11,1299,649,0.6333333333333333,650,0.6668377823408624
2004,1179,11,16,819,1050,0.4074074074074074,-231,0.43820224719101125
2004,1180,18,10,1404,639,0.6428571428571429,765,0.6872246696035242
2004,1181,27,5,2171,381,0.84375,1790,0.850705329153605
2004,1182,12,17,966,1074,0.41379310344827586,-108,0.47352941176470587
2004,1183,4,20,331,1274,0.16666666666666666,-943,0.2062305295950156
2004,1184,12,15,951,1001,0.4444444444444444,-50,0.48719262295081966
2004,1185,10,15,810,927,0.4,-117,0.46632124352331605
2004,1186,16,12,1179,788,0.5714285714285714,391,0.5993899339095069
2004,1187,12,14,911,894,0.46153846153846156,17,0.5047091412742383
2004,1189,10,18,766,1133,0.35714285714285715,-367,0.40337019483938913
2004,1190,24,5,1885,375,0.8275862068965517,1510,0.834070796460177
2004,1191,7,22,529,1433,0.2413793103448276,-904,0.26962283384301733
2004,1192,16,12,1147,775,0.5714285714285714,372,0.5967741935483871
2004,1193,19,11,1380,648,0.6333333333333333,732,0.6804733727810651
2004,1194,7,19,645,1335,0.2692307692307692,-690,0.32575757575757575
2004,1196,20,10,1641,668,0.6666666666666666,973,0.7106972715461238
2004,1197,14,16,1077,1086,0.4666666666666667,-9,0.49791955617198336
2004,1198,3,22,199,1158,0.12,-959,0.1466470154753132
2004,1199,17,13,1307,821,0.5666666666666667,486,0.6141917293233082
2004,1200,6,22,446,1289,0.21428571428571427,-843,0.2570605187319885
2004,1201,13,15,841,913,0.4642857142857143,-72,0.47947548460661343
2004,1202,14,12,1045,838,0.5384615384615384,207,0.5549654806160382
2004,1203,18,11,1424,761,0.6206896551724138,663,0.6517162471395881
2004,1204,18,8,1426,624,0.6923076923076923,802,0.6956097560975609
2004,1205,7,20,527,1258,0.25925925925925924,-731,0.29523809523809524
2004,1206,21,9,1609,577,0.7,1032,0.7360475754803294
2004,1207,13,15,1019,864,0.4642857142857143,155,0.541157727031333
2004,1208,16,13,1188,733,0.5517241379310345,455,0.6184279021343051
2004,1209,18,9,1432,553,0.6666666666666666,879,0.7214105793450881
2004,1210,23,9,1823,675,0.71875,1148,0.7297838270616493
2004,1211,27,2,2242,146,0.9310344827586207,2096,0.9388609715242882
2004,1212,9,18,705,1110,0.3333333333333333,-405,0.3884297520661157
2004,1214,13,17,990,1067,0.43333333333333335,-77,0.48128342245989303
2004,1216,11,17,783,958,0.39285714285714285,-175,0.4497415278575531
2004,1217,4,23,277,1471,0.14814814814814814,-1194,0.15846681922196795
2004,1218,18,11,1340,688,0.6206896551724138,652,0.6607495069033531
2004,1219,17,11,1286,682,0.6071428571428571,604,0.6534552845528455
2004,1220,14,15,1043,1007,0.4827586206896552,36,0.5087804878048781
2004,1221,13,14,895,801,0.48148148148148145,94,0.5277122641509434
2004,1222,9,18,577,1015,0.3333333333333333,-438,0.36243718592964824
2004,1224,6,22,394,1289,0.21428571428571427,-895,0.23410576351752824
2004,1225,13,16,856,969,0.4482758620689655,-113,0.469041095890411
2004,1226,11,18,834,1230,0.3793103448275862,-396,0.40406976744186046
2004,1227,24,7,1754,416,0.7741935483870968,1338,0.808294930875576
2004,1228,24,6,1821,355,0.8,1466,0.8368566176470589
2004,1229,9,19,644,1094,0.32142857142857145,-450,0.3705408515535098
2004,1231,14,15,1004,877,0.4827586206896552,127,0.5337586390217969
2004,1232,9,19,634,989,0.32142857142857145,-355,0.39063462723351816
2004,1233,11,18,825,1253,0.3793103448275862,-428,0.39701636188642925
2004,1234,16,12,1209,793,0.5714285714285714,416,0.6038961038961039
2004,1235,16,12,1260,810,0.5714285714285714,450,0.6086956521739131
2004,1236,2,24,159,1426,0.07692307692307693,-1267,0.10031545741324921
2004,1237,19,11,1551,742,0.6333333333333333,809,0.6764064544265155
2004,1238,12,17,876,960,0.41379310344827586,-84,0.477124183006536
2004,1239,11,15,852,976,0.4230769230769231,-124,0.4660831509846827
2004,1240,12,14,960,951,0.46153846153846156,9,0.5023547880690737
2004,1241,7,21,504,1312,0.25,-808,0.2775330396475771
2004,1242,20,8,1606,490,0.7142857142857143,1116,0.7662213740458015
2004,1243,14,14,1034,909,0.5,125,0.5321667524446732
2004,1245,21,8,1614,477,0.7241379310344828,1137,0.7718794835007173
2004,1246,26,4,1953,241,0.8666666666666667,1712,0.890154968094804
2004,1247,10,20,742,1211,0.3333333333333333,-469,0.37992831541218636
2004,1248,16,10,1251,687,0.6153846153846154,564,0.6455108359133127
2004,1249,7,18,594,1294,0.28,-700,0.3146186440677966
2004,1250,18,10,1217,627,0.6428571428571429,590,0.6599783080260304
2004,1251,17,14,1267,864,0.5483870967741935,403,0.5945565462224308
2004,1252,5,21,355,1413,0.19230769230769232,-1058,0.20079185520361992
2004,1253,5,21,361,1266,0.19230769230769232,-905,0.22188076213890595
2004,1254,8,19,614,1258,0.2962962962962963,-644,0.327991452991453
2004,1256,13,15,928,941,0.4642857142857143,-13,0.49652220438737293
2004,1257,20,9,1550,575,0.6896551724137931,975,0.7294117647058823
2004,1258,14,14,1015,873,0.5,142,0.5376059322033898
2004,1259,1,27,63,1615,0.03571428571428571,-1552,0.037544696066746125
2004,1260,9,20,724,1309,0.3103448275862069,-585,0.3561239547466798
2004,1261,18,10,1279,584,0.6428571428571429,695,0.6865271068169619
2004,1263,18,10,1256,621,0.6428571428571429,635,0.6691529035695258
2004,1264,24,5,1871,285,0.8275862068965517,1586,0.8678107606679035
2004,1265,6,22,375,1347,0.21428571428571427,-972,0.21777003484320556
2004,1266,16,11,1158,757,0.5925925925925926,401,0.6046997389033942
2004,1267,12,17,933,1089,0.41379310344827586,-156,0.46142433234421365
2004,1268,19,11,1520,801,0.6333333333333333,719,0.6548901335631193
2004,1269,10,19,753,1222,0.3448275862068966,-469,0.38126582278481014
2004,1270,8,16,608,1145,0.3333333333333333,-537,0.3468339988590987
2004,1271,8,21,504,1200,0.27586206896551724,-696,0.29577464788732394
2004,1272,21,7,1584,476,0.75,1108,0.7689320388349514
2004,1273,11,18,868,1191,0.3793103448275862,-323,0.42156386595434675
2004,1274,13,16,995,1067,0.4482758620689655,-72,0.482541222114452
2004,1275,17,11,1162,594,0.6071428571428571,568,0.6617312072892938
2004,1276,18,11,1312,673,0.6206896551724138,639,0.6609571788413098
2004,1277,18,11,1341,731,0.6206896551724138,610,0.6472007722007722
2004,1278,12,18,951,1151,0.4,-200,0.45242626070409137
2004,1279,13,15,865,905,0.4642857142857143,-40,0.4887005649717514
2004,1280,25,3,1950,209,0.8928571428571429,1741,0.9031959240389069
2004,1281,16,13,1269,893,0.5517241379310345,376,0.5869565217391305
2004,1282,15,14,1189,956,0.5172413793103449,233,0.5543123543123543
2004,1283,19,14,1344,865,0.5757575757575758,479,0.6084200995925758
2004,1284,21,11,1515,686,0.65625,829,0.688323489323035
2004,1285,8,18,599,1181,0.3076923076923077,-582,0.3365168539325843
2004,1286,12,13,868,815,0.48,53,0.5157456922162804
2004,1287,13,13,1008,913,0.5,95,0.5247267048412285
2004,1288,11,16,809,1045,0.4074074074074074,-236,0.43635382955771307
2004,1290,21,6,1481,373,0.7777777777777778,1108,0.7988133764832794
2004,1291,10,19,731,1227,0.3448275862068966,-496,0.37334014300306434
2004,1292,15,12,1082,772,0.5555555555555556,310,0.5836030204962244
2004,1293,25,5,2124,300,0.8333333333333334,1824,0.8762376237623762
2004,1296,8,19,579,1211,0.2962962962962963,-632,0.323463687150838
2004,1298,3,23,176,1243,0.11538461538461539,-1067,0.12403100775193798
2004,1299,3,25,230,1388,0.10714285714285714,-1158,0.14215080346106304
2004,1301,20,9,1553,574,0.6896551724137931,979,0.7301363422661025
2004,1304,16,12,1199,753,0.5714285714285714,446,0.6142418032786885
2004,1305,22,8,1691,574,0.7333333333333333,1117,0.7465783664459161
2004,1306,10,20,666,1145,0.3333333333333333,-479,0.3677526228602982
2004,1307,12,14,904,863,0.46153846153846156,41,0.511601584606678
2004,1308,11,14,818,799,0.44,19,0.5058750773036488
2004,1309,16,14,1189,896,0.5333333333333333,293,0.5702637889688249
2004,1310,21,9,1825,629,0.7,1196,0.743683781581092
2004,1311,2,21,166,1286,0.08695652173913043,-1120,0.11432506887052342
2004,1313,12,16,811,909,0.42857142857142855,-98,0.47151162790697676
2004,1314,18,10,1542,784,0.6428571428571429,758,0.6629406706792778
2004,1317,11,15,836,1027,0.4230769230769231,-191,0.4487385936661299
2004,1318,17,11,1316,782,0.6071428571428571,534,0.6272640610104862
2004,1319,13,14,1049,957,0.48148148148148145,92,0.5229312063808574
2004,1320,20,9,1473,534,0.6896551724137931,939,0.7339312406576981
2004,1321,14,15,907,880,0.4827586206896552,27,0.5075545607162842
2004,1322,8,17,650,1163,0.32,-513,0.35852178709321564
2004,1323,17,12,1291,757,0.5862068965517241,534,0.63037109375
2004,1324,11,17,893,1162,0.39285714285714285,-269,0.4345498783454988
2004,1325,10,20,726,1274,0.3333333333333333,-548,0.363
2004,1326,14,16,966,984,0.4666666666666667,-18,0.49538461538461537
2004,1328,19,10,1338,597,0.6551724137931034,741,0.6914728682170542
2004,1329,26,3,2043,225,0.896551724137931,1818,0.9007936507936508
2004,1330,17,12,1293,843,0.5862068965517241,450,0.6053370786516854
2004,1331,15,11,1203,850,0.5769230769230769,353,0.5859717486604968
2004,1332,15,12,1171,889,0.5555555555555556,282,0.5684466019417476
2004,1333,11,16,791,1143,0.4074074074074074,-352,0.4089968976215098
2004,1334,23,7,1657,418,0.7666666666666667,1239,0.7985542168674699
2004,1335,17,10,1277,652,0.6296296296296297,625,0.6620010368066356
2004,1336,9,19,608,1024,0.32142857142857145,-416,0.37254901960784315
2004,1337,15,16,1285,1161,0.4838709677419355,124,0.5253475061324612
2004,1338,28,4,1968,236,0.875,1732,0.8929219600725953
2004,1339,11,17,863,1090,0.39285714285714285,-227,0.441884280593958
2004,1340,9,16,664,992,0.36,-328,0.40096618357487923
2004,1341,7,20,476,1197,0.25925925925925924,-721,0.28451882845188287
2004,1343,19,7,1266,359,0.7307692307692307,907,0.7790769230769231
2004,1344,20,8,1498,504,0.7142857142857143,994,0.7482517482517482
2004,1345,17,13,1206,747,0.5666666666666667,459,0.6175115207373272
2004,1346,7,20,542,1398,0.25925925925925924,-856,0.2793814432989691
2004,1347,10,16,749,977,0.38461538461538464,-228,0.4339513325608343
2004,1348,19,12,1392,730,0.6129032258064516,662,0.6559849198868991
2004,1349,21,10,1606,675,0.6774193548387096,931,0.7040771591407278
2004,1350,20,12,1362,703,0.625,659,0.6595641646489104
2004,1351,17,13,1279,777,0.5666666666666667,502,0.6220817120622568
2004,1352,13,15,925,974,0.4642857142857143,-49,0.48709847288046343
2004,1353,15,12,1101,709,0.5555555555555556,392,0.6082872928176796
2004,1354,17,11,1255,670,0.6071428571428571,585,0.6519480519480519
2004,1356,25,4,1818,249,0.8620689655172413,1569,0.8795355587808418
2004,1357,12,15,907,1079,0.4444444444444444,-172,0.4566968781470292
2004,1358,9,15,732,1002,0.375,-270,0.42214532871972316
2004,1359,8,16,539,931,0.3333333333333333,-392,0.36666666666666664
2004,1360,3,26,222,1739,0.10344827586206896,-1517,0.11320754716981132
2004,1361,12,16,911,1063,0.42857142857142855,-152,0.461499493414387
2004,1362,16,14,1149,778,0.5333333333333333,371,0.5962636222106902
2004,1363,5,22,328,1289,0.18518518518518517,-961,0.2028447742733457
2004,1364,15,12,1075,706,0.5555555555555556,369,0.6035934868051657
2004,1365,15,16,1064,949,0.4838709677419355,115,0.5285643318430203
2004,1366,4,23,270,1354,0.14814814814814814,-1084,0.16625615763546797
2004,1368,16,9,1221,605,0.64,616,0.6686746987951807
2004,1369,9,16,706,1050,0.36,-344,0.4020501138952164
2004,1371,19,9,1445,579,0.6785714285714286,866,0.7139328063241107
2004,1372,17,9,1198,582,0.6538461538461539,616,0.6730337078651686
2004,1373,14,16,1001,1070,0.4666666666666667,-69,0.4833413809753742
2004,1374,12,18,807,1130,0.4,-323,0.4166236448115643
2004,1375,10,16,672,1031,0.38461538461538464,-359,0.39459776864357016
2004,1376,23,10,1702,638,0.696969696969697,1064,0.7273504273504273
2004,1378,7,20,502,1152,0.25925925925925924,-650,0.30350665054413545
2004,1379,12,15,880,846,0.4444444444444444,34,0.5098493626882966
2004,1380,11,16,834,1046,0.4074074074074074,-212,0.44361702127659575
2004,1381,8,18,546,1109,0.3076923076923077,-563,0.32990936555891237
2004,1382,7,21,545,1359,0.25,-814,0.2862394957983193
2004,1383,15,13,1149,848,0.5357142857142857,301,0.5753630445668503
2004,1384,13,15,944,929,0.4642857142857143,15,0.5040042712226375
2004,1385,6,21,402,1271,0.2222222222222222,-869,0.2402869097429767
2004,1386,27,1,2111,67,0.9642857142857143,2044,0.9692378328741965
2004,1387,18,12,1183,686,0.6,497,0.6329588014981273
2004,1388,16,12,1286,837,0.5714285714285714,449,0.6057465850211964
2004,1389,17,12,1347,849,0.5862068965517241,498,0.6133879781420765
2004,1390,29,1,2156,62,0.9666666666666667,2094,0.9720468890892696
2004,1391,10,15,729,954,0.4,-225,0.43315508021390375
2004,1392,10,20,661,1216,0.3333333333333333,-555,0.35215769845498135
2004,1393,21,7,1595,447,0.75,1148,0.7810969637610186
2004,1394,11,11,871,670,0.5,201,0.5652173913043478
2004,1395,12,17,881,1060,0.41379310344827586,-179,0.4538897475528078
2004,1396,15,13,1036,782,0.5357142857142857,254,0.5698569856985699
2004,1397,15,13,1209,799,0.5357142857142857,410,0.6020916334661355
2004,1398,6,20,454,1342,0.23076923076923078,-888,0.25278396436525613
2004,1399,10,15,821,1041,0.4,-220,0.44092373791621914
2004,1400,23,7,1862,452,0.7666666666666667,1410,0.8046672428694901
2004,1401,7,21,599,1414,0.25,-815,0.2975658221559861
2004,1402,9,14,682,875,0.391304347826087,-193,0.4380218368657675
2004,1403,22,10,1706,643,0.6875,1063,0.7262664963814389
2004,1404,8,18,662,1182,0.3076923076923077,-520,0.35900216919739697
2004,1405,20,10,1647,660,0.6666666666666666,987,0.7139141742522757
2004,1406,8,21,528,1244,0.27586206896551724,-716,0.2979683972911964
2004,1407,23,5,1999,341,0.8214285714285714,1658,0.8542735042735042
2004,1408,10,17,740,1013,0.37037037037037035,-273,0.42213348545350826
2004,1409,9,20,677,1305,0.3103448275862069,-628,0.34157416750756814
2004,1410,10,14,714,910,0.4166666666666667,-196,0.4396551724137931
2004,1411,13,15,906,938,0.4642857142857143,-32,0.4913232104121475
2004,1412,20,9,1560,602,0.6896551724137931,958,0.7215541165587419
2004,1414,10,17,701,997,0.37037037037037035,-296,0.4128386336866902
2004,1415,10,17,726,1098,0.37037037037037035,-372,0.3980263157894737
2004,1416,24,5,1757,288,0.8275862068965517,1469,0.8591687041564792
2004,1417,11,17,789,1074,0.39285714285714285,-285,0.42351046698872785
2004,1418,18,8,1465,518,0.6923076923076923,947,0.7387796268280383
2004,1419,9,19,646,1222,0.32142857142857145,-576,0.34582441113490364
2004,1420,7,21,472,1212,0.25,-740,0.28028503562945367
2004,1421,7,20,457,1206,0.25925925925925924,-749,0.27480457005411907
2004,1422,10,17,763,1211,0.37037037037037035,-448,0.38652482269503546
2004,1423,15,15,993,851,0.5,142,0.5385032537960954
2004,1424,17,12,1308,839,0.5862068965517241,469,0.6092221704704238
2004,1425,13,15,1059,1052,0.4642857142857143,7,0.5016579819990525
2004,1426,14,12,1091,745,0.5384615384615384,346,0.5942265795206971
2004,1427,16,12,1277,751,0.5714285714285714,526,0.6296844181459567
2004,1428,23,8,1581,431,0.7419354838709677,1150,0.7857852882703777
2004,1429,24,3,1682,167,0.8888888888888888,1515,0.9096809085992429
2004,1431,22,7,1739,450,0.7586206896551724,1289,0.7944266788487894
2004,1433,23,7,1722,402,0.7666666666666667,1320,0.8107344632768362
2004,1434,17,12,1292,804,0.5862068965517241,488,0.6164122137404581
2004,1435,21,9,1624,591,0.7,1033,0.7331828442437923
2004,1436,22,8,1509,483,0.7333333333333333,1026,0.7575301204819277
2004,1437,15,15,1116,974,0.5,142,0.5339712918660288
2004,1438,17,12,1345,818,0.5862068965517241,527,0.6218215441516413
2004,1439,15,14,1040,891,0.5172413793103449,149,0.5385810460901087
2004,1440,4,22,251,1165,0.15384615384615385,-914,0.1772598870056497
2004,1441,9,15,688,993,0.375,-305,0.4092801903628792
2004,1442,3,24,240,1539,0.1111111111111111,-1299,0.13490725126475547
2004,1443,13,13,1016,918,0.5,98,0.5253360910031024
2004,1444,26,4,2102,274,0.8666666666666667,1828,0.8846801346801347
2004,1447,12,16,893,976,0.42857142857142855,-83,0.4777956126270733
2004,1448,19,9,1679,668,0.6785714285714286,1011,0.7153813378781423
2004,1449,19,11,1656,787,0.6333333333333333,869,0.677855096193205
2004,1450,12,16,793,828,0.42857142857142855,-35,0.4892041949413942
2004,1451,13,14,942,880,0.48148148148148145,62,0.5170142700329309
2004,1452,15,13,1045,782,0.5357142857142857,263,0.571975916803503
2004,1453,16,11,1098,659,0.5925925925925926,439,0.6249288560045532
2004,1454,18,10,1450,694,0.6428571428571429,756,0.6763059701492538
2004,1455,20,10,1462,667,0.6666666666666666,795,0.6867073743541569
2004,1456,7,21,579,1428,0.25,-849,0.2884902840059791
2004,1457,14,12,996,699,0.5384615384615384,297,0.5876106194690266
2004,1458,24,6,1718,341,0.8,1377,0.8343856240893638
2004,1459,6,20,509,1356,0.23076923076923078,-847,0.27292225201072384
2004,1460,14,13,985,806,0.5185185185185185,179,0.5499720826353992
2004,1461,11,17,874,1085,0.39285714285714285,-211,0.4461459928534967
2004,1462,23,10,1683,641,0.696969696969697,1042,0.7241824440619621
2004,1463,11,15,745,954,0.4230769230769231,-209,0.4384932313125368
2004,1464,7,20,529,1241,0.25925925925925924,-712,0.29887005649717513
2004,3102,1,25,57,1338,0.038461538461538464,-1281,0.04086021505376344
2004,3103,7,21,432,1138,0.25,-706,0.2751592356687898
2004,3104,12,16,907,951,0.42857142857142855,-44,0.4881593110871905
2004,3105,12,16,759,886,0.42857142857142855,-127,0.4613981762917933
2004,3106,19,9,1294,531,0.6785714285714286,763,0.709041095890411
2004,3107,13,16,874,862,0.4482758620689655,12,0.5034562211981567
2004,3108,12,15,795,844,0.4444444444444444,-49,0.48505186089078706
2004,3110,16,14,1027,814,0.5333333333333333,213,0.5578489951113526
2004,3111,7,21,543,1308,0.25,-765,0.293354943273906
2004,3112,24,8,1828,498,0.75,1330,0.7858985382631126
2004,3113,17,11,1239,612,0.6071428571428571,627,0.6693679092382496
2004,3114,10,17,657,962,0.37037037037037035,-305,0.40580605311920936
2004,3115,3,23,187,1279,0.11538461538461539,-1092,0.1275579809004093
2004,3116,16,12,1151,745,0.5714285714285714,406,0.6070675105485233
2004,3117,19,9,1405,520,0.6785714285714286,885,0.7298701298701299
2004,3119,13,14,881,789,0.48148148148148145,92,0.5275449101796407
2004,3120,21,8,1622,498,0.7241379310344828,1124,0.7650943396226415
2004,3122,22,7,1537,413,0.7586206896551724,1124,0.7882051282051282
2004,3123,13,16,1000,1101,0.4482758620689655,-101,0.47596382674916704
2004,3124,23,8,1850,512,0.7419354838709677,1338,0.7832345469940728
2004,3125,16,12,1161,750,0.5714285714285714,411,0.6075353218210361
2004,3126,14,14,1003,817,0.5,186,0.5510989010989011
2004,3127,17,10,1074,524,0.6296296296296297,550,0.672090112640801
2004,3128,13,16,802,854,0.4482758620689655,-52,0.48429951690821255
2004,3129,8,20,546,1167,0.2857142857142857,-621,0.318739054290718
2004,3130,25,6,1825,376,0.8064516129032258,1449,0.8291685597455702
2004,3131,19,11,1364,666,0.6333333333333333,698,0.6719211822660098
2004,3132,21,10,1545,688,0.6774193548387096,857,0.6918943125839677
2004,3133,9,19,652,1129,0.32142857142857145,-477,0.3660864682762493
2004,3135,16,11,1162,629,0.5925925925925926,533,0.6487995533221664
2004,3137,15,14,1087,784,0.5172413793103449,303,0.5809727418492785
2004,3138,6,21,394,1190,0.2222222222222222,-796,0.24873737373737373
2004,3139,14,15,990,874,0.4827586206896552,116,0.5311158798283262
2004,3140,15,14,1028,850,0.5172413793103449,178,0.5473908413205538
2004,3141,4,23,247,1257,0.14814814814814814,-1010,0.16422872340425532
2004,3142,13,14,973,830,0.48148148148148145,143,0.5396561286744315
2004,3143,12,17,870,1006,0.41379310344827586,-136,0.46375266524520253
2004,3144,9,18,579,987,0.3333333333333333,-408,0.36973180076628354
2004,3145,19,11,1426,727,0.6333333333333333,699,0.6623316302833256
2004,3147,3,23,217,1289,0.11538461538461539,-1072,0.14409030544488713
2004,3148,4,23,252,1188,0.14814814814814814,-936,0.175
2004,3149,9,17,646,933,0.34615384615384615,-287,0.409119696010133
2004,3150,16,13,1196,860,0.5517241379310345,336,0.5817120622568094
2004,3151,28,2,2087,125,0.9333333333333333,1962,0.9434900542495479
2004,3152,6,20,437,1120,0.23076923076923078,-683,0.2806679511881824
2004,3153,15,15,1090,863,0.5,227,0.558115719406042
2004,3155,17,10,1254,526,0.6296296296296297,728,0.7044943820224719
2004,3156,12,16,845,944,0.42857142857142855,-99,0.4723309111235327
2004,3157,11,15,762,810,0.4230769230769231,-48,0.4847328244274809
2004,3158,7,22,479,1253,0.2413793103448276,-774,0.27655889145496537
2004,3159,21,9,1592,567,0.7,1025,0.7373784159333024
2004,3160,22,7,1641,393,0.7586206896551724,1248,0.8067846607669616
2004,3161,17,11,1199,662,0.6071428571428571,537,0.6442772702847931
2004,3162,12,14,812,783,0.46153846153846156,29,0.509090909090909
2004,3163,25,4,1962,244,0.8620689655172413,1718,0.8893925657298277
2004,3164,18,11,1190,636,0.6206896551724138,554,0.651697699890471
2004,3165,9,18,627,1048,0.3333333333333333,-421,0.3743283582089552
2004,3166,19,9,1381,567,0.6785714285714286,814,0.7089322381930184
2004,3168,9,20,628,1114,0.3103448275862069,-486,0.3605051664753157
2004,3169,6,20,399,1202,0.23076923076923078,-803,0.24921923797626483
2004,3170,1,26,56,1293,0.037037037037037035,-1237,0.04151223128243143
2004,3171,15,12,1148,716,0.5555555555555556,432,0.6158798283261803
2004,3172,16,12,1076,720,0.5714285714285714,356,0.5991091314031181
2004,3173,3,25,213,1389,0.10714285714285714,-1176,0.13295880149812733
2004,3174,19,10,1230,609,0.6551724137931034,621,0.6688417618270799
2004,3175,21,9,1321,438,0.7,883,0.7509948834565093
2004,3176,14,15,922,833,0.4827586206896552,89,0.5253561253561253
2004,3177,22,6,1971,418,0.7857142857142857,1553,0.8250313938886563
2004,3178,17,12,1068,591,0.5862068965517241,477,0.64376130198915
2004,3179,16,14,1060,796,0.5333333333333333,264,0.5711206896551724
2004,3180,10,18,742,993,0.35714285714285715,-251,0.4276657060518732
2004,3181,27,3,2248,220,0.9,2028,0.9108589951377634
2004,3182,16,13,1168,798,0.5517241379310345,370,0.5940996948118006
2004,3183,6,19,432,1168,0.24,-736,0.27
2004,3184,15,16,1124,1014,0.4838709677419355,110,0.5257249766136576
2004,3185,21,7,1586,447,0.75,1139,0.780127889818003
2004,3186,12,16,893,971,0.42857142857142855,-78,0.4790772532188841
2004,3187,14,14,962,971,0.5,-9,0.4976720124159338
2004,3189,16,12,1141,593,0.5714285714285714,548,0.6580161476355249
2004,3190,13,14,964,800,0.48148148148148145,164,0.546485260770975
2004,3191,11,16,788,990,0.4074074074074074,-202,0.4431946006749156
2004,3192,13,15,932,935,0.4642857142857143,-3,0.499196572040707
2004,3193,10,19,716,1184,0.3448275862068966,-468,0.37684210526315787
2004,3194,12,16,902,1044,0.42857142857142855,-142,0.4635149023638232
2004,3196,18,10,1353,715,0.6428571428571429,638,0.6542553191489362
2004,3197,17,12,1151,731,0.5862068965517241,420,0.6115834218916046
2004,3198,11,16,744,937,0.4074074074074074,-193,0.44259369422962525
2004,3199,14,14,1096,867,0.5,229,0.5583290881304126
2004,3200,11,17,734,909,0.39285714285714285,-175,0.44674376141205113
2004,3201,13,16,907,861,0.4482758620689655,46,0.5130090497737556
2004,3202,17,11,1186,675,0.6071428571428571,511,0.6372917786136486
2004,3203,22,7,1600,406,0.7586206896551724,1194,0.7976071784646062
2004,3204,14,14,927,704,0.5,223,0.5683629675045984
2004,3205,5,22,374,1206,0.18518518518518517,-832,0.23670886075949368
2004,3206,18,10,1312,618,0.6428571428571429,694,0.6797927461139897
2004,3207,13,15,916,848,0.4642857142857143,68,0.5192743764172335
2004,3208,22,9,1728,568,0.7096774193548387,1160,0.7526132404181185
2004,3209,18,11,1257,627,0.6206896551724138,630,0.6671974522292994
2004,3210,14,15,966,867,0.4827586206896552,99,0.5270049099836334
2004,3211,17,11,1177,633,0.6071428571428571,544,0.6502762430939226
2004,3212,11,13,842,740,0.4583333333333333,102,0.5322376738305942
2004,3214,17,12,1203,644,0.5862068965517241,559,0.6513264753654575
2004,3216,18,12,1118,646,0.6,472,0.6337868480725624
2004,3217,16,11,1246,769,0.5925925925925926,477,0.6183622828784119
2004,3218,8,20,497,1123,0.2857142857142857,-626,0.30679012345679013
2004,3219,13,13,864,729,0.5,135,0.5423728813559322
2004,3220,14,14,967,796,0.5,171,0.5484968803176404
2004,3221,13,15,931,954,0.4642857142857143,-23,0.49389920424403183
2004,3222,27,3,1868,190,0.9,1678,0.9076773566569485
2004,3224,11,17,820,1004,0.39285714285714285,-184,0.44956140350877194
2004,3225,22,7,1624,436,0.7586206896551724,1188,0.7883495145631068
2004,3226,18,8,1409,513,0.6923076923076923,896,0.7330905306971904
2004,3227,11,17,776,1043,0.39285714285714285,-267,0.42660802638812534
2004,3228,9,18,697,1059,0.3333333333333333,-362,0.3969248291571754
2004,3229,16,13,1262,844,0.5517241379310345,418,0.5992402659069326
2004,3231,12,17,816,995,0.41379310344827586,-179,0.45057979017117616
2004,3232,16,12,1286,793,0.5714285714285714,493,0.6185666185666185
2004,3233,7,21,505,1254,0.25,-749,0.2870949403069926
2004,3234,16,12,1245,808,0.5714285714285714,437,0.6064296151972722
2004,3235,15,14,1130,754,0.5172413793103449,376,0.5997876857749469
2004,3236,8,20,649,1306,0.2857142857142857,-657,0.3319693094629156
2004,3237,6,21,443,1163,0.2222222222222222,-720,0.27584059775840597
2004,3238,23,7,1405,363,0.7666666666666667,1042,0.794683257918552
2004,3239,2,24,122,1338,0.07692307692307693,-1216,0.08356164383561644
2004,3240,18,10,1414,644,0.6428571428571429,770,0.6870748299319728
2004,3241,13,18,896,1079,0.41935483870967744,-183,0.45367088607594935
2004,3242,9,19,649,1078,0.32142857142857145,-429,0.37579617834394907
2004,3243,24,5,1891,317,0.8275862068965517,1574,0.8564311594202898
2004,3245,19,9,1366,514,0.6785714285714286,852,0.7265957446808511
2004,3246,11,17,833,1030,0.39285714285714285,-197,0.44712828770799784
2004,3247,15,13,1033,767,0.5357142857142857,266,0.5738888888888889
2004,3248,1,27,64,1536,0.03571428571428571,-1472,0.04
2004,3249,2,21,124,1113,0.08695652173913043,-989,0.10024252223120453
2004,3250,13,16,941,892,0.4482758620689655,49,0.5133660665575559
2004,3251,25,6,1770,374,0.8064516129032258,1396,0.8255597014925373
2004,3252,20,11,1400,612,0.6451612903225806,788,0.6958250497017893
2004,3253,14,16,912,920,0.4666666666666667,-8,0.4978165938864629
2004,3254,10,17,579,877,0.37037037037037035,-298,0.39766483516483514
2004,3256,27,2,2279,149,0.9310344827586207,2130,0.9386326194398682
2004,3257,20,9,1463,587,0.6896551724137931,876,0.7136585365853658
2004,3258,24,5,1528,247,0.8275862068965517,1281,0.8608450704225352
2004,3259,14,15,945,820,0.4827586206896552,125,0.5354107648725213
2004,3260,11,17,764,1062,0.39285714285714285,-298,0.4184008762322015
2004,3261,23,7,1801,420,0.7666666666666667,1381,0.8108959927960379
2004,3263,25,6,1675,345,0.8064516129032258,1330,0.8292079207920792
2004,3264,11,18,674,980,0.3793103448275862,-306,0.407496977025393
2004,3265,20,10,1316,538,0.6666666666666666,778,0.7098166127292341
2004,3266,21,9,1412,539,0.7,873,0.7237314197847258
2004,3267,18,12,1265,713,0.6,552,0.6395348837209303
2004,3268,17,12,1289,684,0.5862068965517241,605,0.6533198175367461
2004,3269,6,22,377,1103,0.21428571428571427,-726,0.25472972972972974
2004,3270,11,17,707,919,0.39285714285714285,-212,0.43480934809348093
2004,3271,12,17,955,1048,0.41379310344827586,-93,0.4767848227658512
2004,3272,20,9,1488,568,0.6896551724137931,920,0.7237354085603113
2004,3273,13,15,839,826,0.4642857142857143,13,0.5039039039039039
2004,3274,22,6,1704,350,0.7857142857142857,1354,0.8296007789678675
2004,3275,21,8,1707,550,0.7241379310344828,1157,0.7563136907399203
2004,3276,14,17,944,945,0.45161290322580644,-1,0.49973530968766544
2004,3277,21,8,1407,470,0.7241379310344828,937,0.7496004262120405
2004,3278,21,8,1586,458,0.7241379310344828,1128,0.7759295499021527
2004,3279,17,13,1343,848,0.5666666666666667,495,0.61296211775445
2004,3280,14,15,1026,884,0.4827586206896552,142,0.53717277486911
2004,3281,17,12,1317,766,0.5862068965517241,551,0.6322611617858858
2004,3282,15,14,1045,845,0.5172413793103449,200,0.5529100529100529
2004,3283,28,3,2227,194,0.9032258064516129,2033,0.9198678232135481
2004,3284,17,13,1138,742,0.5666666666666667,396,0.6053191489361702
2004,3285,25,4,1757,195,0.8620689655172413,1562,0.9001024590163934
2004,3286,13,14,976,816,0.48148148148148145,160,0.5446428571428571
2004,3287,11,18,781,1103,0.3793103448275862,-322,0.4145435244161359
2004,3288,3,24,209,1141,0.1111111111111111,-932,0.15481481481481482
2004,3290,6,19,378,1013,0.24,-635,0.2717469446441409
2004,3291,9,18,652,1158,0.3333333333333333,-506,0.3602209944751381
2004,3292,23,7,1598,433,0.7666666666666667,1165,0.7868045297882816
2004,3293,13,15,941,972,0.4642857142857143,-31,0.49189754312598016
2004,3296,12,16,848,925,0.42857142857142855,-77,0.47828539199097575
2004,3298,13,17,939,954,0.43333333333333335,-15,0.4960380348652932
2004,3299,7,22,465,1138,0.2413793103448276,-673,0.29008109794135994
2004,3301,16,14,1157,851,0.5333333333333333,306,0.576195219123506
2004,3304,17,11,1191,674,0.6071428571428571,517,0.6386058981233244
2004,3305,3,26,213,1502,0.10344827586206896,-1289,0.12419825072886298
2004,3306,11,18,732,1012,0.3793103448275862,-280,0.4197247706422018
2004,3307,22,7,1438,342,0.7586206896551724,1096,0.8078651685393259
2004,3308,13,16,838,820,0.4482758620689655,18,0.5054282267792521
2004,3309,10,17,725,964,0.37037037037037035,-239,0.42924807578448787
2004,3310,18,10,1328,587,0.6428571428571429,741,0.6934725848563968
2004,3311,1,23,87,1288,0.041666666666666664,-1201,0.06327272727272727
2004,3313,8,21,541,1144,0.27586206896551724,-603,0.32106824925816024
2004,3314,24,6,1824,372,0.8,1452,0.8306010928961749
2004,3317,11,17,725,1011,0.39285714285714285,-286,0.4176267281105991
2004,3318,15,15,1052,798,0.5,254,0.5686486486486486
2004,3319,12,16,831,890,0.42857142857142855,-59,0.48285880302149914
2004,3320,12,17,858,1002,0.41379310344827586,-144,0.4612903225806452
2004,3321,8,20,464,996,0.2857142857142857,-532,0.3178082191780822
2004,3322,21,6,1595,368,0.7777777777777778,1227,0.8125318390219053
2004,3323,19,10,1286,591,0.6551724137931034,695,0.6851358550879062
2004,3324,17,11,1121,687,0.6071428571428571,434,0.6200221238938053
2004,3325,13,15,951,879,0.4642857142857143,72,0.519672131147541
2004,3326,20,9,1486,509,0.6896551724137931,977,0.7448621553884712
2004,3328,23,8,1755,477,0.7419354838709677,1278,0.7862903225806451
2004,3329,8,20,599,1036,0.2857142857142857,-437,0.36636085626911313
2004,3330,25,6,1928,347,0.8064516129032258,1581,0.8474725274725274
2004,3331,15,13,1073,683,0.5357142857142857,390,0.6110478359908884
2004,3332,14,15,926,841,0.4827586206896552,85,0.5240520656479909
2004,3333,14,14,956,833,0.5,123,0.534376746785914
2004,3334,15,14,1084,736,0.5172413793103449,348,0.5956043956043956
2004,3335,17,10,1247,634,0.6296296296296297,613,0.6629452418926103
2004,3336,25,5,1803,326,0.8333333333333334,1477,0.84687646782527
2004,3337,17,12,1214,678,0.5862068965517241,536,0.6416490486257929
2004,3338,6,20,387,1097,0.23076923076923078,-710,0.26078167115902967
2004,3339,13,15,970,878,0.4642857142857143,92,0.5248917748917749
2004,3340,6,22,424,1287,0.21428571428571427,-863,0.24780829924021042
2004,3341,3,21,179,1109,0.125,-930,0.1389751552795031
2004,3343,7,20,487,1087,0.25925925925925924,-600,0.30940279542566707
2004,3344,4,23,248,1235,0.14814814814814814,-987,0.1672285906945381
2004,3345,27,3,1937,165,0.9,1772,0.9215033301617507
2004,3346,18,11,1303,698,0.6206896551724138,605,0.6511744127936032
2004,3347,13,14,895,706,0.48148148148148145,189,0.5590256089943785
2004,3348,16,13,1052,783,0.5517241379310345,269,0.5732970027247957
2004,3349,21,9,1487,504,0.7,983,0.7468608739326972
2004,3350,20,9,1497,548,0.6896551724137931,949,0.7320293398533008
2004,3351,5,23,353,1397,0.17857142857142858,-1044,0.2017142857142857
2004,3352,2,24,136,1285,0.07692307692307693,-1149,0.09570724841660802
2004,3353,21,11,1372,622,0.65625,750,0.6880641925777332
2004,3354,9,19,615,1042,0.32142857142857145,-427,0.3711526855763428
2004,3356,3,24,211,1376,0.1111111111111111,-1165,0.13295526149968495
2004,3357,21,8,1552,452,0.7241379310344828,1100,0.7744510978043913
2004,3358,7,20,499,1066,0.25925925925925924,-567,0.31884984025559104
2004,3359,10,17,603,932,0.37037037037037035,-329,0.39283387622149835
2004,3360,7,22,513,1251,0.2413793103448276,-738,0.29081632653061223
2004,3361,8,20,474,1027,0.2857142857142857,-553,0.3157894736842105
2004,3362,10,18,647,1005,0.35714285714285715,-358,0.3916464891041162
2004,3363,16,13,1101,738,0.5517241379310345,363,0.598694942903752
2004,3364,25,6,1827,351,0.8064516129032258,1476,0.8388429752066116
2004,3365,9,20,609,1244,0.3103448275862069,-635,0.328656233135456
2004,3366,6,20,364,997,0.23076923076923078,-633,0.2674504041146216
2004,3368,8,15,573,790,0.34782608695652173,-217,0.4203961848862803
2004,3369,15,13,1217,779,0.5357142857142857,438,0.6097194388777555
2004,3371,14,14,911,706,0.5,205,0.5633889919604206
2004,3372,9,19,656,1132,0.32142857142857145,-476,0.3668903803131991
2004,3373,17,11,1127,628,0.6071428571428571,499,0.6421652421652422
2004,3374,13,15,866,866,0.4642857142857143,0,0.5
2004,3375,22,6,1388,319,0.7857142857142857,1069,0.8131224370240188
2004,3376,10,18,838,1041,0.35714285714285715,-203,0.44598190526875997
2004,3378,14,14,1056,841,0.5,215,0.5566684238270954
2004,3379,14,13,915,730,0.5185185185185185,185,0.5562310030395137
2004,3380,16,12,1105,614,0.5714285714285714,491,0.6428155904595695
2004,3381,16,10,1188,649,0.6153846153846154,539,0.6467065868263473
2004,3382,9,19,672,1100,0.32142857142857145,-428,0.3792325056433409
2004,3383,8,19,537,1017,0.2962962962962963,-480,0.34555984555984554
2004,3384,25,5,1916,323,0.8333333333333334,1593,0.8557391692719964
2004,3385,10,18,756,1040,0.35714285714285715,-284,0.4209354120267261
2004,3386,20,10,1324,547,0.6666666666666666,777,0.7076429716729022
2004,3387,8,19,592,1117,0.2962962962962963,-525,0.34640140433001754
2004,3388,15,14,922,766,0.5172413793103449,156,0.5462085308056872
2004,3389,15,15,1009,800,0.5,209,0.5577667219458264
2004,3390,24,6,1769,370,0.8,1399,0.8270219728845255
2004,3391,13,16,927,908,0.4482758620689655,19,0.5051771117166213
2004,3392,7,21,491,1278,0.25,-787,0.27755794234030523
2004,3393,6,21,373,1064,0.2222222222222222,-691,0.2595685455810717
2004,3394,16,9,1155,520,0.64,635,0.6895522388059702
2004,3395,24,6,1937,420,0.8,1517,0.8218073822655918
2004,3396,21,9,1351,489,0.7,862,0.7342391304347826
2004,3397,26,3,2008,193,0.896551724137931,1815,0.9123125851885506
2004,3399,18,11,1326,743,0.6206896551724138,583,0.6408893185113581
2004,3400,28,4,2102,219,0.875,1883,0.9056441189142611
2004,3401,9,19,619,1067,0.32142857142857145,-448,0.367141162514828
2004,3402,8,19,544,1015,0.2962962962962963,-471,0.34894162924951894
2004,3403,24,7,1779,483,0.7741935483870968,1296,0.786472148541114
2004,3404,10,16,687,992,0.38461538461538464,-305,0.4091721262656343
2004,3405,13,16,926,907,0.4482758620689655,19,0.5051827605019095
2004,3406,9,19,598,1053,0.32142857142857145,-455,0.36220472440944884
2004,3407,11,17,705,915,0.39285714285714285,-210,0.4351851851851852
2004,3408,10,18,672,1009,0.35714285714285715,-337,0.3997620464009518
2004,3409,19,11,1362,639,0.6333333333333333,723,0.6806596701649176
2004,3410,10,14,639,625,0.4166666666666667,14,0.5055379746835443
2004,3411,9,17,614,910,0.34615384615384615,-296,0.40288713910761154
2004,3412,9,19,664,1213,0.32142857142857145,-549,0.3537559936068194
2004,3414,6,20,369,1112,0.23076923076923078,-743,0.24915597569209993
2004,3415,7,20,478,1246,0.25925925925925924,-768,0.27726218097447797
2004,3416,17,13,1179,690,0.5666666666666667,489,0.6308186195826645
2004,3417,17,12,1244,687,0.5862068965517241,557,0.6442257897462454
2004,3418,13,15,847,803,0.4642857142857143,44,0.5133333333333333
2004,3419,18,11,1353,627,0.6206896551724138,726,0.6833333333333333
2004,3420,4,24,222,1108,0.14285714285714285,-886,0.16691729323308271
2004,3421,18,9,1154,463,0.6666666666666666,691,0.7136672850958565
2004,3422,9,19,627,1027,0.32142857142857145,-400,0.37908101571946795
2004,3423,15,13,961,731,0.5357142857142857,230,0.567966903073286
2004,3424,22,7,1658,410,0.7586206896551724,1248,0.8017408123791102
2004,3425,15,13,1058,831,0.5357142857142857,227,0.5600847008999471
2004,3426,18,12,1236,694,0.6,542,0.6404145077720207
2004,3427,15,14,922,776,0.5172413793103449,146,0.5429917550058893
2004,3428,24,7,1631,385,0.7741935483870968,1246,0.8090277777777778
2004,3429,5,21,345,1151,0.19230769230769232,-806,0.2306149732620321
2004,3431,16,13,1094,667,0.5517241379310345,427,0.6212379329926179
2004,3433,14,14,1027,832,0.5,195,0.5524475524475524
2004,3434,19,11,1262,614,0.6333333333333333,648,0.6727078891257996
2004,3435,24,7,1729,478,0.7741935483870968,1251,0.7834164023561395
2004,3436,14,13,1029,731,0.5185185185185185,298,0.584659090909091
2004,3437,22,6,1427,285,0.7857142857142857,1142,0.8335280373831776
2004,3438,13,16,907,943,0.4482758620689655,-36,0.49027027027027026
2004,3439,22,7,1493,339,0.7586206896551724,1154,0.8149563318777293
2004,3441,14,17,975,991,0.45161290322580644,-16,0.49593082400813837
2004,3442,19,9,1314,536,0.6785714285714286,778,0.7102702702702702
2004,3443,18,13,1288,860,0.5806451612903226,428,0.5996275605214153
2004,3444,17,12,1389,740,0.5862068965517241,649,0.6524189760450916
2004,3447,11,17,775,950,0.39285714285714285,-175,0.4492753623188406
2004,3448,12,17,846,1029,0.41379310344827586,-183,0.4512
2004,3449,17,12,1304,754,0.5862068965517241,550,0.6336248785228377
2004,3450,5,22,326,1233,0.18518518518518517,-907,0.20910840282232201
2004,3451,17,11,1126,604,0.6071428571428571,522,0.6508670520231213
2004,3452,21,10,1522,612,0.6774193548387096,910,0.7132146204311153
2004,3453,23,7,1617,408,0.7666666666666667,1209,0.7985185185185185
2004,3454,17,12,1139,685,0.5862068965517241,454,0.6244517543859649
2004,3455,10,18,720,1136,0.35714285714285715,-416,0.3879310344827586
2004,3456,11,18,774,1037,0.3793103448275862,-263,0.4273881833241303
2004,3457,3,22,199,1201,0.12,-1002,0.14214285714285715
2004,3458,10,17,631,916,0.37037037037037035,-285,0.4078862314156432
2004,3460,9,20,628,1142,0.3103448275862069,-514,0.35480225988700564
2004,3461,10,18,648,815,0.35714285714285715,-167,0.4429254955570745
2004,3462,17,12,1159,682,0.5862068965517241,477,0.6295491580662683
2004,3463,8,19,564,1108,0.2962962962962963,-544,0.3373205741626794
2004,3464,3,25,205,1310,0.10714285714285714,-1105,0.1353135313531353
2005,1102,17,12,1097,679,0.5862068965517241,418,0.6176801801801802
2005,1103,18,10,1358,647,0.6428571428571429,711,0.6773067331670823
2005,1104,23,7,1823,440,0.7666666666666667,1383,0.8055678303137428
2005,1105,16,13,1158,845,0.5517241379310345,313,0.5781328007988018
2005,1106,15,15,932,807,0.5,125,0.5359401955146637
2005,1107,13,15,952,934,0.4642857142857143,18,0.5047720042417816
2005,1108,6,22,373,1228,0.21428571428571427,-855,0.23297938788257339
2005,1110,16,12,1160,721,0.5714285714285714,439,0.6166932482721956
2005,1111,15,12,1173,758,0.5555555555555556,415,0.6074572760227861
2005,1112,27,6,2213,416,0.8181818181818182,1797,0.8417649296310384
2005,1113,18,13,1375,980,0.5806451612903226,395,0.583864118895966
2005,1114,15,10,1024,639,0.6,385,0.6157546602525557
2005,1115,5,21,337,1176,0.19230769230769232,-839,0.22273628552544614
2005,1116,18,12,1422,725,0.6,697,0.6623195156031673
2005,1117,13,13,1046,881,0.5,165,0.5428126621691749
2005,1119,1,24,63,1295,0.04,-1232,0.04639175257731959
2005,1120,14,17,1097,1094,0.45161290322580644,3,0.5006846188954815
2005,1122,13,19,922,1168,0.40625,-246,0.4411483253588517
2005,1123,14,13,1028,856,0.5185185185185185,172,0.5456475583864119
2005,1124,8,19,622,1149,0.2962962962962963,-527,0.3512140033879164
2005,1125,14,16,1056,1052,0.4666666666666667,4,0.5009487666034156
2005,1126,13,17,948,983,0.43333333333333335,-35,0.490937338166753
2005,1127,12,17,794,990,0.41379310344827586,-196,0.44506726457399104
2005,1128,15,14,1033,828,0.5172413793103449,205,0.555077915099409
2005,1129,15,18,1149,1190,0.45454545454545453,-41,0.49123557075673363
2005,1130,24,4,1757,257,0.8571428571428571,1500,0.8723932472691162
2005,1131,20,8,1327,461,0.7142857142857143,866,0.7421700223713646
2005,1132,17,11,1269,667,0.6071428571428571,602,0.6554752066115702
2005,1133,13,15,970,989,0.4642857142857143,-19,0.4951505870342011
2005,1135,12,16,879,970,0.42857142857142855,-91,0.4753921038399135
2005,1137,22,9,1471,500,0.7096774193548387,971,0.7463216641298833
2005,1138,22,9,1663,668,0.7096774193548387,995,0.7134277134277134
2005,1139,11,15,786,866,0.4230769230769231,-80,0.47578692493946734
2005,1140,7,21,533,1252,0.25,-719,0.29859943977591036
2005,1141,8,18,623,1096,0.3076923076923077,-473,0.3624200116346713
2005,1142,4,22,339,1409,0.15384615384615385,-1070,0.19393592677345536
2005,1143,13,16,923,1033,0.4482758620689655,-110,0.471881390593047
2005,1144,2,25,143,1538,0.07407407407407407,-1395,0.08506841165972635
2005,1145,11,18,840,1249,0.3793103448275862,-409,0.40210627094303497
2005,1147,2,24,150,1494,0.07692307692307693,-1344,0.09124087591240876
2005,1148,12,16,934,985,0.42857142857142855,-51,0.4867118290776446
2005,1149,12,16,774,847,0.42857142857142855,-73,0.47748303516347934
2005,1150,21,7,1689,505,0.75,1184,0.7698268003646308
2005,1151,17,10,1270,632,0.6296296296296297,638,0.6677181913774973
2005,1152,9,19,645,1163,0.32142857142857145,-518,0.3567477876106195
2005,1153,24,7,1894,475,0.7741935483870968,1419,0.7994934571549177
2005,1154,8,16,604,941,0.3333333333333333,-337,0.39093851132686086
2005,1155,16,15,1241,979,0.5161290322580645,262,0.559009009009009
2005,1156,7,17,513,1095,0.2916666666666667,-582,0.31902985074626866
2005,1157,8,18,593,1173,0.3076923076923077,-580,0.3357870894677237
2005,1158,18,10,1366,652,0.6428571428571429,714,0.6769078295341923
2005,1159,10,16,688,989,0.38461538461538464,-301,0.41025641025641024
2005,1160,13,16,972,1093,0.4482758620689655,-121,0.47070217917675544
2005,1161,9,17,746,1054,0.34615384615384615,-308,0.41444444444444445
2005,1162,12,15,826,908,0.4444444444444444,-82,0.47635524798154555
2005,1163,22,7,1813,467,0.7586206896551724,1346,0.7951754385964912
2005,1164,14,15,1001,764,0.4827586206896552,237,0.5671388101983003
2005,1165,12,14,811,853,0.46153846153846156,-42,0.4873798076923077
2005,1166,23,10,1684,676,0.696969696969697,1008,0.7135593220338983
2005,1168,18,10,1385,689,0.6428571428571429,696,0.6677917068466731
2005,1169,17,13,1263,887,0.5666666666666667,376,0.5874418604651163
2005,1170,10,16,798,977,0.38461538461538464,-179,0.4495774647887324
2005,1171,9,17,518,978,0.34615384615384615,-460,0.3462566844919786
2005,1172,18,8,1328,507,0.6923076923076923,821,0.7237057220708447
2005,1173,18,11,1154,723,0.6206896551724138,431,0.6148108684070325
2005,1174,11,20,781,1236,0.3548387096774194,-455,0.38720872583044125
2005,1175,19,13,1261,736,0.59375,525,0.6314471707561342
2005,1176,18,10,1350,687,0.6428571428571429,663,0.6627393225331369
2005,1177,19,10,1373,600,0.6551724137931034,773,0.6958945767866194
2005,1178,13,16,912,866,0.4482758620689655,46,0.5129358830146231
2005,1179,13,16,1023,987,0.4482758620689655,36,0.508955223880597
2005,1180,17,11,1257,689,0.6071428571428571,568,0.6459403905447071
2005,1181,25,5,2008,385,0.8333333333333334,1623,0.8391140827413289
2005,1182,8,22,623,1391,0.26666666666666666,-768,0.30933465739821253
2005,1183,11,16,803,1025,0.4074074074074074,-222,0.43927789934354483
2005,1184,19,8,1404,496,0.7037037037037037,908,0.7389473684210527
2005,1185,10,18,792,1237,0.35714285714285715,-445,0.39034006899950713
2005,1186,7,20,453,1205,0.25925925925925924,-752,0.2732207478890229
2005,1187,7,19,475,1153,0.2692307692307692,-678,0.2917690417690418
2005,1189,7,22,456,1283,0.2413793103448276,-827,0.2622196664749856
2005,1190,7,19,589,1350,0.2692307692307692,-761,0.3037648272305312
2005,1191,11,17,839,1147,0.39285714285714285,-308,0.42245720040281975
2005,1192,19,12,1414,885,0.6129032258064516,529,0.6150500217485864
2005,1193,15,15,1058,983,0.5,75,0.5183733463988242
2005,1194,10,17,852,1221,0.37037037037037035,-369,0.4109985528219971
2005,1196,23,7,1830,476,0.7666666666666667,1354,0.7935819601040763
2005,1197,14,15,1085,887,0.4827586206896552,198,0.5502028397565923
2005,1198,12,17,877,1070,0.41379310344827586,-193,0.4504365690806369
2005,1199,11,19,853,1187,0.36666666666666664,-334,0.4181372549019608
2005,1200,13,16,927,902,0.4482758620689655,25,0.5068343357025697
2005,1201,15,14,1119,961,0.5172413793103449,158,0.5379807692307692
2005,1202,12,13,862,831,0.48,31,0.5091553455404607
2005,1203,22,7,1783,457,0.7586206896551724,1326,0.7959821428571429
2005,1204,14,13,1228,921,0.5185185185185185,307,0.5714285714285714
2005,1205,16,12,1219,776,0.5714285714285714,443,0.6110275689223058
2005,1206,16,13,1297,830,0.5517241379310345,467,0.609779031499765
2005,1207,17,12,1119,738,0.5862068965517241,381,0.6025848142164781
2005,1208,8,20,610,1073,0.2857142857142857,-463,0.36244800950683304
2005,1209,13,15,1029,932,0.4642857142857143,97,0.5247322794492606
2005,1210,19,11,1492,745,0.6333333333333333,747,0.6669646848457756
2005,1211,25,4,2027,284,0.8620689655172413,1743,0.8771094764171354
2005,1212,12,12,850,743,0.5,107,0.5335844318895167
2005,1214,17,13,1214,759,0.5666666666666667,455,0.6153066396350735
2005,1216,8,20,559,1106,0.2857142857142857,-547,0.33573573573573573
2005,1217,12,15,927,886,0.4444444444444444,41,0.5113072255929398
2005,1218,16,13,1123,867,0.5517241379310345,256,0.564321608040201
2005,1219,11,17,903,1145,0.39285714285714285,-242,0.44091796875
2005,1220,21,8,1571,542,0.7241379310344828,1029,0.7434926644581165
2005,1221,24,6,1674,328,0.8,1346,0.8361638361638362
2005,1222,18,13,1326,831,0.5806451612903226,495,0.6147426981919333
2005,1224,5,23,408,1384,0.17857142857142858,-976,0.22767857142857142
2005,1225,7,21,458,1240,0.25,-782,0.2697290930506478
2005,1226,7,18,521,1059,0.28,-538,0.32974683544303796
2005,1227,13,13,930,873,0.5,57,0.5158069883527454
2005,1228,32,1,2491,64,0.9696969696969697,2427,0.9749510763209394
2005,1229,16,13,1173,748,0.5517241379310345,425,0.6106194690265486
2005,1231,15,13,1049,741,0.5357142857142857,308,0.5860335195530726
2005,1232,11,20,764,1126,0.3548387096774194,-362,0.4042328042328042
2005,1233,15,16,1191,1030,0.4838709677419355,161,0.5362449347140927
2005,1234,21,11,1603,740,0.65625,863,0.6841655996585574
2005,1235,18,11,1294,689,0.6206896551724138,605,0.6525466464952093
2005,1236,6,22,428,1300,0.21428571428571427,-872,0.24768518518518517
2005,1237,14,13,1013,882,0.5185185185185185,131,0.5345646437994723
2005,1238,14,17,972,1021,0.45161290322580644,-49,0.48770697441043653
2005,1239,14,13,1048,852,0.5185185185185185,196,0.5515789473684211
2005,1240,4,22,331,1412,0.15384615384615385,-1081,0.18990246701090074
2005,1241,6,22,402,1293,0.21428571428571427,-891,0.23716814159292035
2005,1242,23,6,1780,408,0.7931034482758621,1372,0.8135283363802559
2005,1243,15,12,1079,774,0.5555555555555556,305,0.5822989746357259
2005,1245,18,12,1336,729,0.6,607,0.6469733656174335
2005,1246,25,5,1909,303,0.8333333333333334,1606,0.8630198915009042
2005,1247,10,19,713,1104,0.3448275862068966,-391,0.3924050632911392
2005,1248,8,19,651,1155,0.2962962962962963,-504,0.36046511627906974
2005,1249,14,11,1169,781,0.56,388,0.5994871794871794
2005,1250,13,15,833,885,0.4642857142857143,-52,0.4848661233993015
2005,1251,12,15,909,907,0.4444444444444444,2,0.5005506607929515
2005,1252,14,12,1004,746,0.5384615384615384,258,0.5737142857142857
2005,1253,10,20,634,1186,0.3333333333333333,-552,0.34835164835164834
2005,1254,13,15,965,920,0.4642857142857143,45,0.5119363395225465
2005,1255,1,29,75,1836,0.03333333333333333,-1761,0.03924646781789639
2005,1256,14,15,1025,1015,0.4827586206896552,10,0.5024509803921569
2005,1257,27,4,2233,264,0.8709677419354839,1969,0.8942731277533039
2005,1258,11,17,764,1135,0.39285714285714285,-371,0.40231700895208006
2005,1259,6,22,455,1391,0.21428571428571427,-936,0.24647887323943662
2005,1260,12,17,894,1050,0.41379310344827586,-156,0.45987654320987653
2005,1261,20,9,1598,591,0.6896551724137931,1007,0.7300137048880767
2005,1263,13,15,870,884,0.4642857142857143,-14,0.4960091220068415
2005,1264,13,14,1043,913,0.48148148148148145,130,0.5332310838445807
2005,1265,11,17,816,1145,0.39285714285714285,-329,0.41611422743498216
2005,1266,18,11,1313,651,0.6206896551724138,662,0.6685336048879837
2005,1267,6,22,438,1431,0.21428571428571427,-993,0.23434991974317818
2005,1268,16,12,1406,899,0.5714285714285714,507,0.6099783080260304
2005,1269,16,12,1138,664,0.5714285714285714,474,0.6315205327413984
2005,1270,9,15,659,1093,0.375,-434,0.3761415525114155
2005,1271,2,26,157,1424,0.07142857142857142,-1267,0.09930423782416192
2005,1272,19,15,1496,906,0.5588235294117647,590,0.6228143213988343
2005,1273,14,12,1238,841,0.5384615384615384,397,0.5954785954785955
2005,1274,16,12,1203,801,0.5714285714285714,402,0.6002994011976048
2005,1275,18,10,1299,534,0.6428571428571429,765,0.7086743044189853
2005,1276,13,18,873,1038,0.41935483870967744,-165,0.45682888540031397
2005,1277,22,6,1759,427,0.7857142857142857,1332,0.8046660567246111
2005,1278,21,10,1519,603,0.6774193548387096,916,0.7158341187558906
2005,1279,14,17,1012,967,0.45161290322580644,45,0.5113693784739768
2005,1280,22,10,1669,649,0.6875,1020,0.7200172562553926
2005,1281,16,16,1075,979,0.5,96,0.5233690360272639
2005,1282,14,12,1117,768,0.5384615384615384,349,0.5925729442970822
2005,1283,18,12,1411,752,0.6,659,0.6523347202958854
2005,1284,16,13,1122,723,0.5517241379310345,399,0.608130081300813
2005,1285,16,12,1184,756,0.5714285714285714,428,0.6103092783505155
2005,1286,12,14,893,844,0.46153846153846156,49,0.514104778353483
2005,1287,8,16,581,909,0.3333333333333333,-328,0.38993288590604025
2005,1288,14,16,1016,946,0.4666666666666667,70,0.5178389398572885
2005,1290,13,15,916,959,0.4642857142857143,-43,0.4885333333333333
2005,1291,7,20,518,1247,0.25925925925925924,-729,0.2934844192634561
2005,1292,17,12,1291,745,0.5862068965517241,546,0.6340864440078585
2005,1293,15,11,1141,700,0.5769230769230769,441,0.6197718631178707
2005,1294,4,21,345,1239,0.16,-894,0.2178030303030303
2005,1296,11,17,815,1101,0.39285714285714285,-286,0.4253653444676409
2005,1298,8,18,640,1173,0.3076923076923077,-533,0.3530060672917816
2005,1299,6,24,433,1503,0.2,-1070,0.22365702479338842
2005,1301,19,13,1509,854,0.59375,655,0.6385950063478629
2005,1304,14,14,1075,830,0.5,245,0.5643044619422573
2005,1305,23,6,1606,411,0.7931034482758621,1195,0.7962320277640059
2005,1306,8,19,552,1175,0.2962962962962963,-623,0.31962941517081644
2005,1307,25,6,1969,383,0.8064516129032258,1586,0.8371598639455783
2005,1308,4,24,278,1579,0.14285714285714285,-1301,0.14970382337102853
2005,1309,12,17,846,1084,0.41379310344827586,-238,0.4383419689119171
2005,1310,20,9,1724,746,0.6896551724137931,978,0.6979757085020243
2005,1311,3,21,274,1423,0.125,-1149,0.1614614024749558
2005,1313,13,14,879,798,0.48148148148148145,81,0.5241502683363148
2005,1314,27,4,2459,293,0.8709677419354839,2166,0.893531976744186
2005,1317,12,14,911,958,0.46153846153846156,-47,0.48742643124665597
2005,1318,21,9,1637,575,0.7,1062,0.7400542495479204
2005,1319,9,17,737,1213,0.34615384615384615,-476,0.3779487179487179
2005,1320,20,10,1486,689,0.6666666666666666,797,0.6832183908045977
2005,1321,15,16,931,897,0.4838709677419355,34,0.5092997811816192
2005,1322,17,12,1366,744,0.5862068965517241,622,0.64739336492891
2005,1323,17,11,1166,712,0.6071428571428571,454,0.6208732694355698
2005,1324,11,18,821,1219,0.3793103448275862,-398,0.4024509803921569
2005,1325,21,10,1580,646,0.6774193548387096,934,0.7097933513027853
2005,1326,20,12,1493,780,0.625,713,0.656841179058513
2005,1328,24,7,1838,500,0.7741935483870968,1338,0.786142001710864
2005,1329,23,6,1853,412,0.7931034482758621,1441,0.8181015452538631
2005,1330,27,5,1931,319,0.84375,1612,0.8582222222222222
2005,1331,24,7,1893,486,0.7741935483870968,1407,0.7957124842370744
2005,1332,14,13,1083,832,0.5185185185185185,251,0.5655352480417755
2005,1333,17,14,1326,919,0.5483870967741935,407,0.5906458797327394
2005,1334,26,3,1914,186,0.896551724137931,1728,0.9114285714285715
2005,1335,20,8,1470,447,0.7142857142857143,1023,0.7668231611893583
2005,1336,6,23,448,1361,0.20689655172413793,-913,0.2476506357103372
2005,1337,16,14,1289,951,0.5333333333333333,338,0.5754464285714286
2005,1338,20,8,1496,530,0.7142857142857143,966,0.7384007897334649
2005,1339,14,15,1049,947,0.4827586206896552,102,0.5255511022044088
2005,1340,17,9,1312,580,0.6538461538461539,732,0.693446088794926
2005,1341,5,23,316,1278,0.17857142857142858,-962,0.19824341279799249
2005,1343,14,13,859,657,0.5185185185185185,202,0.566622691292876
2005,1344,13,17,1040,1189,0.43333333333333335,-149,0.46657694033198743
2005,1345,7,21,511,1251,0.25,-740,0.29001135073779793
2005,1346,9,17,764,1173,0.34615384615384615,-409,0.39442436757873
2005,1347,10,16,803,954,0.38461538461538464,-151,0.4570290267501423
2005,1348,6,22,412,1208,0.21428571428571427,-796,0.254320987654321
2005,1349,17,11,1303,757,0.6071428571428571,546,0.6325242718446602
2005,1350,14,15,1043,891,0.4827586206896552,152,0.5392967942088935
2005,1351,18,11,1412,743,0.6206896551724138,669,0.6552204176334107
2005,1352,13,15,952,959,0.4642857142857143,-7,0.4981684981684982
2005,1353,9,19,644,1156,0.32142857142857145,-512,0.35777777777777775
2005,1354,19,12,1331,755,0.6129032258064516,576,0.6380632790028763
2005,1356,25,7,1707,433,0.78125,1274,0.7976635514018692
2005,1357,4,23,255,1501,0.14814814814814814,-1246,0.14521640091116172
2005,1358,14,12,1102,722,0.5384615384615384,380,0.6041666666666666
2005,1359,13,13,898,767,0.5,131,0.5393393393393393
2005,1360,14,13,1122,937,0.5185185185185185,185,0.5449247207382224
2005,1361,9,18,651,1188,0.3333333333333333,-537,0.3539967373572594
2005,1362,16,13,1169,831,0.5517241379310345,338,0.5845
2005,1363,6,23,459,1310,0.20689655172413793,-851,0.2594686263425664
2005,1364,11,18,704,1014,0.3793103448275862,-310,0.409778812572759
2005,1365,14,16,1077,1144,0.4666666666666667,-67,0.48491670418730304
2005,1368,19,8,1171,484,0.7037037037037037,687,0.7075528700906344
2005,1369,11,14,807,917,0.44,-110,0.4680974477958237
2005,1371,12,16,810,946,0.42857142857142855,-136,0.4612756264236902
2005,1372,9,15,650,824,0.375,-174,0.44097693351424694
2005,1373,6,24,411,1511,0.2,-1100,0.21383975026014568
2005,1374,13,14,1002,868,0.48148148148148145,134,0.5358288770053476
2005,1375,7,18,473,1041,0.28,-568,0.31241743725231175
2005,1376,15,13,1054,859,0.5357142857142857,195,0.5509670674333508
2005,1378,13,16,1000,966,0.4482758620689655,34,0.508646998982706
2005,1379,8,17,601,1055,0.32,-454,0.36292270531400966
2005,1380,12,15,789,938,0.4444444444444444,-149,0.4568616097278518
2005,1381,11,15,847,944,0.4230769230769231,-97,0.47292015633724177
2005,1382,2,26,150,1568,0.07142857142857142,-1418,0.08731082654249127
2005,1383,13,15,1028,933,0.4642857142857143,95,0.5242223355430903
2005,1384,14,13,1053,824,0.5185185185185185,229,0.5610015982951518
2005,1385,9,18,622,1116,0.3333333333333333,-494,0.3578826237054085
2005,1386,19,11,1302,631,0.6333333333333333,671,0.6735644076564925
2005,1387,9,21,564,1129,0.3,-565,0.33313644418192556
2005,1388,23,8,1666,503,0.7419354838709677,1163,0.7680958967266022
2005,1389,15,13,1187,1013,0.5357142857142857,174,0.5395454545454546
2005,1390,18,12,1324,779,0.6,545,0.6295767950546838
2005,1391,9,17,637,1091,0.34615384615384615,-454,0.36863425925925924
2005,1392,12,17,784,1009,0.41379310344827586,-225,0.4372559955382041
2005,1393,27,6,2102,389,0.8181818181818182,1713,0.8438378161380972
2005,1394,16,8,1211,513,0.6666666666666666,698,0.7024361948955916
2005,1395,18,13,1337,841,0.5806451612903226,496,0.6138659320477502
2005,1396,16,13,1067,797,0.5517241379310345,270,0.5724248927038627
2005,1397,14,17,1053,1085,0.45161290322580644,-32,0.49251637043966323
2005,1398,12,16,1002,1072,0.42857142857142855,-70,0.4831243972999036
2005,1399,15,11,1147,729,0.5769230769230769,418,0.6114072494669509
2005,1400,19,10,1536,707,0.6551724137931034,829,0.6847971466785555
2005,1401,17,9,1383,526,0.6538461538461539,857,0.7244630696699843
2005,1402,10,14,718,887,0.4166666666666667,-169,0.4473520249221184
2005,1403,20,10,1686,640,0.6666666666666666,1046,0.7248495270851246
2005,1404,4,21,271,1372,0.16,-1101,0.16494217894096166
2005,1405,15,13,1119,846,0.5357142857142857,273,0.5694656488549619
2005,1406,5,24,396,1407,0.1724137931034483,-1011,0.21963394342762063
2005,1407,11,18,884,1249,0.3793103448275862,-365,0.4144397562119081
2005,1408,9,18,675,1116,0.3333333333333333,-441,0.3768844221105528
2005,1409,9,20,694,1376,0.3103448275862069,-682,0.3352657004830918
2005,1410,8,16,619,977,0.3333333333333333,-358,0.38784461152882205
2005,1411,10,15,688,942,0.4,-254,0.42208588957055215
2005,1412,21,10,1684,728,0.6774193548387096,956,0.6981757877280266
2005,1413,10,17,783,1033,0.37037037037037035,-250,0.43116740088105726
2005,1414,15,13,1135,750,0.5357142857142857,385,0.6021220159151194
2005,1415,8,19,547,1096,0.2962962962962963,-549,0.3329275715155204
2005,1416,21,8,1451,529,0.7241379310344828,922,0.7328282828282828
2005,1417,18,10,1396,676,0.6428571428571429,720,0.6737451737451737
2005,1418,19,10,1435,663,0.6551724137931034,772,0.6839847473784557
2005,1419,5,19,351,1152,0.20833333333333334,-801,0.23353293413173654
2005,1420,10,18,673,1020,0.35714285714285715,-347,0.39751919669226227
2005,1421,9,17,708,1116,0.34615384615384615,-408,0.3881578947368421
2005,1422,15,12,1132,752,0.5555555555555556,380,0.6008492569002123
2005,1423,19,10,1245,641,0.6551724137931034,604,0.6601272534464475
2005,1424,15,13,1177,848,0.5357142857142857,329,0.5812345679012346
2005,1425,12,17,1015,1144,0.41379310344827586,-129,0.4701250578971746
2005,1426,9,15,706,944,0.375,-238,0.42787878787878786
2005,1427,12,13,981,906,0.48,75,0.519872813990461
2005,1428,25,5,1733,288,0.8333333333333334,1445,0.8574962889658585
2005,1429,24,7,1833,429,0.7741935483870968,1404,0.8103448275862069
2005,1430,14,12,1010,725,0.5384615384615384,285,0.5821325648414986
2005,1431,25,7,1994,427,0.78125,1567,0.8236266005782734
2005,1433,19,12,1407,771,0.6129032258064516,636,0.6460055096418733
2005,1434,15,16,1121,1057,0.4838709677419355,64,0.5146923783287419
2005,1435,18,13,1394,826,0.5806451612903226,568,0.627927927927928
2005,1436,24,6,1803,375,0.8,1428,0.8278236914600551
2005,1437,22,7,1658,481,0.7586206896551724,1177,0.7751285647498831
2005,1438,14,15,1035,1077,0.4827586206896552,-42,0.4900568181818182
2005,1439,15,13,1116,818,0.5357142857142857,298,0.5770423991726991
2005,1440,7,18,493,1107,0.28,-614,0.308125
2005,1441,5,22,357,1442,0.18518518518518517,-1085,0.19844357976653695
2005,1442,9,17,651,1067,0.34615384615384615,-416,0.3789289871944121
2005,1443,20,8,1559,571,0.7142857142857143,988,0.7319248826291079
2005,1444,18,12,1326,863,0.6,463,0.6057560529922339
2005,1447,13,17,876,986,0.43333333333333335,-110,0.47046186895810954
2005,1448,26,5,2212,414,0.8387096774193549,1798,0.8423457730388424
2005,1449,26,5,2278,395,0.8387096774193549,1883,0.8522259633370745
2005,1450,12,16,700,866,0.42857142857142855,-166,0.44699872286079184
2005,1451,13,16,910,978,0.4482758620689655,-68,0.4819915254237288
2005,1452,21,10,1612,565,0.6774193548387096,1047,0.7404685346807534
2005,1453,16,11,1157,654,0.5925925925925926,503,0.6388735505245721
2005,1454,22,5,1685,310,0.8148148148148148,1375,0.8446115288220551
2005,1455,20,9,1505,563,0.6896551724137931,942,0.7277562862669246
2005,1456,8,21,603,1277,0.27586206896551724,-674,0.32074468085106383
2005,1457,24,5,1647,289,0.8275862068965517,1358,0.8507231404958677
2005,1458,22,8,1558,457,0.7333333333333333,1101,0.7732009925558313
2005,1459,10,14,786,901,0.4166666666666667,-115,0.46591582691167754
2005,1460,15,15,1040,878,0.5,162,0.5422314911366006
2005,1461,15,13,1109,877,0.5357142857142857,232,0.5584088620342397
2005,1462,17,12,1262,771,0.5862068965517241,491,0.6207575012297097
2005,1463,11,16,807,1024,0.4074074074074074,-217,0.4407427635172037
2005,1464,3,23,209,1324,0.11538461538461539,-1115,0.13633398564905413
2005,3102,6,21,399,1162,0.2222222222222222,-763,0.2556053811659193
2005,3103,3,25,194,1346,0.10714285714285714,-1152,0.12597402597402596
2005,3104,14,14,1018,839,0.5,179,0.5481960150780829
2005,3105,15,12,903,634,0.5555555555555556,269,0.5875081327260898
2005,3106,15,14,923,698,0.5172413793103449,225,0.5694016039481802
2005,3107,14,14,962,750,0.5,212,0.5619158878504673
2005,3108,20,7,1352,376,0.7407407407407407,976,0.7824074074074074
2005,3110,12,16,756,832,0.42857142857142855,-76,0.4760705289672544
2005,3111,11,17,760,1012,0.39285714285714285,-252,0.4288939051918736
2005,3112,19,11,1480,663,0.6333333333333333,817,0.6906206252916472
2005,3113,22,9,1477,459,0.7096774193548387,1018,0.7629132231404959
2005,3114,10,19,557,1027,0.3448275862068966,-470,0.35164141414141414
2005,3115,4,21,236,1010,0.16,-774,0.18940609951845908
2005,3116,16,13,1162,744,0.5517241379310345,418,0.6096537250786989
2005,3117,19,10,1411,579,0.6551724137931034,832,0.7090452261306532
2005,3119,14,13,951,726,0.5185185185185185,225,0.5670840787119857
2005,3120,16,13,1057,792,0.5517241379310345,265,0.5716603569497025
2005,3122,8,19,599,1104,0.2962962962962963,-505,0.35173223722842045
2005,3123,16,13,1191,782,0.5517241379310345,409,0.6036492650785605
2005,3124,27,3,2001,224,0.9,1777,0.8993258426966292
2005,3125,17,11,1205,663,0.6071428571428571,542,0.6450749464668094
2005,3126,5,20,318,1115,0.2,-797,0.22191207257501744
2005,3127,10,18,644,1024,0.35714285714285715,-380,0.38609112709832133
2005,3128,11,15,716,758,0.4230769230769231,-42,0.48575305291723203
2005,3129,10,19,661,1068,0.3448275862068966,-407,0.3823019086176981
2005,3130,19,9,1395,488,0.6785714285714286,907,0.7408390865639937
2005,3131,15,16,1075,920,0.4838709677419355,155,0.5388471177944862
2005,3132,23,7,1770,374,0.7666666666666667,1396,0.8255597014925373
2005,3133,15,13,1148,822,0.5357142857142857,326,0.582741116751269
2005,3135,18,9,1213,499,0.6666666666666666,714,0.7085280373831776
2005,3137,10,18,702,961,0.35714285714285715,-259,0.4221286831028262
2005,3138,4,24,239,1231,0.14285714285714285,-992,0.16258503401360544
2005,3139,13,14,832,766,0.48148148148148145,66,0.5206508135168961
2005,3140,19,10,1318,549,0.6551724137931034,769,0.7059453668987681
2005,3141,9,18,625,1034,0.3333333333333333,-409,0.3767329716696805
2005,3142,11,16,730,963,0.4074074074074074,-233,0.43118724158298877
2005,3143,11,18,779,1126,0.3793103448275862,-347,0.4089238845144357
2005,3144,9,18,597,925,0.3333333333333333,-328,0.39224704336399474
2005,3145,21,9,1430,590,0.7,840,0.7079207920792079
2005,3148,9,19,595,982,0.32142857142857145,-387,0.3772986683576411
2005,3149,11,15,698,723,0.4230769230769231,-25,0.4912033779028853
2005,3150,21,8,1538,515,0.7241379310344828,1023,0.749147588894301
2005,3151,24,4,1730,186,0.8571428571428571,1544,0.9029227557411273
2005,3152,11,15,692,742,0.4230769230769231,-50,0.4825662482566248
2005,3153,9,18,573,960,0.3333333333333333,-387,0.37377690802348335
2005,3155,8,20,559,1177,0.2857142857142857,-618,0.3220046082949309
2005,3156,4,25,278,1462,0.13793103448275862,-1184,0.15977011494252874
2005,3157,8,17,452,878,0.32,-426,0.3398496240601504
2005,3158,14,14,908,712,0.5,196,0.5604938271604938
2005,3159,12,18,885,1176,0.4,-291,0.4294032023289665
2005,3160,9,19,632,1131,0.32142857142857145,-499,0.35847986386840613
2005,3161,15,13,1086,725,0.5357142857142857,361,0.5996686913307565
2005,3162,12,15,746,782,0.4444444444444444,-36,0.4882198952879581
2005,3163,23,7,1704,402,0.7666666666666667,1302,0.8091168091168092
2005,3164,23,7,1582,421,0.7666666666666667,1161,0.7898152770843735
2005,3165,3,24,196,1251,0.1111111111111111,-1055,0.1354526606772633
2005,3166,19,9,1478,550,0.6785714285714286,928,0.7287968441814595
2005,3168,8,20,551,1110,0.2857142857142857,-559,0.3317278747742324
2005,3169,18,11,1262,641,0.6206896551724138,621,0.6631634261692065
2005,3170,8,20,516,1054,0.2857142857142857,-538,0.3286624203821656
2005,3171,17,10,1193,601,0.6296296296296297,592,0.664994425863991
2005,3172,18,11,1232,711,0.6206896551724138,521,0.6340710241893979
2005,3173,12,16,808,818,0.42857142857142855,-10,0.4969249692496925
2005,3174,25,5,1644,314,0.8333333333333334,1330,0.839632277834525
2005,3175,16,12,852,530,0.5714285714285714,322,0.6164978292329957
2005,3176,6,22,364,1105,0.21428571428571427,-741,0.24778761061946902
2005,3177,25,4,2147,258,0.8620689655172413,1889,0.8927234927234927
2005,3178,9,20,575,1068,0.3103448275862069,-493,0.349969567863664
2005,3179,14,15,983,902,0.4827586206896552,81,0.5214854111405836
2005,3180,19,10,1221,512,0.6551724137931034,709,0.7045585689555683
2005,3181,28,4,2224,251,0.875,1973,0.8985858585858586
2005,3182,10,18,726,1011,0.35714285714285715,-285,0.41796200345423146
2005,3183,9,17,614,1037,0.34615384615384615,-423,0.37189582071471833
2005,3184,23,7,1659,455,0.7666666666666667,1204,0.7847682119205298
2005,3185,22,7,1598,408,0.7586206896551724,1190,0.7966101694915254
2005,3186,14,12,942,677,0.5384615384615384,265,0.5818406423718344
2005,3187,10,18,698,995,0.35714285714285715,-297,0.4122858830478441
2005,3189,3,24,208,1209,0.1111111111111111,-1001,0.14678899082568808
2005,3190,12,17,915,1003,0.41379310344827586,-88,0.4770594369134515
2005,3191,17,11,1187,695,0.6071428571428571,492,0.630712008501594
2005,3192,2,25,123,1434,0.07407407407407407,-1311,0.0789980732177264
2005,3193,12,17,851,1047,0.41379310344827586,-196,0.44836670179135935
2005,3194,12,16,884,928,0.42857142857142855,-44,0.4878587196467991
2005,3196,14,14,998,879,0.5,119,0.5316995205114544
2005,3197,14,16,942,914,0.4666666666666667,28,0.5075431034482759
2005,3198,18,11,1198,619,0.6206896551724138,579,0.6593285635663181
2005,3199,23,7,1671,400,0.7666666666666667,1271,0.8068565910188314
2005,3200,9,21,531,1060,0.3,-529,0.33375235700817096
2005,3201,20,10,1357,695,0.6666666666666666,662,0.6613060428849903
2005,3202,17,10,1172,603,0.6296296296296297,569,0.660281690140845
2005,3203,22,8,1505,432,0.7333333333333333,1073,0.7769747031491998
2005,3204,16,14,1101,839,0.5333333333333333,262,0.5675257731958763
2005,3205,9,18,573,1013,0.3333333333333333,-440,0.36128625472887765
2005,3206,12,16,799,835,0.42857142857142855,-36,0.488984088127295
2005,3207,12,16,885,872,0.42857142857142855,13,0.5036994877632328
2005,3208,21,9,1631,539,0.7,1092,0.7516129032258064
2005,3209,16,14,1100,775,0.5333333333333333,325,0.5866666666666667
2005,3210,13,14,812,759,0.48148148148148145,53,0.5168682367918523
2005,3211,27,3,1905,178,0.9,1727,0.914546327412386
2005,3212,13,15,828,802,0.4642857142857143,26,0.5079754601226993
2005,3214,14,13,955,734,0.5185185185185185,221,0.5654233274126702
2005,3216,22,8,1326,410,0.7333333333333333,916,0.7638248847926268
2005,3217,20,8,1506,485,0.7142857142857143,1021,0.7564038171772979
2005,3218,11,15,747,825,0.4230769230769231,-78,0.4751908396946565
2005,3219,15,12,987,659,0.5555555555555556,328,0.5996354799513973
2005,3220,13,16,902,998,0.4482758620689655,-96,0.4747368421052632
2005,3221,20,10,1410,573,0.6666666666666666,837,0.7110438729198184
2005,3222,21,8,1495,447,0.7241379310344828,1048,0.7698249227600412
2005,3224,17,12,1200,771,0.5862068965517241,429,0.60882800608828
2005,3225,19,11,1317,662,0.6333333333333333,655,0.6654876200101061
2005,3226,11,16,881,939,0.4074074074074074,-58,0.48406593406593407
2005,3227,14,15,961,957,0.4827586206896552,4,0.5010427528675704
2005,3228,17,12,1241,662,0.5862068965517241,579,0.652128218602207
2005,3229,13,17,964,1081,0.43333333333333335,-117,0.4713936430317848
2005,3231,10,18,585,863,0.35714285714285715,-278,0.40400552486187846
2005,3232,22,8,1743,547,0.7333333333333333,1196,0.7611353711790393
2005,3233,6,22,434,1336,0.21428571428571427,-902,0.24519774011299436
2005,3234,20,9,1447,573,0.6896551724137931,874,0.7163366336633663
2005,3235,23,6,1823,389,0.7931034482758621,1434,0.8241410488245932
2005,3236,5,22,340,1259,0.18518518518518517,-919,0.21263289555972484
2005,3237,7,21,442,1071,0.25,-629,0.29213483146067415
2005,3238,11,17,723,882,0.39285714285714285,-159,0.4504672897196262
2005,3239,6,21,376,1221,0.2222222222222222,-845,0.23544145272385722
2005,3240,14,14,1005,835,0.5,170,0.5461956521739131
2005,3241,18,11,1229,634,0.6206896551724138,595,0.6596886741814278
2005,3242,12,15,797,769,0.4444444444444444,28,0.5089399744572158
2005,3243,23,7,1750,404,0.7666666666666667,1346,0.8124419684308264
2005,3245,21,9,1469,552,0.7,917,0.7268678871845621
2005,3246,15,14,1177,804,0.5172413793103449,373,0.5941443715295306
2005,3247,12,16,865,906,0.42857142857142855,-41,0.48842461885940147
2005,3248,5,22,314,1154,0.18518518518518517,-840,0.21389645776566757
2005,3249,5,18,341,1005,0.21739130434782608,-664,0.25334323922734026
2005,3250,19,10,1288,593,0.6551724137931034,695,0.684742158426369
2005,3251,23,6,1727,310,0.7931034482758621,1417,0.8478154148257241
2005,3252,12,15,796,875,0.4444444444444444,-79,0.476361460203471
2005,3253,19,9,1365,568,0.6785714285714286,797,0.7061562338334195
2005,3254,9,18,575,965,0.3333333333333333,-390,0.37337662337662336
2005,3255,13,13,871,672,0.5,199,0.5644847699287103
2005,3256,20,9,1553,580,0.6896551724137931,973,0.7280825128926395
2005,3257,22,8,1534,441,0.7333333333333333,1093,0.7767088607594936
2005,3258,16,13,1035,713,0.5517241379310345,322,0.5921052631578947
2005,3259,10,18,648,988,0.35714285714285715,-340,0.3960880195599022
2005,3260,7,21,515,1185,0.25,-670,0.3029411764705882
2005,3261,29,2,2122,114,0.9354838709677419,2008,0.9490161001788909
2005,3263,20,9,1351,481,0.6896551724137931,870,0.7374454148471615
2005,3264,11,18,725,928,0.3793103448275862,-203,0.43859649122807015
2005,3265,22,7,1348,369,0.7586206896551724,979,0.7850902737332557
2005,3266,18,11,1299,637,0.6206896551724138,662,0.6709710743801653
2005,3267,19,10,1424,613,0.6551724137931034,811,0.6990672557682867
2005,3268,21,9,1644,554,0.7,1090,0.7479526842584168
2005,3269,14,15,846,755,0.4827586206896552,91,0.52841973766396
2005,3270,10,18,685,932,0.35714285714285715,-247,0.4236239950525665
2005,3271,12,16,770,833,0.42857142857142855,-63,0.48034934497816595
2005,3272,13,16,848,929,0.4482758620689655,-81,0.4772087788407428
2005,3273,12,16,806,889,0.42857142857142855,-83,0.4755162241887906
2005,3274,13,16,949,907,0.4482758620689655,42,0.5113146551724138
2005,3275,15,14,1053,824,0.5172413793103449,229,0.5610015982951518
2005,3276,5,23,308,1290,0.17857142857142858,-982,0.1927409261576971
2005,3277,28,3,2027,185,0.9032258064516129,1842,0.916365280289331
2005,3278,24,7,1713,401,0.7741935483870968,1312,0.8103122043519394
2005,3279,19,10,1461,601,0.6551724137931034,860,0.7085354025218235
2005,3280,17,11,1228,663,0.6071428571428571,565,0.6493918561607614
2005,3281,11,18,755,979,0.3793103448275862,-224,0.4354094579008074
2005,3282,10,20,643,1028,0.3333333333333333,-385,0.38479952124476363
2005,3283,20,8,1547,505,0.7142857142857143,1042,0.7538986354775828
2005,3284,17,11,1092,622,0.6071428571428571,470,0.6371061843640606
2005,3285,21,7,1431,361,0.75,1070,0.7985491071428571
2005,3286,7,18,500,976,0.28,-476,0.33875338753387535
2005,3287,4,22,264,1314,0.15384615384615385,-1050,0.16730038022813687
2005,3288,4,23,271,1334,0.14814814814814814,-1063,0.16884735202492213
2005,3290,9,16,560,804,0.36,-244,0.41055718475073316
2005,3291,9,19,596,1087,0.32142857142857145,-491,0.3541295306001188
2005,3292,23,7,1520,425,0.7666666666666667,1095,0.781491002570694
2005,3293,9,19,691,1190,0.32142857142857145,-499,0.36735778841042
2005,3294,8,16,532,840,0.3333333333333333,-308,0.3877551020408163
2005,3296,6,20,370,1129,0.23076923076923078,-759,0.24683122081387593
2005,3298,11,18,713,1012,0.3793103448275862,-299,0.41333333333333333
2005,3299,10,18,771,987,0.35714285714285715,-216,0.43856655290102387
2005,3301,21,7,1483,427,0.75,1056,0.7764397905759163
2005,3304,17,13,1318,752,0.5666666666666667,566,0.6367149758454106
2005,3305,8,22,532,1256,0.26666666666666666,-724,0.2975391498881432
2005,3306,15,14,992,721,0.5172413793103449,271,0.5791009924109749
2005,3307,26,4,1774,197,0.8666666666666667,1577,0.900050735667174
2005,3308,8,19,484,881,0.2962962962962963,-397,0.3545787545787546
2005,3309,2,26,121,1199,0.07142857142857142,-1078,0.09166666666666666
2005,3310,17,12,1222,647,0.5862068965517241,575,0.6538255751738897
2005,3311,6,18,394,967,0.25,-573,0.2894930198383541
2005,3313,12,18,820,1006,0.4,-186,0.44906900328587074
2005,3314,27,3,2170,221,0.9,1949,0.9075700543705563
2005,3317,14,14,859,758,0.5,101,0.531230674087817
2005,3318,14,15,930,886,0.4827586206896552,44,0.512114537444934
2005,3319,19,10,1295,549,0.6551724137931034,746,0.7022776572668112
2005,3320,19,11,1233,607,0.6333333333333333,626,0.6701086956521739
2005,3321,5,25,324,1387,0.16666666666666666,-1063,0.18936294564582115
2005,3322,14,12,1043,723,0.5384615384615384,320,0.5906002265005662
2005,3323,26,5,1787,279,0.8387096774193549,1508,0.8649564375605033
2005,3324,21,8,1511,507,0.7241379310344828,1004,0.7487611496531219
2005,3325,13,16,966,1026,0.4482758620689655,-60,0.48493975903614456
2005,3326,28,4,2072,251,0.875,1821,0.8919500645716746
2005,3328,16,12,1193,722,0.5714285714285714,471,0.622976501305483
2005,3329,6,19,405,1014,0.24,-609,0.2854122621564482
2005,3330,22,8,1645,505,0.7333333333333333,1140,0.7651162790697674
2005,3331,20,8,1323,431,0.7142857142857143,892,0.7542759407069556
2005,3332,20,9,1406,520,0.6896551724137931,886,0.7300103842159917
2005,3333,5,23,345,1344,0.17857142857142858,-999,0.20426287744227353
2005,3334,5,22,301,1111,0.18518518518518517,-810,0.2131728045325779
2005,3335,15,12,911,685,0.5555555555555556,226,0.5708020050125313
2005,3336,19,10,1402,604,0.6551724137931034,798,0.6989032901296112
2005,3337,12,17,821,888,0.41379310344827586,-67,0.4803978935049737
2005,3338,13,15,951,798,0.4642857142857143,153,0.5437392795883362
2005,3339,6,22,427,1213,0.21428571428571427,-786,0.2603658536585366
2005,3340,3,23,214,1234,0.11538461538461539,-1020,0.1477900552486188
2005,3341,5,21,288,1026,0.19230769230769232,-738,0.2191780821917808
2005,3343,13,14,851,743,0.48148148148148145,108,0.5338770388958595
2005,3344,1,27,59,1180,0.03571428571428571,-1121,0.047619047619047616
2005,3345,15,12,1021,665,0.5555555555555556,356,0.6055753262158956
2005,3346,16,13,1079,741,0.5517241379310345,338,0.5928571428571429
2005,3347,11,16,743,859,0.4074074074074074,-116,0.4637952559300874
2005,3348,8,20,529,1122,0.2857142857142857,-593,0.32041187159297396
2005,3349,24,8,1708,470,0.75,1238,0.7842056932966024
2005,3350,23,7,1582,392,0.7666666666666667,1190,0.8014184397163121
2005,3351,9,20,594,1058,0.3103448275862069,-464,0.3595641646489104
2005,3352,20,10,1324,558,0.6666666666666666,766,0.7035069075451648
2005,3353,24,6,1595,313,0.8,1282,0.8359538784067087
2005,3354,10,19,650,995,0.3448275862068966,-345,0.3951367781155015
2005,3356,3,24,208,1259,0.1111111111111111,-1051,0.141785957736878
2005,3357,18,11,1241,621,0.6206896551724138,620,0.6664876476906552
2005,3358,6,18,378,979,0.25,-601,0.27855563743551953
2005,3359,13,15,816,752,0.4642857142857143,64,0.5204081632653061
2005,3360,9,19,682,1056,0.32142857142857145,-374,0.3924050632911392
2005,3361,7,20,495,1034,0.25925925925925924,-539,0.3237410071942446
2005,3362,11,16,766,918,0.4074074074074074,-152,0.45486935866983375
2005,3363,18,12,1127,711,0.6,416,0.6131664853101197
2005,3364,21,8,1604,482,0.7241379310344828,1122,0.7689357622243528
2005,3365,17,13,1329,834,0.5666666666666667,495,0.6144244105409153
2005,3366,4,22,269,1049,0.15384615384615385,-780,0.20409711684370258
2005,3368,6,17,415,937,0.2608695652173913,-522,0.3069526627218935
2005,3369,20,8,1497,536,0.7142857142857143,961,0.736350221347762
2005,3371,14,14,841,645,0.5,196,0.5659488559892328
2005,3372,12,16,800,931,0.42857142857142855,-131,0.4621606008087811
2005,3373,13,16,838,882,0.4482758620689655,-44,0.4872093023255814
2005,3374,19,10,1269,609,0.6551724137931034,660,0.6757188498402555
2005,3375,13,15,782,786,0.4642857142857143,-4,0.4987244897959184
2005,3376,8,21,581,1103,0.27586206896551724,-522,0.34501187648456055
2005,3378,20,10,1438,537,0.6666666666666666,901,0.7281012658227848
2005,3379,9,19,609,994,0.32142857142857145,-385,0.3799126637554585
2005,3380,16,14,1007,761,0.5333333333333333,246,0.5695701357466063
2005,3381,9,17,600,930,0.34615384615384615,-330,0.39215686274509803
2005,3382,9,19,595,1017,0.32142857142857145,-422,0.36910669975186106
2005,3383,10,18,623,948,0.35714285714285715,-325,0.3965626989178867
2005,3384,21,9,1514,564,0.7,950,0.7285851780558229
2005,3385,19,10,1362,539,0.6551724137931034,823,0.7164650184113625
2005,3386,7,23,417,1123,0.23333333333333334,-706,0.2707792207792208
2005,3387,4,23,264,1266,0.14814814814814814,-1002,0.17254901960784313
2005,3388,15,13,1007,699,0.5357142857142857,308,0.5902696365767878
2005,3389,11,17,767,1002,0.39285714285714285,-235,0.43357829282080274
2005,3390,29,2,2272,125,0.9354838709677419,2147,0.9478514810179391
2005,3391,17,13,1185,775,0.5666666666666667,410,0.6045918367346939
2005,3392,8,20,592,1298,0.2857142857142857,-706,0.31322751322751324
2005,3393,13,16,823,853,0.4482758620689655,-30,0.49105011933174225
2005,3394,21,6,1450,345,0.7777777777777778,1105,0.807799442896936
2005,3395,22,9,1638,563,0.7096774193548387,1075,0.7442071785552021
2005,3396,27,3,1854,157,0.9,1697,0.921929388363998
2005,3397,26,4,1934,225,0.8666666666666667,1709,0.8957850856878184
2005,3398,10,16,613,891,0.38461538461538464,-278,0.40757978723404253
2005,3399,21,8,1544,484,0.7241379310344828,1060,0.7613412228796844
2005,3400,21,8,1550,488,0.7241379310344828,1062,0.760549558390579
2005,3401,14,14,1032,762,0.5,270,0.5752508361204013
2005,3402,14,13,993,756,0.5185185185185185,237,0.5677530017152659
2005,3403,22,7,1686,399,0.7586206896551724,1287,0.8086330935251799
2005,3404,8,19,557,1060,0.2962962962962963,-503,0.34446505875077305
2005,3405,14,15,931,851,0.4827586206896552,80,0.5224466891133558
2005,3406,16,14,1047,809,0.5333333333333333,238,0.5641163793103449
2005,3407,14,15,953,862,0.4827586206896552,91,0.525068870523416
2005,3408,11,16,755,877,0.4074074074074074,-122,0.46262254901960786
2005,3409,19,10,1382,621,0.6551724137931034,761,0.689965052421368
2005,3410,10,14,628,676,0.4166666666666667,-48,0.4815950920245399
2005,3411,5,23,305,1226,0.17857142857142858,-921,0.1992161985630307
2005,3412,7,21,504,1113,0.25,-609,0.3116883116883117
2005,3413,8,17,563,1013,0.32,-450,0.35723350253807107
2005,3414,8,21,593,1223,0.27586206896551724,-630,0.32654185022026433
2005,3415,16,13,1055,725,0.5517241379310345,330,0.5926966292134831
2005,3416,19,10,1237,524,0.6551724137931034,713,0.7024417944349801
2005,3417,16,12,1225,792,0.5714285714285714,433,0.6073376301437778
2005,3418,21,9,1472,498,0.7,974,0.7472081218274111
2005,3419,21,8,1447,458,0.7241379310344828,989,0.7595800524934383
2005,3420,8,20,523,1005,0.2857142857142857,-482,0.34227748691099474
2005,3421,17,12,1086,642,0.5862068965517241,444,0.6284722222222222
2005,3422,14,14,986,751,0.5,235,0.5676453655728267
2005,3423,8,20,535,1093,0.2857142857142857,-558,0.3286240786240786
2005,3424,16,14,1199,828,0.5333333333333333,371,0.5915145535273804
2005,3425,18,10,1299,634,0.6428571428571429,665,0.6720124159337817
2005,3426,21,9,1361,438,0.7,923,0.7565314063368538
2005,3427,16,12,1042,651,0.5714285714285714,391,0.6154754873006497
2005,3428,25,7,1721,385,0.78125,1336,0.8171889838556505
2005,3429,14,14,979,803,0.5,176,0.5493827160493827
2005,3430,4,21,239,1145,0.16,-906,0.1726878612716763
2005,3431,11,17,742,952,0.39285714285714285,-210,0.4380165289256198
2005,3433,11,18,748,978,0.3793103448275862,-230,0.43337195828505215
2005,3434,17,10,1109,527,0.6296296296296297,582,0.6778728606356969
2005,3435,22,7,1816,470,0.7586206896551724,1346,0.7944006999125109
2005,3436,14,15,1014,898,0.4827586206896552,116,0.5303347280334728
2005,3437,19,11,1178,598,0.6333333333333333,580,0.6632882882882883
2005,3438,20,10,1429,600,0.6666666666666666,829,0.7042878265155249
2005,3439,17,11,1335,730,0.6071428571428571,605,0.6464891041162227
2005,3441,17,13,1260,839,0.5666666666666667,421,0.6002858504049547
2005,3442,17,9,1095,462,0.6538461538461539,633,0.7032755298651252
2005,3443,20,9,1658,611,0.6896551724137931,1047,0.7307183781401498
2005,3444,10,18,713,1084,0.35714285714285715,-371,0.39677239844184753
2005,3447,2,25,126,1252,0.07407407407407407,-1126,0.09143686502177069
2005,3448,15,14,1143,881,0.5172413793103449,262,0.5647233201581028
2005,3449,14,16,1024,993,0.4666666666666667,31,0.5076846802181457
2005,3450,6,22,402,1208,0.21428571428571427,-806,0.2496894409937888
2005,3451,21,8,1522,458,0.7241379310344828,1064,0.7686868686868686
2005,3452,17,12,1246,702,0.5862068965517241,544,0.6396303901437371
2005,3453,25,3,1836,183,0.8928571428571429,1653,0.9093610698365527
2005,3454,14,13,969,778,0.5185185185185185,191,0.5546651402404121
2005,3455,5,22,369,1210,0.18518518518518517,-841,0.233692210259658
2005,3456,4,24,252,1305,0.14285714285714285,-1053,0.16184971098265896
2005,3457,2,26,122,1187,0.07142857142857142,-1065,0.0932009167303285
2005,3458,12,16,948,964,0.42857142857142855,-16,0.49581589958158995
2005,3459,2,24,144,1377,0.07692307692307693,-1233,0.09467455621301775
2005,3460,19,11,1296,632,0.6333333333333333,664,0.6721991701244814
2005,3461,15,12,1005,656,0.5555555555555556,349,0.605057194461168
2005,3462,20,9,1411,546,0.6896551724137931,865,0.7210015329586101
2005,3463,6,21,405,1070,0.2222222222222222,-665,0.2745762711864407
2005,3464,12,16,854,903,0.42857142857142855,-49,0.4860557768924303
2006,1102,22,6,1430,348,0.7857142857142857,1082,0.8042744656917885
2006,1103,21,9,1544,600,0.7,944,0.7201492537313433
2006,1104,17,12,1269,760,0.5862068965517241,509,0.6254312469196649
2006,1105,11,12,911,790,0.4782608695652174,121,0.5355673133450911
2006,1106,12,18,877,1108,0.4,-231,0.4418136020151133
2006,1107,21,10,1507,628,0.6774193548387096,879,0.7058548009367681
2006,1108,8,20,617,1231,0.2857142857142857,-614,0.3338744588744589
2006,1110,12,17,858,992,0.41379310344827586,-134,0.46378378378378377
2006,1111,12,16,863,1045,0.42857142857142855,-182,0.4523060796645702
2006,1112,19,12,1439,822,0.6129032258064516,617,0.6364440513047325
2006,1113,11,17,802,1076,0.39285714285714285,-274,0.42705005324813633
2006,1114,13,15,905,889,0.4642857142857143,16,0.5044593088071349
2006,1115,11,16,741,915,0.4074074074074074,-174,0.447463768115942
2006,1116,22,9,1680,624,0.7096774193548387,1056,0.7291666666666666
2006,1117,10,18,763,1250,0.35714285714285715,-487,0.3790362642821659
2006,1119,3,22,200,1162,0.12,-962,0.14684287812041116
2006,1120,12,16,857,979,0.42857142857142855,-122,0.46677559912854033
2006,1122,17,14,1300,928,0.5483870967741935,372,0.5834829443447038
2006,1123,8,18,542,1084,0.3076923076923077,-542,0.3333333333333333
2006,1124,4,13,330,744,0.23529411764705882,-414,0.30726256983240224
2006,1125,20,10,1741,714,0.6666666666666666,1027,0.7091649694501019
2006,1126,15,15,1090,872,0.5,218,0.5555555555555556
2006,1127,16,13,1051,761,0.5517241379310345,290,0.5800220750551877
2006,1128,17,9,1206,534,0.6538461538461539,672,0.6931034482758621
2006,1129,13,15,991,1022,0.4642857142857143,-31,0.49230004967709884
2006,1130,25,7,1911,474,0.78125,1437,0.8012578616352202
2006,1131,12,16,801,849,0.42857142857142855,-48,0.48545454545454547
2006,1132,7,21,488,1324,0.25,-836,0.2693156732891832
2006,1133,20,10,1496,650,0.6666666666666666,846,0.6971109040074557
2006,1135,10,17,699,914,0.37037037037037035,-215,0.4333539987600744
2006,1137,25,4,1684,239,0.8620689655172413,1445,0.875715028601144
2006,1138,18,13,1312,909,0.5806451612903226,403,0.5907248986942819
2006,1139,19,12,1337,801,0.6129032258064516,536,0.6253507951356407
2006,1140,19,8,1536,541,0.7037037037037037,995,0.7395281656234954
2006,1141,3,24,225,1367,0.1111111111111111,-1142,0.14133165829145727
2006,1142,8,19,549,1199,0.2962962962962963,-650,0.31407322654462244
2006,1143,20,10,1474,602,0.6666666666666666,872,0.710019267822736
2006,1144,10,18,865,1454,0.35714285714285715,-589,0.3730056058645968
2006,1145,9,20,709,1341,0.3103448275862069,-632,0.34585365853658534
2006,1147,3,23,221,1491,0.11538461538461539,-1270,0.12908878504672897
2006,1148,18,11,1367,735,0.6206896551724138,632,0.6503330161750713
2006,1149,10,15,753,930,0.4,-177,0.4474153297682709
2006,1150,18,12,1323,754,0.6,569,0.6369764082811747
2006,1151,15,13,1115,826,0.5357142857142857,289,0.5744461617722824
2006,1152,11,19,832,1228,0.36666666666666664,-396,0.40388349514563104
2006,1153,18,12,1447,775,0.6,672,0.6512151215121512
2006,1154,6,21,442,1246,0.2222222222222222,-804,0.2618483412322275
2006,1155,17,12,1358,782,0.5862068965517241,576,0.6345794392523364
2006,1156,8,18,516,1127,0.3076923076923077,-611,0.3140596469872185
2006,1157,16,10,1195,605,0.6153846153846154,590,0.6638888888888889
2006,1158,15,11,1103,756,0.5769230769230769,347,0.593329747175901
2006,1159,9,19,598,1020,0.32142857142857145,-422,0.3695920889987639
2006,1160,20,9,1654,590,0.6896551724137931,1064,0.7370766488413547
2006,1161,14,15,1061,1044,0.4827586206896552,17,0.5040380047505938
2006,1162,10,16,654,993,0.38461538461538464,-339,0.3970856102003643
2006,1163,27,3,2213,227,0.9,1986,0.9069672131147541
2006,1164,12,18,851,1068,0.4,-217,0.44346013548723295
2006,1165,12,15,821,863,0.4444444444444444,-42,0.48752969121140144
2006,1166,19,9,1342,517,0.6785714285714286,825,0.7218934911242604
2006,1168,15,13,1226,970,0.5357142857142857,256,0.558287795992714
2006,1169,10,17,749,1120,0.37037037037037035,-371,0.40074906367041196
2006,1170,13,15,1048,1061,0.4642857142857143,-13,0.4969179706021811
2006,1171,6,21,398,1234,0.2222222222222222,-836,0.24387254901960784
2006,1172,17,10,1361,680,0.6296296296296297,681,0.6668299853013229
2006,1173,13,17,903,998,0.43333333333333335,-95,0.47501315097317204
2006,1174,9,21,667,1316,0.3,-649,0.3363590519415028
2006,1175,20,13,1248,654,0.6060606060606061,594,0.6561514195583596
2006,1176,16,15,1125,935,0.5161290322580645,190,0.5461165048543689
2006,1177,12,15,866,886,0.4444444444444444,-20,0.4942922374429224
2006,1178,14,16,1004,894,0.4666666666666667,110,0.5289778714436248
2006,1179,10,19,731,1221,0.3448275862068966,-490,0.3744877049180328
2006,1180,15,16,944,986,0.4838709677419355,-42,0.48911917098445595
2006,1181,30,3,2489,234,0.9090909090909091,2255,0.9140653690782226
2006,1182,3,24,249,1537,0.1111111111111111,-1288,0.13941769316909294
2006,1183,6,21,408,1191,0.2222222222222222,-783,0.2551594746716698
2006,1184,13,16,956,1061,0.4482758620689655,-105,0.4739712444224095
2006,1185,7,21,493,1342,0.25,-849,0.2686648501362398
2006,1186,14,15,1097,1037,0.4827586206896552,60,0.514058106841612
2006,1187,6,20,426,1154,0.23076923076923078,-728,0.26962025316455696
2006,1189,12,14,857,834,0.46153846153846156,23,0.5068007096392667
2006,1190,15,13,1343,941,0.5357142857142857,402,0.5880035026269702
2006,1191,10,19,698,1197,0.3448275862068966,-499,0.3683377308707124
2006,1192,19,11,1450,754,0.6333333333333333,696,0.6578947368421053
2006,1193,9,19,727,1291,0.32142857142857145,-564,0.36025768087215065
2006,1194,15,13,1224,831,0.5357142857142857,393,0.5956204379562043
2006,1196,27,6,2181,435,0.8181818181818182,1746,0.8337155963302753
2006,1197,13,17,981,1017,0.43333333333333335,-36,0.49099099099099097
2006,1198,7,20,456,1199,0.25925925925925924,-743,0.2755287009063444
2006,1199,19,9,1514,653,0.6785714285714286,861,0.6986617443470236
2006,1200,16,16,1187,981,0.5,206,0.547509225092251
2006,1201,15,13,1227,840,0.5357142857142857,387,0.5936139332365747
2006,1202,12,13,893,838,0.48,55,0.5158867706528019
2006,1203,26,2,2100,111,0.9285714285714286,1989,0.9497964721845319
2006,1204,18,9,1495,568,0.6666666666666666,927,0.7246728065923412
2006,1205,17,12,1255,747,0.5862068965517241,508,0.6268731268731269
2006,1206,23,7,1660,422,0.7666666666666667,1238,0.7973102785782901
2006,1207,21,9,1478,522,0.7,956,0.739
2006,1208,15,15,1151,959,0.5,192,0.5454976303317536
2006,1209,7,22,549,1339,0.2413793103448276,-790,0.2907838983050847
2006,1210,11,17,839,1173,0.39285714285714285,-334,0.41699801192842945
2006,1211,27,3,2173,230,0.9,1943,0.9042863087806908
2006,1212,12,13,852,811,0.48,41,0.5123271196632592
2006,1214,16,15,1180,891,0.5161290322580645,289,0.5697730564944471
2006,1216,12,15,871,938,0.4444444444444444,-67,0.48148148148148145
2006,1217,13,14,926,881,0.48148148148148145,45,0.5124515771997786
2006,1218,17,11,1239,654,0.6071428571428571,585,0.6545166402535658
2006,1219,14,13,1112,862,0.5185185185185185,250,0.563323201621074
2006,1220,24,6,1791,413,0.8,1378,0.8126134301270418
2006,1221,20,12,1457,667,0.625,790,0.685969868173258
2006,1222,19,9,1406,572,0.6785714285714286,834,0.7108190091001011
2006,1224,7,22,519,1364,0.2413793103448276,-845,0.27562400424853956
2006,1225,3,25,223,1452,0.10714285714285714,-1229,0.13313432835820896
2006,1226,11,14,877,1040,0.44,-163,0.45748565466875324
2006,1227,16,14,1170,887,0.5333333333333333,283,0.5687894992707827
2006,1228,25,6,1823,346,0.8064516129032258,1477,0.8404794836330106
2006,1229,8,19,501,999,0.2962962962962963,-498,0.334
2006,1231,18,11,1377,687,0.6206896551724138,690,0.6671511627906976
2006,1232,12,16,824,956,0.42857142857142855,-132,0.46292134831460674
2006,1233,23,7,1914,497,0.7666666666666667,1417,0.7938614682704273
2006,1234,25,8,1734,457,0.7575757575757576,1277,0.7914194431766317
2006,1235,15,14,1198,1021,0.5172413793103449,177,0.5398828301036503
2006,1236,8,18,532,1099,0.3076923076923077,-567,0.3261802575107296
2006,1237,17,10,1252,614,0.6296296296296297,638,0.6709539121114684
2006,1238,14,17,1068,1151,0.45161290322580644,-83,0.48129788192879674
2006,1239,1,26,88,1895,0.037037037037037035,-1807,0.044377206253151794
2006,1240,15,13,1197,926,0.5357142857142857,271,0.5638247762600094
2006,1241,5,23,384,1419,0.17857142857142858,-1035,0.2129783693843594
2006,1242,24,7,1859,446,0.7741935483870968,1413,0.8065075921908894
2006,1243,15,13,1088,823,0.5357142857142857,265,0.5693354264782836
2006,1244,11,15,852,975,0.4230769230769231,-123,0.4663382594417077
2006,1245,24,8,1837,469,0.75,1368,0.7966175195143105
2006,1246,21,12,1548,777,0.6363636363636364,771,0.6658064516129032
2006,1247,18,10,1322,619,0.6428571428571429,703,0.6810922205048944
2006,1248,9,17,662,1040,0.34615384615384615,-378,0.3889541715628672
2006,1249,14,13,1202,914,0.5185185185185185,288,0.5680529300567108
2006,1250,17,12,1122,656,0.5862068965517241,466,0.6310461192350956
2006,1251,4,23,307,1362,0.14814814814814814,-1055,0.18394248052726184
2006,1252,21,10,1607,649,0.6774193548387096,958,0.712322695035461
2006,1253,17,12,1478,912,0.5862068965517241,566,0.6184100418410042
2006,1254,11,16,801,1050,0.4074074074074074,-249,0.4327390599675851
2006,1255,8,20,638,1376,0.2857142857142857,-738,0.31678252234359483
2006,1256,19,12,1350,687,0.6129032258064516,663,0.6627393225331369
2006,1257,18,12,1332,762,0.6,570,0.6361031518624641
2006,1258,12,18,963,1215,0.4,-252,0.44214876033057854
2006,1259,15,13,1198,954,0.5357142857142857,244,0.5566914498141264
2006,1260,17,11,1303,692,0.6071428571428571,611,0.6531328320802005
2006,1261,22,8,1707,536,0.7333333333333333,1171,0.7610343290236291
2006,1263,10,16,692,954,0.38461538461538464,-262,0.4204131227217497
2006,1264,18,10,1460,687,0.6428571428571429,773,0.680018630647415
2006,1265,19,10,1487,743,0.6551724137931034,744,0.6668161434977579
2006,1266,19,10,1459,693,0.6551724137931034,766,0.6779739776951673
2006,1267,12,16,845,1000,0.42857142857142855,-155,0.45799457994579945
2006,1268,18,12,1502,821,0.6,681,0.6465777012483858
2006,1269,13,15,918,898,0.4642857142857143,20,0.5055066079295154
2006,1270,11,14,806,964,0.44,-158,0.4553672316384181
2006,1271,7,22,490,1392,0.2413793103448276,-902,0.2603613177470776
2006,1272,30,3,2471,199,0.9090909090909091,2272,0.9254681647940075
2006,1273,9,19,735,1323,0.32142857142857145,-588,0.35714285714285715
2006,1274,16,15,1202,926,0.5161290322580645,276,0.5648496240601504
2006,1275,18,10,1194,576,0.6428571428571429,618,0.6745762711864407
2006,1276,18,10,1331,666,0.6428571428571429,665,0.6664997496244367
2006,1277,21,11,1654,712,0.65625,942,0.6990701606086221
2006,1278,15,14,1075,836,0.5172413793103449,239,0.5625327053898482
2006,1279,14,16,1039,912,0.4666666666666667,127,0.5325474115838031
2006,1280,15,15,1121,922,0.5,199,0.5487028879099364
2006,1281,12,16,877,979,0.42857142857142855,-102,0.47252155172413796
2006,1282,13,14,1027,873,0.48148148148148145,154,0.5405263157894736
2006,1283,20,8,1615,494,0.7142857142857143,1121,0.7657657657657657
2006,1284,18,14,1224,851,0.5625,373,0.5898795180722891
2006,1285,21,6,1658,452,0.7777777777777778,1206,0.785781990521327
2006,1286,13,14,1036,935,0.48148148148148145,101,0.5256215119228818
2006,1287,3,23,200,1356,0.11538461538461539,-1156,0.12853470437017994
2006,1288,4,26,290,1356,0.13333333333333333,-1066,0.17618469015795868
2006,1290,9,18,617,1023,0.3333333333333333,-406,0.37621951219512195
2006,1291,13,17,898,1041,0.43333333333333335,-143,0.4631253223310985
2006,1292,15,12,1133,752,0.5555555555555556,381,0.6010610079575597
2006,1293,23,6,1711,351,0.7931034482758621,1360,0.8297769156159069
2006,1294,3,24,241,1502,0.1111111111111111,-1261,0.13826735513482502
2006,1295,12,12,906,773,0.5,133,0.5396069088743299
2006,1296,16,11,1191,713,0.5925925925925926,478,0.6255252100840336
2006,1298,8,18,616,1091,0.3076923076923077,-475,0.36086701816051553
2006,1299,6,23,401,1389,0.20689655172413793,-988,0.2240223463687151
2006,1301,21,9,1682,589,0.7,1093,0.7406428885953324
2006,1304,19,13,1357,782,0.59375,575,0.6344086021505376
2006,1305,26,5,1904,335,0.8387096774193549,1569,0.8503796337650736
2006,1306,12,17,814,906,0.41379310344827586,-92,0.47325581395348837
2006,1307,17,13,1136,803,0.5666666666666667,333,0.5858690046415678
2006,1308,15,14,1104,919,0.5172413793103449,185,0.5457241720217498
2006,1309,8,19,547,1169,0.2962962962962963,-622,0.31876456876456877
2006,1310,11,18,899,1239,0.3793103448275862,-340,0.4204864359214219
2006,1311,8,18,638,1157,0.3076923076923077,-519,0.3554317548746518
2006,1313,13,18,918,1000,0.41935483870967744,-82,0.4786235662148071
2006,1314,22,7,1831,500,0.7586206896551724,1331,0.7854997854997855
2006,1316,4,22,338,1449,0.15384615384615385,-1111,0.18914381645215445
2006,1317,11,14,908,939,0.44,-31,0.4916080129940444
2006,1318,18,11,1463,688,0.6206896551724138,775,0.6801487680148768
2006,1319,18,10,1486,612,0.6428571428571429,874,0.7082936129647283
2006,1320,21,9,1472,491,0.7,981,0.7498726439123791
2006,1321,13,15,822,805,0.4642857142857143,17,0.5052243392747388
2006,1322,22,7,1720,477,0.7586206896551724,1243,0.7828857532999545
2006,1323,15,13,1185,943,0.5357142857142857,242,0.5568609022556391
2006,1324,9,18,717,1233,0.3333333333333333,-516,0.3676923076923077
2006,1325,18,11,1360,644,0.6206896551724138,716,0.6786427145708582
2006,1326,25,5,1908,333,0.8333333333333334,1575,0.8514056224899599
2006,1328,20,8,1408,513,0.7142857142857143,895,0.7329515877147319
2006,1329,17,15,1328,935,0.53125,393,0.5868316394167035
2006,1330,21,9,1573,553,0.7,1020,0.7398871119473189
2006,1331,20,11,1552,752,0.6451612903225806,800,0.6736111111111112
2006,1332,14,18,1067,1148,0.4375,-81,0.4817155756207675
2006,1333,13,18,916,1127,0.41935483870967744,-211,0.44836025452765543
2006,1334,22,7,1679,459,0.7586206896551724,1220,0.7853133769878391
2006,1335,19,8,1420,443,0.7037037037037037,977,0.7622114868491681
2006,1336,15,14,1089,861,0.5172413793103449,228,0.5584615384615385
2006,1337,7,20,523,1258,0.25925925925925924,-735,0.29365524985962943
2006,1338,24,7,1796,450,0.7741935483870968,1346,0.7996438112199465
2006,1339,11,17,883,1045,0.39285714285714285,-162,0.4579875518672199
2006,1340,10,16,761,1087,0.38461538461538464,-326,0.41179653679653677
2006,1341,3,24,218,1540,0.1111111111111111,-1322,0.12400455062571103
2006,1343,12,14,751,605,0.46153846153846156,146,0.553834808259587
2006,1344,12,15,959,1061,0.4444444444444444,-102,0.47475247524752473
2006,1345,9,19,671,1140,0.32142857142857145,-469,0.37051352843732743
2006,1346,11,16,807,1146,0.4074074074074074,-339,0.41321044546851
2006,1347,14,13,1122,843,0.5185185185185185,279,0.5709923664122137
2006,1348,14,14,938,841,0.5,97,0.5272625070264193
2006,1349,10,16,702,1015,0.38461538461538464,-313,0.40885264997087944
2006,1350,13,17,805,757,0.43333333333333335,48,0.5153649167733675
2006,1351,8,20,605,1376,0.2857142857142857,-771,0.30540131246845026
2006,1352,13,14,1029,898,0.48148148148148145,131,0.5339906590555267
2006,1353,17,13,1198,843,0.5666666666666667,355,0.5869671729544341
2006,1354,14,16,907,902,0.4666666666666667,5,0.5013819789939193
2006,1355,8,20,548,1218,0.2857142857142857,-670,0.3103057757644394
2006,1356,22,9,1359,525,0.7096774193548387,834,0.7213375796178344
2006,1357,11,17,760,1093,0.39285714285714285,-333,0.4101457096600108
2006,1358,18,9,1362,579,0.6666666666666666,783,0.7017001545595054
2006,1359,18,11,1240,609,0.6206896551724138,631,0.670632774472688
2006,1360,17,12,1380,872,0.5862068965517241,508,0.6127886323268206
2006,1361,22,8,1680,538,0.7333333333333333,1142,0.757439134355275
2006,1362,11,17,812,1123,0.39285714285714285,-311,0.4196382428940568
2006,1363,6,25,431,1584,0.1935483870967742,-1153,0.2138957816377171
2006,1364,14,14,1024,839,0.5,185,0.549651100375738
2006,1365,11,16,788,1013,0.4074074074074074,-225,0.43753470294280955
2006,1366,1,26,70,1415,0.037037037037037035,-1345,0.04713804713804714
2006,1368,13,11,937,670,0.5416666666666666,267,0.5830740510267579
2006,1369,5,20,348,1223,0.2,-875,0.22151495862507956
2006,1371,18,11,1324,643,0.6206896551724138,681,0.6731062531774276
2006,1372,14,12,1033,797,0.5384615384615384,236,0.5644808743169399
2006,1373,15,13,1183,901,0.5357142857142857,282,0.567658349328215
2006,1374,12,16,888,948,0.42857142857142855,-60,0.48366013071895425
2006,1375,23,6,1752,397,0.7931034482758621,1355,0.8152629129827826
2006,1376,17,15,1223,925,0.53125,298,0.569366852886406
2006,1378,7,22,488,1248,0.2413793103448276,-760,0.28110599078341014
2006,1379,7,21,512,1129,0.25,-617,0.3120048750761731
2006,1380,19,12,1349,690,0.6129032258064516,659,0.6615988229524277
2006,1381,9,20,700,1273,0.3103448275862069,-573,0.3547896604156107
2006,1382,8,19,594,1245,0.2962962962962963,-651,0.32300163132137033
2006,1383,10,17,653,1068,0.37037037037037035,-415,0.37943056362579897
2006,1384,3,24,191,1414,0.1111111111111111,-1223,0.11900311526479751
2006,1385,12,15,752,867,0.4444444444444444,-115,0.4644842495367511
2006,1386,18,13,1193,843,0.5806451612903226,350,0.5859528487229863
2006,1387,16,13,1020,729,0.5517241379310345,291,0.5831903945111492
2006,1388,16,12,1199,757,0.5714285714285714,442,0.6129856850715747
2006,1389,17,15,1328,1057,0.53125,271,0.5568134171907757
2006,1390,15,13,1023,837,0.5357142857142857,186,0.55
2006,1391,14,18,995,1134,0.4375,-139,0.46735556599342415
2006,1392,4,24,257,1372,0.14285714285714285,-1115,0.15776550030693678
2006,1393,23,11,1746,731,0.6764705882352942,1015,0.7048849414614453
2006,1394,16,8,1295,584,0.6666666666666666,711,0.689196381053752
2006,1395,6,24,450,1420,0.2,-970,0.24064171122994651
2006,1396,17,14,1179,752,0.5483870967741935,427,0.6105644743656137
2006,1397,21,7,1754,523,0.75,1231,0.7703118137900746
2006,1398,12,15,918,956,0.4444444444444444,-38,0.48986125933831376
2006,1399,17,12,1306,756,0.5862068965517241,550,0.6333656644034917
2006,1400,27,6,2125,387,0.8181818181818182,1738,0.8459394904458599
2006,1401,21,8,1500,507,0.7241379310344828,993,0.7473841554559043
2006,1402,2,22,143,1355,0.08333333333333333,-1212,0.09546061415220294
2006,1403,15,17,1168,1019,0.46875,149,0.5340649291266575
2006,1404,11,15,856,1011,0.4230769230769231,-155,0.4584895554365292
2006,1405,19,11,1409,675,0.6333333333333333,734,0.6761036468330134
2006,1406,12,16,930,1022,0.42857142857142855,-92,0.4764344262295082
2006,1407,11,15,872,1001,0.4230769230769231,-129,0.4655632674853177
2006,1408,11,16,705,958,0.4074074074074074,-253,0.4239326518340349
2006,1409,10,17,675,983,0.37037037037037035,-308,0.4071170084439083
2006,1410,3,24,213,1377,0.1111111111111111,-1164,0.1339622641509434
2006,1411,6,22,470,1387,0.21428571428571427,-917,0.25309639203015616
2006,1412,23,6,1785,359,0.7931034482758621,1426,0.8325559701492538
2006,1413,7,20,508,1254,0.25925925925925924,-746,0.2883087400681044
2006,1414,16,11,1187,727,0.5925925925925926,460,0.6201671891327064
2006,1415,5,22,405,1369,0.18518518518518517,-964,0.22829763246899662
2006,1416,12,15,791,891,0.4444444444444444,-100,0.4702734839476813
2006,1417,27,6,1866,397,0.8181818181818182,1469,0.824569155987627
2006,1418,13,16,914,1022,0.4482758620689655,-108,0.47210743801652894
2006,1419,7,18,534,1036,0.28,-502,0.3401273885350318
2006,1420,10,19,791,1149,0.3448275862068966,-358,0.4077319587628866
2006,1421,8,18,638,1087,0.3076923076923077,-449,0.36985507246376814
2006,1422,10,19,685,1266,0.3448275862068966,-581,0.3511019989748847
2006,1423,25,7,1706,459,0.78125,1247,0.7879907621247113
2006,1424,17,13,1285,799,0.5666666666666667,486,0.6166026871401151
2006,1425,16,13,1202,796,0.5517241379310345,406,0.6016016016016016
2006,1426,10,16,770,1086,0.38461538461538464,-316,0.41487068965517243
2006,1427,9,17,722,1178,0.34615384615384615,-456,0.38
2006,1428,13,15,937,874,0.4642857142857143,63,0.5173937051352844
2006,1429,22,8,1581,563,0.7333333333333333,1018,0.7374067164179104
2006,1430,14,13,983,791,0.5185185185185185,192,0.5541149943630215
2006,1431,18,9,1208,539,0.6666666666666666,669,0.6914710933028048
2006,1433,19,10,1368,596,0.6551724137931034,772,0.6965376782077393
2006,1434,16,12,1340,833,0.5714285714285714,507,0.616658996778647
2006,1435,17,12,1222,813,0.5862068965517241,409,0.6004914004914005
2006,1436,13,17,888,1048,0.43333333333333335,-160,0.45867768595041325
2006,1437,25,4,1916,271,0.8620689655172413,1645,0.8760859625057156
2006,1438,15,14,1096,893,0.5172413793103449,203,0.5510306686777275
2006,1439,14,16,1019,1041,0.4666666666666667,-22,0.49466019417475726
2006,1440,4,20,324,1318,0.16666666666666666,-994,0.19732034104750304
2006,1441,10,17,750,1016,0.37037037037037035,-266,0.4246885617214043
2006,1442,5,21,338,1350,0.19230769230769232,-1012,0.20023696682464456
2006,1443,22,7,1776,490,0.7586206896551724,1286,0.7837599293909974
2006,1444,13,17,868,1020,0.43333333333333335,-152,0.4597457627118644
2006,1447,12,14,870,856,0.46153846153846156,14,0.5040556199304751
2006,1448,17,16,1286,1138,0.5151515151515151,148,0.5305280528052805
2006,1449,24,6,2033,439,0.8,1594,0.8224110032362459
2006,1450,11,17,739,890,0.39285714285714285,-151,0.4536525475751995
2006,1451,8,17,575,1055,0.32,-480,0.35276073619631904
2006,1452,19,10,1406,643,0.6551724137931034,763,0.6861883845778428
2006,1453,14,16,1005,957,0.4666666666666667,48,0.5122324159021406
2006,1454,20,8,1532,527,0.7142857142857143,1005,0.7440505099562894
2006,1455,23,8,1660,458,0.7419354838709677,1202,0.7837582625118036
2006,1456,8,20,671,1144,0.2857142857142857,-473,0.3696969696969697
2006,1457,21,7,1621,414,0.75,1207,0.7965601965601966
2006,1458,19,11,1451,679,0.6333333333333333,772,0.6812206572769953
2006,1459,7,18,522,1107,0.28,-585,0.32044198895027626
2006,1460,12,15,845,847,0.4444444444444444,-2,0.49940898345153667
2006,1461,13,18,908,1138,0.41935483870967744,-230,0.44379276637341153
2006,1462,21,10,1583,632,0.6774193548387096,951,0.7146726862302483
2006,1463,15,14,1117,822,0.5172413793103449,295,0.5760701392470345
2006,1464,6,21,455,1358,0.2222222222222222,-903,0.25096525096525096
2006,3102,11,15,806,803,0.4230769230769231,3,0.5009322560596644
2006,3103,5,23,324,1204,0.17857142857142858,-880,0.21204188481675393
2006,3104,9,19,634,1062,0.32142857142857145,-428,0.3738207547169811
2006,3105,12,16,742,863,0.42857142857142855,-121,0.46230529595015574
2006,3106,14,15,868,792,0.4827586206896552,76,0.5228915662650603
2006,3107,7,21,421,1087,0.25,-666,0.2791777188328912
2006,3108,11,16,717,941,0.4074074074074074,-224,0.4324487334137515
2006,3110,7,21,528,1115,0.25,-587,0.3213633597078515
2006,3111,14,13,1040,774,0.5185185185185185,266,0.5733186328555678
2006,3112,8,22,595,1401,0.26666666666666666,-806,0.29809619238476953
2006,3113,24,6,1733,392,0.8,1341,0.8155294117647058
2006,3114,13,15,841,768,0.4642857142857143,73,0.5226848974518334
2006,3115,7,21,449,1122,0.25,-673,0.28580521960534694
2006,3116,13,15,937,909,0.4642857142857143,28,0.5075839653304443
2006,3117,15,15,1090,939,0.5,151,0.5372104484967964
2006,3119,19,10,1371,566,0.6551724137931034,805,0.7077955601445535
2006,3120,14,15,1044,801,0.4827586206896552,243,0.5658536585365853
2006,3122,15,13,1058,763,0.5357142857142857,295,0.5809994508511807
2006,3123,17,12,1201,701,0.5862068965517241,500,0.631440588853838
2006,3124,24,6,1857,388,0.8,1469,0.8271714922048998
2006,3125,22,7,1567,412,0.7586206896551724,1155,0.7918140474987367
2006,3126,6,23,385,1168,0.20689655172413793,-783,0.24790727623953637
2006,3127,17,12,1262,678,0.5862068965517241,584,0.6505154639175258
2006,3128,11,16,726,859,0.4074074074074074,-133,0.4580441640378549
2006,3129,15,15,1080,904,0.5,176,0.5443548387096774
2006,3130,19,11,1380,659,0.6333333333333333,721,0.6768023540951447
2006,3131,18,12,1303,704,0.6,599,0.6492277030393623
2006,3132,28,2,1975,106,0.9333333333333333,1869,0.9490629505045651
2006,3133,9,19,653,1113,0.32142857142857145,-460,0.369762174405436
2006,3135,18,10,1181,579,0.6428571428571429,602,0.6710227272727273
2006,3137,18,11,1224,608,0.6206896551724138,616,0.6681222707423581
2006,3138,10,18,711,989,0.35714285714285715,-278,0.41823529411764704
2006,3139,15,14,1123,881,0.5172413793103449,242,0.560379241516966
2006,3140,25,5,1669,282,0.8333333333333334,1387,0.8554587391081496
2006,3141,15,12,977,604,0.5555555555555556,373,0.6179633143580012
2006,3142,12,14,1008,859,0.46153846153846156,149,0.5399035886448849
2006,3143,18,11,1231,645,0.6206896551724138,586,0.656183368869936
2006,3144,11,18,758,1009,0.3793103448275862,-251,0.4289756649688738
2006,3145,18,11,1309,699,0.6206896551724138,610,0.6518924302788844
2006,3147,3,24,196,1317,0.1111111111111111,-1121,0.12954395241242564
2006,3148,8,20,530,1075,0.2857142857142857,-545,0.3302180685358255
2006,3149,4,21,254,1066,0.16,-812,0.19242424242424241
2006,3150,20,8,1509,543,0.7142857142857143,966,0.7353801169590644
2006,3151,27,3,2099,170,0.9,1929,0.9250771264874394
2006,3152,10,16,638,838,0.38461538461538464,-200,0.43224932249322495
2006,3153,17,11,1231,652,0.6071428571428571,579,0.6537440254912373
2006,3155,8,21,641,1280,0.27586206896551724,-639,0.3336803748047892
2006,3156,3,24,209,1352,0.1111111111111111,-1143,0.133888532991672
2006,3157,14,10,900,537,0.5833333333333334,363,0.6263048016701461
2006,3158,10,17,651,929,0.37037037037037035,-278,0.4120253164556962
2006,3159,9,20,654,1175,0.3103448275862069,-521,0.35757244395844723
2006,3160,8,21,637,1269,0.27586206896551724,-632,0.3342077649527807
2006,3161,8,20,590,1215,0.2857142857142857,-625,0.3268698060941828
2006,3162,6,21,385,1155,0.2222222222222222,-770,0.25
2006,3163,29,4,2166,232,0.8787878787878788,1934,0.9032527105921602
2006,3164,22,8,1381,373,0.7333333333333333,1008,0.7873432155074116
2006,3165,8,19,553,1164,0.2962962962962963,-611,0.3220733838089691
2006,3166,8,21,585,1252,0.27586206896551724,-667,0.3184540010887316
2006,3168,11,17,792,1103,0.39285714285714285,-311,0.4179419525065963
2006,3169,10,20,736,1209,0.3333333333333333,-473,0.37840616966580976
2006,3170,9,17,632,945,0.34615384615384615,-313,0.40076093849080535
2006,3171,23,6,1714,303,0.7931034482758621,1411,0.8497768963807635
2006,3172,15,12,989,755,0.5555555555555556,234,0.5670871559633027
2006,3173,17,12,1184,684,0.5862068965517241,500,0.6338329764453962
2006,3174,22,7,1454,420,0.7586206896551724,1034,0.775880469583778
2006,3175,21,9,1334,443,0.7,891,0.7507034327518289
2006,3176,15,13,948,696,0.5357142857142857,252,0.5766423357664233
2006,3177,25,6,1952,411,0.8064516129032258,1541,0.8260685569191706
2006,3178,11,17,809,1017,0.39285714285714285,-208,0.4430449069003286
2006,3179,17,11,1140,669,0.6071428571428571,471,0.6301824212271974
2006,3180,15,14,963,717,0.5172413793103449,246,0.5732142857142857
2006,3181,26,3,2335,205,0.896551724137931,2130,0.9192913385826772
2006,3182,13,17,836,946,0.43333333333333335,-110,0.4691358024691358
2006,3183,10,19,761,1176,0.3448275862068966,-415,0.39287558079504387
2006,3184,7,20,499,1292,0.25925925925925924,-793,0.2786152987158012
2006,3185,22,7,1469,425,0.7586206896551724,1044,0.7756071805702217
2006,3186,13,15,877,851,0.4642857142857143,26,0.5075231481481481
2006,3187,17,12,1142,732,0.5862068965517241,410,0.6093916755602988
2006,3189,10,16,628,775,0.38461538461538464,-147,0.4476122594440485
2006,3190,18,10,1319,615,0.6428571428571429,704,0.6820062047569804
2006,3191,15,13,1048,791,0.5357142857142857,257,0.5698749320282762
2006,3192,9,18,623,1087,0.3333333333333333,-464,0.36432748538011694
2006,3193,11,18,794,1003,0.3793103448275862,-209,0.44184752365052865
2006,3194,20,10,1459,613,0.6666666666666666,846,0.7041505791505791
2006,3196,21,8,1540,520,0.7241379310344828,1020,0.7475728155339806
2006,3197,12,17,756,905,0.41379310344827586,-149,0.4551475015051174
2006,3198,18,12,1224,685,0.6,539,0.6411733892090099
2006,3199,19,9,1414,575,0.6785714285714286,839,0.7109100050276521
2006,3200,10,18,649,957,0.35714285714285715,-308,0.4041095890410959
2006,3201,22,7,1584,444,0.7586206896551724,1140,0.7810650887573964
2006,3202,9,20,649,1115,0.3103448275862069,-466,0.3679138321995465
2006,3203,22,8,1462,453,0.7333333333333333,1009,0.7634464751958224
2006,3204,11,18,794,1076,0.3793103448275862,-282,0.42459893048128344
2006,3205,14,16,993,907,0.4666666666666667,86,0.5226315789473684
2006,3206,12,17,823,847,0.41379310344827586,-24,0.492814371257485
2006,3207,10,17,676,922,0.37037037037037035,-246,0.4230287859824781
2006,3208,21,8,1785,546,0.7241379310344828,1239,0.7657657657657657
2006,3209,9,20,654,1160,0.3103448275862069,-506,0.360529217199559
2006,3210,14,15,957,914,0.4827586206896552,43,0.5114911811865313
2006,3211,16,14,1043,777,0.5333333333333333,266,0.573076923076923
2006,3212,10,15,731,938,0.4,-207,0.43798681845416415
2006,3214,7,22,491,1306,0.2413793103448276,-815,0.27323316638842515
2006,3216,26,3,1750,163,0.896551724137931,1587,0.9147935180345008
2006,3217,12,15,895,856,0.4444444444444444,39,0.5111364934323244
2006,3218,18,10,1240,638,0.6428571428571429,602,0.6602768903088392
2006,3219,18,10,1318,552,0.6428571428571429,766,0.704812834224599
2006,3220,18,11,1346,647,0.6206896551724138,699,0.6753637732062218
2006,3221,16,14,1107,777,0.5333333333333333,330,0.5875796178343949
2006,3222,12,17,836,952,0.41379310344827586,-116,0.46756152125279643
2006,3224,14,15,1141,986,0.4827586206896552,155,0.536436295251528
2006,3225,10,19,714,1082,0.3448275862068966,-368,0.3975501113585746
2006,3226,15,12,1233,830,0.5555555555555556,403,0.5976732913233156
2006,3227,16,14,1235,816,0.5333333333333333,419,0.6021452949780595
2006,3228,15,14,1065,772,0.5172413793103449,293,0.5797495917256397
2006,3229,12,16,837,1044,0.42857142857142855,-207,0.4449760765550239
2006,3231,17,13,1107,742,0.5666666666666667,365,0.5987020010816657
2006,3232,26,5,2104,267,0.8387096774193549,1837,0.8873892872205821
2006,3233,17,12,1239,720,0.5862068965517241,519,0.6324655436447167
2006,3234,17,11,1314,721,0.6071428571428571,593,0.6457002457002456
2006,3235,17,12,1226,713,0.5862068965517241,513,0.6322846828261991
2006,3236,5,21,368,1227,0.19230769230769232,-859,0.23072100313479624
2006,3237,17,11,1064,610,0.6071428571428571,454,0.6356033452807647
2006,3238,17,13,1141,747,0.5666666666666667,394,0.604343220338983
2006,3239,10,18,681,1073,0.35714285714285715,-392,0.3882554161915621
2006,3240,11,17,858,1095,0.39285714285714285,-237,0.4393241167434716
2006,3241,24,6,1681,373,0.8,1308,0.8184031158714703
2006,3242,16,12,1175,681,0.5714285714285714,494,0.6330818965517241
2006,3243,19,10,1403,620,0.6551724137931034,783,0.6935244686109738
2006,3244,4,22,297,1355,0.15384615384615385,-1058,0.1797820823244552
2006,3245,21,9,1500,486,0.7,1014,0.7552870090634441
2006,3246,21,8,1553,450,0.7241379310344828,1103,0.7753369945082377
2006,3247,11,17,730,1001,0.39285714285714285,-271,0.4217215482380127
2006,3248,8,20,507,1124,0.2857142857142857,-617,0.3108522378908645
2006,3249,8,15,519,843,0.34782608695652173,-324,0.381057268722467
2006,3250,10,18,679,1094,0.35714285714285715,-415,0.3829667230682459
2006,3251,24,5,1557,270,0.8275862068965517,1287,0.8522167487684729
2006,3252,6,21,373,1123,0.2222222222222222,-750,0.24933155080213903
2006,3253,18,10,1279,611,0.6428571428571429,668,0.6767195767195767
2006,3254,14,15,951,804,0.4827586206896552,147,0.5418803418803418
2006,3255,7,19,547,1070,0.2692307692307692,-523,0.33828076685219544
2006,3256,26,4,1948,242,0.8666666666666667,1706,0.8894977168949771
2006,3257,19,9,1395,531,0.6785714285714286,864,0.7242990654205608
2006,3258,17,12,1183,682,0.5862068965517241,501,0.6343163538873995
2006,3259,20,10,1384,613,0.6666666666666666,771,0.6930395593390085
2006,3260,4,24,318,1392,0.14285714285714285,-1074,0.18596491228070175
2006,3261,27,3,2090,188,0.9,1902,0.9174714661984197
2006,3263,10,19,718,1033,0.3448275862068966,-315,0.41005139920045686
2006,3264,11,18,753,955,0.3793103448275862,-202,0.4408665105386417
2006,3265,23,6,1524,340,0.7931034482758621,1184,0.8175965665236051
2006,3266,18,10,1282,555,0.6428571428571429,727,0.6978769733260751
2006,3267,15,14,1072,765,0.5172413793103449,307,0.5835601524224279
2006,3268,28,4,2371,303,0.875,2068,0.8866866118175019
2006,3269,11,17,722,885,0.39285714285714285,-163,0.4492843808338519
2006,3270,10,15,632,836,0.4,-204,0.4305177111716621
2006,3271,16,13,1123,796,0.5517241379310345,327,0.5852006253256905
2006,3272,3,25,220,1453,0.10714285714285714,-1233,0.1315002988643156
2006,3273,14,15,853,862,0.4827586206896552,-9,0.49737609329446064
2006,3274,16,12,1298,809,0.5714285714285714,489,0.6160417655434267
2006,3275,8,20,549,1201,0.2857142857142857,-652,0.3137142857142857
2006,3276,6,23,466,1190,0.20689655172413793,-724,0.28140096618357485
2006,3277,22,9,1625,510,0.7096774193548387,1115,0.7611241217798594
2006,3278,19,9,1429,460,0.6785714285714286,969,0.756484912652197
2006,3279,16,13,1232,836,0.5517241379310345,396,0.5957446808510638
2006,3280,6,22,437,1152,0.21428571428571427,-715,0.2750157331655129
2006,3281,21,9,1555,547,0.7,1008,0.7397716460513797
2006,3282,9,18,648,917,0.3333333333333333,-269,0.41405750798722046
2006,3283,17,14,1151,824,0.5483870967741935,327,0.5827848101265822
2006,3284,14,14,946,799,0.5,147,0.5421203438395416
2006,3285,20,7,1500,389,0.7407407407407407,1111,0.7940709370037057
2006,3286,3,23,235,1408,0.11538461538461539,-1173,0.1430310407790627
2006,3287,14,13,949,772,0.5185185185185185,177,0.5514235909355026
2006,3288,5,23,363,1320,0.17857142857142858,-957,0.21568627450980393
2006,3290,15,11,1025,605,0.5769230769230769,420,0.6288343558282209
2006,3291,12,16,851,993,0.42857142857142855,-142,0.4614967462039046
2006,3292,20,10,1528,634,0.6666666666666666,894,0.7067530064754857
2006,3293,11,17,896,1093,0.39285714285714285,-197,0.4504776269482152
2006,3294,10,15,688,867,0.4,-179,0.442443729903537
2006,3295,6,16,433,979,0.2727272727272727,-546,0.306657223796034
2006,3296,12,17,797,981,0.41379310344827586,-184,0.4482564679415073
2006,3298,14,14,990,859,0.5,131,0.5354245538128718
2006,3299,9,19,656,1126,0.32142857142857145,-470,0.3681257014590348
2006,3301,19,11,1416,655,0.6333333333333333,761,0.6837276677933366
2006,3304,17,12,1266,702,0.5862068965517241,564,0.6432926829268293
2006,3305,13,17,852,915,0.43333333333333335,-63,0.48217317487266553
2006,3306,15,13,1035,717,0.5357142857142857,318,0.5907534246575342
2006,3307,21,9,1447,538,0.7,909,0.7289672544080604
2006,3308,10,20,656,1033,0.3333333333333333,-377,0.38839550029603315
2006,3309,3,25,194,1241,0.10714285714285714,-1047,0.13519163763066203
2006,3310,4,25,250,1325,0.13793103448275862,-1075,0.15873015873015872
2006,3311,4,23,237,1204,0.14814814814814814,-967,0.16446911866759195
2006,3313,8,20,560,1092,0.2857142857142857,-532,0.3389830508474576
2006,3314,29,1,2403,95,0.9666666666666667,2308,0.9619695756605284
2006,3316,11,17,676,855,0.39285714285714285,-179,0.44154147615937295
2006,3317,18,9,1267,521,0.6666666666666666,746,0.7086129753914989
2006,3318,8,21,547,1174,0.27586206896551724,-627,0.3178384660081348
2006,3319,21,10,1525,546,0.6774193548387096,979,0.736359246740705
2006,3320,19,10,1260,561,0.6551724137931034,699,0.6919275123558485
2006,3321,6,22,465,1215,0.21428571428571427,-750,0.2767857142857143
2006,3322,8,16,593,954,0.3333333333333333,-361,0.38332255979314805
2006,3323,18,11,1249,626,0.6206896551724138,623,0.6661333333333334
2006,3324,15,15,1065,910,0.5,155,0.5392405063291139
2006,3325,9,20,620,1244,0.3103448275862069,-624,0.33261802575107297
2006,3326,28,2,2045,107,0.9333333333333333,1938,0.9502788104089219
2006,3328,29,4,2242,268,0.8787878787878788,1974,0.8932270916334661
2006,3329,5,22,406,1162,0.18518518518518517,-756,0.25892857142857145
2006,3330,22,8,1697,534,0.7333333333333333,1163,0.7606454504706409
2006,3331,14,12,1020,727,0.5384615384615384,293,0.5838580423583286
2006,3332,14,15,1012,840,0.4827586206896552,172,0.5464362850971922
2006,3333,15,14,1034,793,0.5172413793103449,241,0.5659551176792557
2006,3334,5,22,371,1282,0.18518518518518517,-911,0.22444041137326073
2006,3335,5,22,339,1177,0.18518518518518517,-838,0.22361477572559366
2006,3336,13,16,1005,921,0.4482758620689655,84,0.5218068535825545
2006,3337,14,16,927,973,0.4666666666666667,-46,0.48789473684210527
2006,3338,19,10,1333,590,0.6551724137931034,743,0.6931877275091004
2006,3339,4,24,314,1445,0.14285714285714285,-1131,0.17851051733939738
2006,3340,12,16,885,1082,0.42857142857142855,-197,0.4499237417386884
2006,3341,7,21,487,1119,0.25,-632,0.30323785803237857
2006,3343,21,7,1516,370,0.75,1146,0.8038176033934252
2006,3344,8,19,544,1104,0.2962962962962963,-560,0.3300970873786408
2006,3345,24,6,1668,351,0.8,1317,0.826151560178306
2006,3346,22,8,1500,455,0.7333333333333333,1045,0.7672634271099744
2006,3347,12,14,830,797,0.46153846153846156,33,0.510141364474493
2006,3348,8,20,548,1102,0.2857142857142857,-554,0.3321212121212121
2006,3349,17,13,1227,802,0.5666666666666667,425,0.6047313947757516
2006,3350,13,17,895,961,0.43333333333333335,-66,0.4822198275862069
2006,3351,3,25,179,1216,0.10714285714285714,-1037,0.12831541218637993
2006,3352,20,9,1407,446,0.6896551724137931,961,0.7593092282784674
2006,3353,25,4,1616,215,0.8620689655172413,1401,0.8825778263244128
2006,3354,13,15,903,797,0.4642857142857143,106,0.5311764705882352
2006,3355,17,9,1270,529,0.6538461538461539,741,0.7059477487493052
2006,3356,10,18,722,1037,0.35714285714285715,-315,0.41046048891415576
2006,3357,26,4,1968,199,0.8666666666666667,1769,0.9081679741578219
2006,3358,6,18,423,924,0.25,-501,0.31403118040089084
2006,3359,21,8,1406,444,0.7241379310344828,962,0.76
2006,3360,9,19,627,1087,0.32142857142857145,-460,0.36581096849474914
2006,3361,3,24,188,1247,0.1111111111111111,-1059,0.13101045296167246
2006,3362,9,20,625,1104,0.3103448275862069,-479,0.3614806246385194
2006,3363,13,15,872,838,0.4642857142857143,34,0.5099415204678363
2006,3364,16,13,1145,718,0.5517241379310345,427,0.6146001073537305
2006,3365,19,11,1432,778,0.6333333333333333,654,0.6479638009049774
2006,3366,2,24,144,1205,0.07692307692307693,-1061,0.1067457375833951
2006,3368,8,16,485,811,0.3333333333333333,-326,0.3742283950617284
2006,3369,20,8,1440,554,0.7142857142857143,886,0.7221664994984955
2006,3371,6,21,406,1079,0.2222222222222222,-673,0.2734006734006734
2006,3372,23,7,1712,437,0.7666666666666667,1275,0.796649604467194
2006,3373,11,17,772,972,0.39285714285714285,-200,0.4426605504587156
2006,3374,16,14,1114,842,0.5333333333333333,272,0.5695296523517382
2006,3375,15,14,975,775,0.5172413793103449,200,0.5571428571428572
2006,3376,17,11,1297,640,0.6071428571428571,657,0.6695921528136293
2006,3378,18,11,1288,671,0.6206896551724138,617,0.6574783052577846
2006,3379,14,15,969,931,0.4827586206896552,38,0.51
2006,3380,20,10,1367,505,0.6666666666666666,862,0.7302350427350427
2006,3381,9,17,604,962,0.34615384615384615,-358,0.38569604086845466
2006,3382,9,18,579,975,0.3333333333333333,-396,0.37258687258687256
2006,3383,5,22,333,1169,0.18518518518518517,-836,0.22170439414114515
2006,3384,4,24,286,1273,0.14285714285714285,-987,0.18345093008338678
2006,3385,21,7,1588,393,0.75,1195,0.8016153457849571
2006,3386,20,10,1277,527,0.6666666666666666,750,0.7078713968957872
2006,3387,7,20,465,1152,0.25925925925925924,-687,0.287569573283859
2006,3388,12,16,810,906,0.42857142857142855,-96,0.47202797202797203
2006,3389,13,15,891,884,0.4642857142857143,7,0.5019718309859155
2006,3390,23,7,1864,500,0.7666666666666667,1364,0.7884940778341794
2006,3391,9,19,596,941,0.32142857142857145,-345,0.3877683799609629
2006,3392,20,9,1418,545,0.6896551724137931,873,0.7223637289862456
2006,3393,9,18,674,950,0.3333333333333333,-276,0.41502463054187194
2006,3394,14,12,918,700,0.5384615384615384,218,0.5673671199011124
2006,3395,18,11,1345,635,0.6206896551724138,710,0.6792929292929293
2006,3396,24,7,1625,370,0.7741935483870968,1255,0.8145363408521303
2006,3397,28,4,2234,278,0.875,1956,0.8893312101910829
2006,3399,22,8,1636,457,0.7333333333333333,1179,0.7816531294792164
2006,3400,13,15,898,887,0.4642857142857143,11,0.5030812324929972
2006,3401,23,8,1684,478,0.7419354838709677,1206,0.7789084181313598
2006,3402,14,11,1019,615,0.56,404,0.6236230110159119
2006,3403,15,14,1023,870,0.5172413793103449,153,0.5404120443740095
2006,3404,7,19,442,981,0.2692307692307692,-539,0.3106113843991567
2006,3405,11,18,788,1050,0.3793103448275862,-262,0.42872687704026113
2006,3406,9,19,579,1061,0.32142857142857145,-482,0.35304878048780486
2006,3407,9,18,668,976,0.3333333333333333,-308,0.40632603406326034
2006,3408,15,12,1088,750,0.5555555555555556,338,0.5919477693144722
2006,3409,25,5,1820,287,0.8333333333333334,1533,0.8637873754152824
2006,3410,4,21,271,1030,0.16,-759,0.2083013066871637
2006,3411,4,22,271,1284,0.15384615384615385,-1013,0.1742765273311897
2006,3412,14,14,1060,883,0.5,177,0.5455481214616572
2006,3413,15,12,1032,750,0.5555555555555556,282,0.5791245791245792
2006,3414,9,19,687,1149,0.32142857142857145,-462,0.3741830065359477
2006,3415,16,14,1057,763,0.5333333333333333,294,0.5807692307692308
2006,3416,7,21,438,1187,0.25,-749,0.26953846153846156
2006,3417,20,10,1622,725,0.6666666666666666,897,0.6910950149126545
2006,3418,17,10,1136,561,0.6296296296296297,575,0.6694166175604007
2006,3419,18,11,1218,625,0.6206896551724138,593,0.6608790016277808
2006,3420,15,13,1001,734,0.5357142857142857,267,0.5769452449567724
2006,3421,13,13,873,780,0.5,93,0.5281306715063521
2006,3422,18,12,1247,776,0.6,471,0.6164112703905091
2006,3423,15,13,925,677,0.5357142857142857,248,0.5774032459425718
2006,3424,18,11,1239,613,0.6206896551724138,626,0.6690064794816415
2006,3425,18,11,1323,684,0.6206896551724138,639,0.6591928251121076
2006,3426,20,9,1314,500,0.6896551724137931,814,0.7243660418963617
2006,3427,18,12,1212,705,0.6,507,0.6322378716744914
2006,3428,24,6,1738,331,0.8,1407,0.8400193330111165
2006,3429,3,24,192,1316,0.1111111111111111,-1124,0.1273209549071618
2006,3430,9,16,695,1005,0.36,-310,0.4088235294117647
2006,3431,13,15,963,810,0.4642857142857143,153,0.5431472081218274
2006,3433,13,15,891,893,0.4642857142857143,-2,0.4994394618834081
2006,3434,16,13,1115,674,0.5517241379310345,441,0.6232532140860816
2006,3435,20,10,1493,600,0.6666666666666666,893,0.7133301481127569
2006,3436,9,18,609,1058,0.3333333333333333,-449,0.36532693461307736
2006,3437,19,10,1254,544,0.6551724137931034,710,0.6974416017797553
2006,3438,18,11,1296,654,0.6206896551724138,642,0.6646153846153846
2006,3439,20,9,1469,542,0.6896551724137931,927,0.7304823470909995
2006,3441,9,20,688,1302,0.3103448275862069,-614,0.3457286432160804
2006,3442,21,6,1293,288,0.7777777777777778,1005,0.8178368121442126
2006,3443,24,6,1816,380,0.8,1436,0.8269581056466302
2006,3444,14,14,1095,866,0.5,229,0.5583885772565018
2006,3447,2,25,131,1388,0.07407407407407407,-1257,0.08624094799210007
2006,3448,12,16,978,940,0.42857142857142855,38,0.5099061522419187
2006,3449,18,10,1335,654,0.6428571428571429,681,0.6711915535444947
2006,3450,8,20,558,1111,0.2857142857142857,-553,0.3343319352905932
2006,3451,15,15,1045,795,0.5,250,0.5679347826086957
2006,3452,15,16,1135,921,0.4838709677419355,214,0.5520428015564203
2006,3453,22,6,1612,362,0.7857142857142857,1250,0.8166160081053698
2006,3454,21,8,1462,498,0.7241379310344828,964,0.7459183673469387
2006,3455,15,13,1130,854,0.5357142857142857,276,0.5695564516129032
2006,3456,15,13,1014,718,0.5357142857142857,296,0.5854503464203233
2006,3457,13,15,800,768,0.4642857142857143,32,0.5102040816326531
2006,3458,11,18,818,1104,0.3793103448275862,-286,0.4255983350676379
2006,3459,5,21,346,1189,0.19230769230769232,-843,0.2254071661237785
2006,3460,12,16,834,946,0.42857142857142855,-112,0.46853932584269664
2006,3461,19,8,1233,422,0.7037037037037037,811,0.7450151057401813
2006,3462,20,8,1487,512,0.7142857142857143,975,0.743871935967984
2006,3463,3,24,183,1206,0.1111111111111111,-1023,0.13174946004319654
2006,3464,8,20,547,1086,0.2857142857142857,-539,0.33496631965707285
2007,1102,22,8,1591,464,0.7333333333333333,1127,0.7742092457420925
2007,1103,25,7,1907,481,0.78125,1426,0.7985762144053601
2007,1104,20,11,1536,746,0.6451612903225806,790,0.6730937773882559
2007,1105,6,20,443,1118,0.23076923076923078,-675,0.2837924407431134
2007,1106,9,20,589,1157,0.3103448275862069,-568,0.3373424971363116
2007,1107,23,9,1577,607,0.71875,970,0.7220695970695971
2007,1108,10,19,727,1187,0.3448275862068966,-460,0.37983281086729365
2007,1110,16,14,1123,822,0.5333333333333333,301,0.5773778920308483
2007,1111,22,7,1707,462,0.7586206896551724,1245,0.7869986168741355
2007,1112,20,10,1651,703,0.6666666666666666,948,0.7013593882752761
2007,1113,7,22,430,1256,0.2413793103448276,-826,0.25504151838671413
2007,1114,12,17,882,1014,0.41379310344827586,-132,0.4651898734177215
2007,1115,10,19,636,1065,0.3448275862068966,-429,0.37389770723104054
2007,1116,21,13,1575,852,0.6176470588235294,723,0.6489493201483313
2007,1117,16,15,1200,1019,0.5161290322580645,181,0.540784136998648
2007,1119,13,16,835,868,0.4482758620689655,-33,0.4903112155020552
2007,1120,16,15,1271,990,0.5161290322580645,281,0.562140645731977
2007,1122,19,11,1390,707,0.6333333333333333,683,0.6628516928946113
2007,1123,9,22,620,1228,0.2903225806451613,-608,0.3354978354978355
2007,1124,14,16,1180,1063,0.4666666666666667,117,0.5260811413285778
2007,1125,22,9,1696,556,0.7096774193548387,1140,0.7531083481349912
2007,1126,7,21,368,1116,0.25,-748,0.24797843665768193
2007,1127,13,16,918,987,0.4482758620689655,-69,0.4818897637795276
2007,1129,16,14,1247,1012,0.5333333333333333,235,0.5520141655599823
2007,1130,20,11,1593,721,0.6451612903225806,872,0.6884183232497839
2007,1131,12,18,785,1017,0.4,-232,0.43562708102108766
2007,1132,11,18,794,1121,0.3793103448275862,-327,0.414621409921671
2007,1133,20,12,1600,780,0.625,820,0.6722689075630253
2007,1135,11,18,745,1014,0.3793103448275862,-269,0.4235361000568505
2007,1137,22,9,1438,527,0.7096774193548387,911,0.7318066157760814
2007,1138,12,19,883,1226,0.3870967741935484,-343,0.4186818397344713
2007,1139,25,6,1731,386,0.8064516129032258,1345,0.8176665092111478
2007,1140,24,8,1903,572,0.75,1331,0.7688888888888888
2007,1141,13,18,916,1119,0.41935483870967744,-203,0.45012285012285014
2007,1142,17,11,1337,756,0.6071428571428571,581,0.6387959866220736
2007,1143,16,17,1172,1121,0.48484848484848486,51,0.5111208024422155
2007,1144,12,17,1020,1200,0.41379310344827586,-180,0.4594594594594595
2007,1145,12,19,873,1281,0.3870967741935484,-408,0.4052924791086351
2007,1146,6,20,407,1239,0.23076923076923078,-832,0.24726609963547996
2007,1147,10,21,777,1348,0.3225806451612903,-571,0.36564705882352944
2007,1148,22,11,1645,642,0.6666666666666666,1003,0.7192829033668562
2007,1149,4,22,326,1347,0.15384615384615385,-1021,0.19485953377166768
2007,1150,14,16,1096,1005,0.4666666666666667,91,0.5216563541170871
2007,1151,12,18,852,1113,0.4,-261,0.433587786259542
2007,1152,7,20,585,1304,0.25925925925925924,-719,0.3096876654314452
2007,1153,11,19,781,1156,0.36666666666666664,-375,0.403200826019618
2007,1154,4,23,253,1232,0.14814814814814814,-979,0.17037037037037037
2007,1155,21,10,1618,650,0.6774193548387096,968,0.7134038800705468
2007,1156,7,21,479,1250,0.25,-771,0.27703875072296125
2007,1157,11,15,890,985,0.4230769230769231,-95,0.4746666666666667
2007,1158,22,11,1588,702,0.6666666666666666,886,0.6934497816593886
2007,1159,9,19,577,993,0.32142857142857145,-416,0.36751592356687895
2007,1160,7,20,558,1309,0.25925925925925924,-751,0.2988752008569898
2007,1161,15,13,1152,876,0.5357142857142857,276,0.5680473372781065
2007,1162,15,12,1116,639,0.5555555555555556,477,0.6358974358974359
2007,1163,17,14,1312,869,0.5483870967741935,443,0.6015589179275561
2007,1164,12,20,810,1162,0.375,-352,0.4107505070993915
2007,1165,15,12,1004,772,0.5555555555555556,232,0.5653153153153153
2007,1166,22,10,1571,578,0.6875,993,0.7310376919497441
2007,1168,18,10,1515,741,0.6428571428571429,774,0.6715425531914894
2007,1169,12,17,977,1131,0.41379310344827586,-154,0.463472485768501
2007,1170,8,19,694,1298,0.2962962962962963,-604,0.34839357429718876
2007,1171,9,18,565,1026,0.3333333333333333,-461,0.35512256442489
2007,1172,27,4,2216,264,0.8709677419354839,1952,0.8935483870967742
2007,1173,19,12,1325,750,0.6129032258064516,575,0.6385542168674698
2007,1174,5,26,356,1518,0.16129032258064516,-1162,0.18996798292422626
2007,1175,20,12,1285,606,0.625,679,0.6795346377578001
2007,1176,4,25,315,1540,0.13793103448275862,-1225,0.16981132075471697
2007,1177,17,13,1249,754,0.5666666666666667,495,0.6235646530204693
2007,1178,11,19,778,1135,0.36666666666666664,-357,0.4066910611604809
2007,1179,16,15,1253,1041,0.5161290322580645,212,0.546207497820401
2007,1180,22,8,1535,463,0.7333333333333333,1072,0.7682682682682682
2007,1181,22,10,1559,687,0.6875,872,0.6941228851291185
2007,1182,10,19,905,1366,0.3448275862068966,-461,0.3985028621752532
2007,1183,9,20,644,1124,0.3103448275862069,-480,0.36425339366515835
2007,1184,19,11,1318,642,0.6333333333333333,676,0.6724489795918367
2007,1185,13,19,883,1156,0.40625,-273,0.43305541932319763
2007,1186,12,14,1045,1117,0.46153846153846156,-72,0.48334875115633674
2007,1187,3,24,237,1326,0.1111111111111111,-1089,0.15163147792706333
2007,1189,5,23,364,1350,0.17857142857142858,-986,0.21236872812135357
2007,1190,22,9,1681,585,0.7096774193548387,1096,0.7418358340688438
2007,1191,14,17,986,1145,0.45161290322580644,-159,0.4626935710933834
2007,1192,13,16,1024,1083,0.4482758620689655,-59,0.48599905078310396
2007,1193,13,19,871,1125,0.40625,-254,0.436372745490982
2007,1194,15,15,1193,1034,0.5,159,0.5356982487651549
2007,1196,29,5,2349,348,0.8529411764705882,2001,0.8709677419354839
2007,1197,18,13,1309,829,0.5806451612903226,480,0.6122544434050514
2007,1198,10,17,690,1068,0.37037037037037035,-378,0.3924914675767918
2007,1199,20,12,1589,783,0.625,806,0.6698988195615514
2007,1200,18,12,1268,696,0.6,572,0.6456211812627292
2007,1201,22,9,1650,555,0.7096774193548387,1095,0.7482993197278912
2007,1202,13,16,938,1018,0.4482758620689655,-80,0.47955010224948874
2007,1203,23,8,1699,504,0.7419354838709677,1195,0.7712210621879255
2007,1204,13,16,943,1011,0.4482758620689655,-68,0.4825997952917093
2007,1205,8,21,562,1270,0.27586206896551724,-708,0.3067685589519651
2007,1206,18,15,1227,863,0.5454545454545454,364,0.5870813397129186
2007,1207,26,6,1848,343,0.8125,1505,0.8434504792332268
2007,1208,17,13,1421,811,0.5666666666666667,610,0.6366487455197133
2007,1209,11,20,781,1212,0.3548387096774194,-431,0.39187155042649274
2007,1210,20,11,1650,802,0.6451612903225806,848,0.6729200652528549
2007,1211,23,10,1889,722,0.696969696969697,1167,0.7234775947912677
2007,1212,10,14,750,782,0.4166666666666667,-32,0.489556135770235
2007,1214,15,16,1088,1025,0.4838709677419355,63,0.514907714150497
2007,1216,13,18,811,1114,0.41935483870967744,-303,0.4212987012987013
2007,1217,12,16,929,1096,0.42857142857142855,-167,0.4587654320987654
2007,1218,18,13,1401,844,0.5806451612903226,557,0.6240534521158129
2007,1219,18,10,1401,655,0.6428571428571429,746,0.681420233463035
2007,1220,21,9,1523,670,0.7,853,0.6944824441404469
2007,1221,25,8,1674,446,0.7575757575757576,1228,0.789622641509434
2007,1222,18,15,1394,1021,0.5454545454545454,373,0.5772256728778468
2007,1224,9,22,704,1305,0.2903225806451613,-601,0.3504230960676954
2007,1225,4,27,272,1635,0.12903225806451613,-1363,0.1426324069218668
2007,1226,12,17,876,1061,0.41379310344827586,-185,0.4522457408363449
2007,1227,13,18,976,1173,0.41935483870967744,-197,0.454164727780363
2007,1228,23,11,1568,625,0.6764705882352942,943,0.7150022799817601
2007,1229,14,16,1022,961,0.4666666666666667,61,0.5153807362581947
2007,1231,20,10,1547,580,0.6666666666666666,967,0.7273154677950164
2007,1232,12,18,840,1002,0.4,-162,0.4560260586319218
2007,1233,2,28,121,1637,0.06666666666666667,-1516,0.06882821387940842
2007,1234,17,14,1277,844,0.5483870967741935,433,0.6020744931636021
2007,1235,14,16,932,950,0.4666666666666667,-18,0.4952178533475027
2007,1236,9,17,699,999,0.34615384615384615,-300,0.411660777385159
2007,1237,13,15,961,938,0.4642857142857143,23,0.5060558188520273
2007,1238,20,13,1480,864,0.6060606060606061,616,0.6313993174061433
2007,1239,13,14,1019,940,0.48148148148148145,79,0.520163348647269
2007,1240,8,20,569,1277,0.2857142857142857,-708,0.30823401950162516
2007,1241,7,23,499,1420,0.23333333333333334,-921,0.26003126628452317
2007,1242,30,4,2409,258,0.8823529411764706,2151,0.9032620922384702
2007,1243,22,11,1649,694,0.6666666666666666,955,0.7037985488689714
2007,1244,12,18,875,1163,0.4,-288,0.429342492639843
2007,1245,20,11,1418,707,0.6451612903225806,711,0.6672941176470588
2007,1246,21,11,1597,756,0.65625,841,0.6787080322991925
2007,1247,10,20,784,1366,0.3333333333333333,-582,0.36465116279069765
2007,1248,7,21,504,1273,0.25,-769,0.28362408553742263
2007,1249,13,17,1042,1142,0.43333333333333335,-100,0.47710622710622713
2007,1250,10,19,663,1139,0.3448275862068966,-476,0.36792452830188677
2007,1251,11,17,946,1121,0.39285714285714285,-175,0.4576681180454765
2007,1252,16,13,1115,836,0.5517241379310345,279,0.5715017939518195
2007,1253,23,7,1935,481,0.7666666666666667,1454,0.8009105960264901
2007,1254,9,19,669,1232,0.32142857142857145,-563,0.35192004208311417
2007,1255,7,22,526,1327,0.2413793103448276,-801,0.2838640043173233
2007,1256,10,20,749,1173,0.3333333333333333,-424,0.38969823100936524
2007,1257,22,9,1660,550,0.7096774193548387,1110,0.751131221719457
2007,1258,11,18,795,1083,0.3793103448275862,-288,0.4233226837060703
2007,1259,18,13,1378,835,0.5806451612903226,543,0.622684139177587
2007,1260,19,11,1362,703,0.6333333333333333,659,0.6595641646489104
2007,1261,17,15,1231,946,0.53125,285,0.5654570509875976
2007,1263,10,18,690,1099,0.35714285714285715,-409,0.3856903297931806
2007,1264,13,17,910,1068,0.43333333333333335,-158,0.46006066734074824
2007,1265,24,8,1866,553,0.75,1313,0.7713931376601901
2007,1266,23,9,1739,579,0.71875,1160,0.7502157031924073
2007,1267,13,19,860,1252,0.40625,-392,0.4071969696969697
2007,1268,24,8,1989,555,0.75,1434,0.7818396226415094
2007,1269,23,8,1796,589,0.7419354838709677,1207,0.7530398322851153
2007,1270,13,17,865,997,0.43333333333333335,-132,0.46455424274973145
2007,1271,3,27,201,1591,0.1,-1390,0.11216517857142858
2007,1272,30,3,2412,214,0.9090909090909091,2198,0.9185072353389185
2007,1273,11,17,903,1106,0.39285714285714285,-203,0.44947735191637633
2007,1274,12,20,949,1330,0.375,-381,0.41641070645019745
2007,1275,18,14,1187,719,0.5625,468,0.6227701993704092
2007,1276,21,12,1436,679,0.6363636363636364,757,0.6789598108747045
2007,1277,22,11,1550,598,0.6666666666666666,952,0.7216014897579144
2007,1278,9,22,605,1275,0.2903225806451613,-670,0.32180851063829785
2007,1279,20,12,1584,761,0.625,823,0.6754797441364605
2007,1280,18,13,1469,892,0.5806451612903226,577,0.6221939855993224
2007,1281,18,12,1459,869,0.6,590,0.6267182130584192
2007,1282,11,19,909,1214,0.36666666666666664,-305,0.4281676872350447
2007,1283,21,10,1677,604,0.6774193548387096,1073,0.7352038579570364
2007,1284,12,18,813,1125,0.4,-312,0.4195046439628483
2007,1285,15,15,1138,997,0.5,141,0.5330210772833723
2007,1286,9,19,659,1200,0.32142857142857145,-541,0.3544916621839699
2007,1287,10,18,698,1068,0.35714285714285715,-370,0.3952434881087203
2007,1288,13,18,940,1168,0.41935483870967744,-228,0.4459203036053131
2007,1290,18,15,1173,840,0.5454545454545454,333,0.5827123695976155
2007,1291,11,20,839,1183,0.3548387096774194,-344,0.4149357072205737
2007,1292,14,17,941,994,0.45161290322580644,-53,0.48630490956072353
2007,1293,14,13,980,794,0.5185185185185185,186,0.552423900789177
2007,1294,3,23,246,1480,0.11538461538461539,-1234,0.1425260718424102
2007,1295,16,8,1250,544,0.6666666666666666,706,0.6967670011148273
2007,1296,6,23,472,1452,0.20689655172413793,-980,0.24532224532224534
2007,1298,12,16,859,847,0.42857142857142855,12,0.5035169988276671
2007,1299,13,17,1047,1112,0.43333333333333335,-65,0.48494673459935156
2007,1301,18,15,1411,971,0.5454545454545454,440,0.5923593618807724
2007,1304,15,14,1129,802,0.5172413793103449,327,0.5846711548420508
2007,1305,27,4,2132,276,0.8709677419354839,1856,0.8853820598006644
2007,1306,10,19,674,1019,0.3448275862068966,-345,0.3981098641464855
2007,1307,14,17,1180,1139,0.45161290322580644,41,0.5088400172488141
2007,1308,24,8,1927,558,0.75,1369,0.7754527162977867
2007,1309,13,17,1030,1164,0.43333333333333335,-134,0.46946216955332726
2007,1310,22,11,1772,738,0.6666666666666666,1034,0.7059760956175298
2007,1311,7,22,563,1505,0.2413793103448276,-942,0.27224371373307543
2007,1312,5,24,323,1334,0.1724137931034483,-1011,0.19493059746529873
2007,1313,11,19,775,1195,0.36666666666666664,-420,0.3934010152284264
2007,1314,28,6,2448,485,0.8235294117647058,1963,0.8346403000340947
2007,1316,1,26,73,1371,0.037037037037037035,-1298,0.05055401662049862
2007,1317,20,10,1571,716,0.6666666666666666,855,0.6869261040664626
2007,1318,13,19,913,1077,0.40625,-164,0.45879396984924625
2007,1319,16,12,1424,875,0.5714285714285714,549,0.6193997390169639
2007,1320,17,13,1205,752,0.5666666666666667,453,0.6157383750638733
2007,1321,11,18,694,953,0.3793103448275862,-259,0.42137219186399516
2007,1322,16,15,1315,1124,0.5161290322580645,191,0.5391553915539156
2007,1323,24,7,2045,483,0.7741935483870968,1562,0.8089398734177216
2007,1324,18,14,1343,875,0.5625,468,0.6055004508566276
2007,1325,18,13,1397,843,0.5806451612903226,554,0.6236607142857142
2007,1326,30,3,2212,218,0.9090909090909091,1994,0.9102880658436214
2007,1328,15,15,1114,886,0.5,228,0.557
2007,1329,21,12,1673,760,0.6363636363636364,913,0.6876284422523633
2007,1330,24,8,1722,522,0.75,1200,0.767379679144385
2007,1331,22,10,1650,645,0.6875,1005,0.7189542483660131
2007,1332,26,7,2033,488,0.7878787878787878,1545,0.8064260214200714
2007,1333,10,21,732,1225,0.3225806451612903,-493,0.37404190086867656
2007,1334,11,19,814,1237,0.36666666666666664,-423,0.3968795709410044
2007,1335,21,8,1582,566,0.7241379310344828,1016,0.7364990689013036
2007,1336,11,19,823,1139,0.36666666666666664,-316,0.4194699286442406
2007,1337,8,22,676,1637,0.26666666666666666,-961,0.2922611327280588
2007,1338,27,7,1962,457,0.7941176470588235,1505,0.8110789582472095
2007,1339,8,23,547,1337,0.25806451612903225,-790,0.2903397027600849
2007,1340,17,13,1370,931,0.5666666666666667,439,0.595393307257714
2007,1341,6,22,375,1274,0.21428571428571427,-899,0.22741055184960582
2007,1343,11,17,624,786,0.39285714285714285,-162,0.4425531914893617
2007,1344,18,12,1487,792,0.6,695,0.6524791575252303
2007,1345,21,11,1578,659,0.65625,919,0.705409029950827
2007,1346,13,15,973,1022,0.4642857142857143,-49,0.48771929824561405
2007,1347,6,22,486,1439,0.21428571428571427,-953,0.25246753246753245
2007,1348,17,14,1355,993,0.5483870967741935,362,0.5770868824531517
2007,1349,14,16,1011,1013,0.4666666666666667,-2,0.49950592885375494
2007,1350,8,22,560,1257,0.26666666666666666,-697,0.3082003302146395
2007,1351,16,15,1190,979,0.5161290322580645,211,0.5486399262332873
2007,1352,16,11,1231,791,0.5925925925925926,440,0.6088031651829872
2007,1353,9,19,592,1060,0.32142857142857145,-468,0.3583535108958838
2007,1354,13,17,929,1060,0.43333333333333335,-131,0.4670688788335847
2007,1355,6,24,448,1413,0.2,-965,0.24073078989790436
2007,1356,26,6,1689,336,0.8125,1353,0.8340740740740741
2007,1357,18,14,1507,1006,0.5625,501,0.5996816553919618
2007,1358,18,10,1433,689,0.6428571428571429,744,0.675306314797361
2007,1359,15,16,961,854,0.4838709677419355,107,0.5294765840220386
2007,1360,15,14,1189,974,0.5172413793103449,215,0.5496994914470643
2007,1361,19,10,1478,613,0.6551724137931034,865,0.7068388330942132
2007,1362,12,18,953,1260,0.4,-307,0.4306371441482151
2007,1363,5,25,327,1531,0.16666666666666666,-1204,0.1759956942949408
2007,1364,17,11,1252,723,0.6071428571428571,529,0.6339240506329114
2007,1365,20,10,1415,633,0.6666666666666666,782,0.69091796875
2007,1366,8,18,498,957,0.3076923076923077,-459,0.3422680412371134
2007,1368,14,14,974,913,0.5,61,0.516163222045575
2007,1369,10,20,800,1284,0.3333333333333333,-484,0.3838771593090211
2007,1371,12,16,980,1094,0.42857142857142855,-114,0.4725168756027001
2007,1372,12,14,862,801,0.46153846153846156,61,0.5183403487672881
2007,1373,20,12,1544,893,0.625,651,0.6335658596635207
2007,1374,12,17,803,987,0.41379310344827586,-184,0.44860335195530726
2007,1375,18,11,1334,702,0.6206896551724138,632,0.6552062868369352
2007,1376,14,16,976,965,0.4666666666666667,11,0.502833590932509
2007,1378,12,18,892,1078,0.4,-186,0.4527918781725888
2007,1379,16,11,1152,671,0.5925925925925926,481,0.6319253976961053
2007,1380,10,21,662,1177,0.3225806451612903,-515,0.35997824904839587
2007,1381,14,14,1020,854,0.5,166,0.544290288153682
2007,1382,7,22,516,1441,0.2413793103448276,-925,0.2636688809402146
2007,1383,9,22,647,1308,0.2903225806451613,-661,0.3309462915601023
2007,1384,7,21,499,1351,0.25,-852,0.26972972972972975
2007,1385,16,15,1097,882,0.5161290322580645,215,0.5543203638201112
2007,1386,17,14,1224,863,0.5483870967741935,361,0.5864877815045519
2007,1387,19,13,1347,752,0.59375,595,0.641734159123392
2007,1388,14,15,1095,927,0.4827586206896552,168,0.5415430267062314
2007,1389,5,25,321,1467,0.16666666666666666,-1146,0.17953020134228187
2007,1390,18,12,1342,756,0.6,586,0.6396568160152526
2007,1391,9,20,629,1262,0.3103448275862069,-633,0.33262823902696986
2007,1392,9,20,583,1154,0.3103448275862069,-571,0.335636154289004
2007,1393,22,10,1702,714,0.6875,988,0.7044701986754967
2007,1394,24,6,1956,419,0.8,1537,0.8235789473684211
2007,1395,13,17,888,1004,0.43333333333333335,-116,0.4693446088794926
2007,1396,12,18,1015,1236,0.4,-221,0.4509107063527321
2007,1397,22,10,1856,693,0.6875,1163,0.728128677912907
2007,1398,11,20,702,1278,0.3548387096774194,-576,0.35454545454545455
2007,1399,18,13,1387,907,0.5806451612903226,480,0.6046207497820401
2007,1400,24,9,1974,739,0.7272727272727273,1235,0.7276078142277921
2007,1401,25,6,1957,409,0.8064516129032258,1548,0.827134404057481
2007,1402,6,20,483,1461,0.23076923076923078,-978,0.24845679012345678
2007,1403,21,12,1613,749,0.6363636363636364,864,0.682895850973751
2007,1404,7,23,492,1395,0.23333333333333334,-903,0.26073131955484896
2007,1405,19,12,1348,798,0.6129032258064516,550,0.6281453867660765
2007,1406,15,17,1106,1069,0.46875,37,0.5085057471264368
2007,1407,12,17,953,1183,0.41379310344827586,-230,0.4461610486891386
2007,1408,15,13,1147,783,0.5357142857142857,364,0.5943005181347151
2007,1409,18,11,1312,632,0.6206896551724138,680,0.6748971193415638
2007,1410,10,15,682,948,0.4,-266,0.41840490797546015
2007,1411,11,17,807,992,0.39285714285714285,-185,0.44858254585881047
2007,1412,15,16,1098,953,0.4838709677419355,145,0.5353486104339347
2007,1413,5,23,355,1512,0.17857142857142858,-1157,0.19014461703267274
2007,1414,15,18,1029,1157,0.45454545454545453,-128,0.4707227813357731
2007,1415,5,24,377,1451,0.1724137931034483,-1074,0.2062363238512035
2007,1416,20,9,1486,608,0.6896551724137931,878,0.7096466093600764
2007,1417,25,5,1840,319,0.8333333333333334,1521,0.8522464103751737
2007,1418,8,21,569,1368,0.27586206896551724,-799,0.29375322663913267
2007,1419,15,14,1153,887,0.5172413793103449,266,0.5651960784313725
2007,1420,12,19,837,1038,0.3870967741935484,-201,0.4464
2007,1421,8,19,599,1231,0.2962962962962963,-632,0.3273224043715847
2007,1422,16,14,1174,909,0.5333333333333333,265,0.5636101776284206
2007,1423,7,22,501,1370,0.2413793103448276,-869,0.2677712453233565
2007,1424,27,6,2084,392,0.8181818181818182,1692,0.8416801292407108
2007,1425,23,11,1732,696,0.6764705882352942,1036,0.71334431630972
2007,1426,11,16,862,1095,0.4074074074074074,-233,0.44047010730710273
2007,1427,4,22,238,1249,0.15384615384615385,-1011,0.16005379959650304
2007,1428,11,19,853,1222,0.36666666666666664,-369,0.4110843373493976
2007,1429,22,11,1596,747,0.6666666666666666,849,0.6811779769526248
2007,1430,20,7,1500,426,0.7407407407407407,1074,0.778816199376947
2007,1431,14,17,1132,1212,0.45161290322580644,-80,0.48293515358361777
2007,1433,27,6,2077,391,0.8181818181818182,1686,0.8415721231766613
2007,1434,15,15,1065,907,0.5,158,0.5400608519269777
2007,1435,19,11,1516,756,0.6333333333333333,760,0.6672535211267606
2007,1436,25,7,1845,408,0.78125,1437,0.8189081225033289
2007,1437,21,10,1609,628,0.6774193548387096,981,0.719266875279392
2007,1438,19,10,1571,675,0.6551724137931034,896,0.6994657168299199
2007,1439,20,11,1540,693,0.6451612903225806,847,0.6896551724137931
2007,1440,10,19,994,1777,0.3448275862068966,-783,0.35871526524720315
2007,1441,9,20,647,1311,0.3103448275862069,-664,0.33043922369765066
2007,1442,5,23,309,1417,0.17857142857142858,-1108,0.17902665121668598
2007,1443,21,11,1702,804,0.65625,898,0.6791699920191541
2007,1444,15,16,1144,1060,0.4838709677419355,84,0.5190562613430127
2007,1445,2,24,137,1356,0.07692307692307693,-1219,0.09176155391828533
2007,1447,10,19,778,1249,0.3448275862068966,-471,0.38381845091267885
2007,1448,15,16,1235,1053,0.4838709677419355,182,0.5397727272727273
2007,1449,19,13,1549,900,0.59375,649,0.6325030624744794
2007,1450,25,7,1715,414,0.78125,1301,0.8055425082198215
2007,1451,17,11,1282,707,0.6071428571428571,575,0.644544997486174
2007,1452,21,9,1581,566,0.7,1015,0.736376339077783
2007,1453,16,15,1197,897,0.5161290322580645,300,0.5716332378223495
2007,1454,9,22,627,1380,0.2903225806451613,-753,0.312406576980568
2007,1455,16,14,1173,884,0.5333333333333333,289,0.5702479338842975
2007,1456,15,15,995,911,0.5,84,0.5220356768100735
2007,1457,24,4,1819,256,0.8571428571428571,1563,0.8766265060240964
2007,1458,29,5,2101,282,0.8529411764705882,1819,0.8816617708770458
2007,1459,7,20,527,1338,0.25925925925925924,-811,0.28257372654155494
2007,1460,23,9,1544,523,0.71875,1021,0.7469762941461054
2007,1461,16,15,1263,1025,0.5161290322580645,238,0.5520104895104895
2007,1462,24,8,1897,548,0.75,1349,0.7758691206543967
2007,1463,13,13,913,829,0.5,84,0.5241102181400689
2007,1464,12,17,901,981,0.41379310344827586,-80,0.47874601487778956
2007,3102,6,22,386,1109,0.21428571428571427,-723,0.2581939799331104
2007,3103,10,19,648,1094,0.3448275862068966,-446,0.3719862227324914
2007,3104,10,20,735,1071,0.3333333333333333,-336,0.4069767441860465
2007,3105,16,13,1076,728,0.5517241379310345,348,0.5964523281596452
2007,3106,10,18,674,928,0.35714285714285715,-254,0.4207240948813982
2007,3107,9,22,587,1147,0.2903225806451613,-560,0.33852364475201846
2007,3108,15,13,979,710,0.5357142857142857,269,0.5796329188869154
2007,3110,13,19,850,1049,0.40625,-199,0.4476040021063718
2007,3111,13,18,949,1144,0.41935483870967744,-195,0.453416149068323
2007,3112,11,21,747,1273,0.34375,-526,0.3698019801980198
2007,3113,28,4,2105,265,0.875,1840,0.8881856540084389
2007,3114,19,10,1226,514,0.6551724137931034,712,0.7045977011494253
2007,3115,11,20,700,1131,0.3548387096774194,-431,0.3823047515019115
2007,3116,18,13,1349,822,0.5806451612903226,527,0.6213726393367112
2007,3117,20,12,1434,716,0.625,718,0.6669767441860465
2007,3119,22,6,1458,301,0.7857142857142857,1157,0.8288800454803866
2007,3120,19,12,1438,700,0.6129032258064516,738,0.6725912067352666
2007,3122,10,20,740,1105,0.3333333333333333,-365,0.4010840108401084
2007,3123,24,6,1796,391,0.8,1405,0.8212162780064015
2007,3124,25,7,1954,420,0.78125,1534,0.823083403538332
2007,3125,25,6,1728,320,0.8064516129032258,1408,0.84375
2007,3126,5,25,288,1204,0.16666666666666666,-916,0.19302949061662197
2007,3127,12,19,777,1044,0.3870967741935484,-267,0.42668863261943984
2007,3128,7,22,510,1304,0.2413793103448276,-794,0.28114663726571115
2007,3129,24,8,1689,519,0.75,1170,0.7649456521739131
2007,3130,12,16,787,868,0.42857142857142855,-81,0.4755287009063444
2007,3131,15,15,1078,890,0.5,188,0.5477642276422764
2007,3132,29,3,2232,194,0.90625,2038,0.920032976092333
2007,3133,12,19,884,1120,0.3870967741935484,-236,0.4411177644710579
2007,3135,5,23,332,1197,0.17857142857142858,-865,0.2171353826030085
2007,3137,20,10,1333,512,0.6666666666666666,821,0.7224932249322493
2007,3138,10,19,669,1056,0.3448275862068966,-387,0.38782608695652177
2007,3139,16,15,1190,940,0.5161290322580645,250,0.5586854460093896
2007,3140,23,9,1492,510,0.71875,982,0.7452547452547452
2007,3141,9,19,665,1182,0.32142857142857145,-517,0.36004331348132107
2007,3142,14,14,975,896,0.5,79,0.521111704970604
2007,3143,23,8,1664,450,0.7419354838709677,1214,0.7871333964049196
2007,3144,8,21,562,1194,0.27586206896551724,-632,0.3200455580865604
2007,3145,16,14,1074,784,0.5333333333333333,290,0.5780409041980624
2007,3146,10,14,727,881,0.4166666666666667,-154,0.4521144278606965
2007,3147,5,25,390,1305,0.16666666666666666,-915,0.23008849557522124
2007,3148,6,23,406,1306,0.20689655172413793,-900,0.2371495327102804
2007,3149,7,20,464,1083,0.25925925925925924,-619,0.29993535875888816
2007,3150,18,12,1354,772,0.6,582,0.6368767638758231
2007,3151,25,7,1860,464,0.78125,1396,0.8003442340791739
2007,3152,5,20,343,1042,0.2,-699,0.24765342960288808
2007,3153,15,14,1119,861,0.5172413793103449,258,0.5651515151515152
2007,3155,12,18,916,1156,0.4,-240,0.4420849420849421
2007,3156,8,22,518,1344,0.26666666666666666,-826,0.2781954887218045
2007,3157,14,11,918,587,0.56,331,0.6099667774086379
2007,3158,8,20,528,1038,0.2857142857142857,-510,0.3371647509578544
2007,3159,6,25,369,1277,0.1935483870967742,-908,0.22417982989064397
2007,3160,12,17,834,1006,0.41379310344827586,-172,0.4532608695652174
2007,3161,7,21,505,1129,0.25,-624,0.30905752753977966
2007,3162,8,20,537,1080,0.2857142857142857,-543,0.3320964749536178
2007,3163,29,3,2290,187,0.90625,2103,0.9245054501412999
2007,3164,24,7,1613,390,0.7741935483870968,1223,0.8052920619071393
2007,3165,11,15,710,817,0.4230769230769231,-107,0.46496398166339226
2007,3166,13,19,929,1138,0.40625,-209,0.4494436381228834
2007,3168,16,15,1156,866,0.5161290322580645,290,0.5717111770524234
2007,3169,13,16,944,1111,0.4482758620689655,-167,0.459367396593674
2007,3170,2,27,117,1452,0.06896551724137931,-1335,0.0745697896749522
2007,3171,15,13,1017,707,0.5357142857142857,310,0.589907192575406
2007,3172,22,8,1581,514,0.7333333333333333,1067,0.754653937947494
2007,3173,12,19,849,1154,0.3870967741935484,-305,0.4238642036944583
2007,3174,26,5,1857,287,0.8387096774193549,1570,0.8661380597014925
2007,3175,20,12,1272,548,0.625,724,0.6989010989010989
2007,3176,20,11,1351,615,0.6451612903225806,736,0.6871820956256358
2007,3177,19,12,1479,811,0.6129032258064516,668,0.6458515283842795
2007,3178,5,26,328,1496,0.16129032258064516,-1168,0.17982456140350878
2007,3179,14,18,987,1045,0.4375,-58,0.48572834645669294
2007,3180,10,21,683,1091,0.3225806451612903,-408,0.3850056369785795
2007,3181,30,1,2308,65,0.967741935483871,2243,0.9726085124315212
2007,3182,7,20,485,1108,0.25925925925925924,-623,0.3044569993722536
2007,3183,9,19,708,1259,0.32142857142857145,-551,0.3599389933909507
2007,3184,11,18,844,1213,0.3793103448275862,-369,0.4103062712688381
2007,3185,16,13,1181,800,0.5517241379310345,381,0.5961635537607269
2007,3186,8,19,592,1197,0.2962962962962963,-605,0.33091112353269986
2007,3187,19,13,1383,756,0.59375,627,0.6465638148667602
2007,3189,9,20,514,947,0.3103448275862069,-433,0.351813826146475
2007,3190,20,11,1568,663,0.6451612903225806,905,0.7028238458090542
2007,3191,19,12,1408,819,0.6129032258064516,589,0.632240682532555
2007,3192,11,18,771,992,0.3793103448275862,-221,0.43732274532047644
2007,3193,15,15,1074,821,0.5,253,0.566754617414248
2007,3194,6,25,443,1511,0.1935483870967742,-1068,0.22671443193449334
2007,3196,9,22,686,1441,0.2903225806451613,-755,0.3225199811941702
2007,3197,14,16,1004,876,0.4666666666666667,128,0.5340425531914894
2007,3198,15,14,1023,828,0.5172413793103449,195,0.5526742301458671
2007,3199,22,9,1577,533,0.7096774193548387,1044,0.74739336492891
2007,3200,3,25,209,1218,0.10714285714285714,-1009,0.14646110721793973
2007,3201,18,13,1267,778,0.5806451612903226,489,0.619559902200489
2007,3202,9,20,537,1063,0.3103448275862069,-526,0.335625
2007,3203,26,3,1792,165,0.896551724137931,1627,0.915687276443536
2007,3204,13,18,888,1065,0.41935483870967744,-177,0.45468509984639016
2007,3205,13,17,764,849,0.43333333333333335,-85,0.4736515809051457
2007,3206,8,21,536,1138,0.27586206896551724,-602,0.3201911589008363
2007,3207,13,16,856,840,0.4482758620689655,16,0.5047169811320755
2007,3208,25,6,1922,325,0.8064516129032258,1597,0.8553627058299955
2007,3209,15,15,1138,893,0.5,245,0.5603151157065485
2007,3210,20,11,1445,619,0.6451612903225806,826,0.7000968992248062
2007,3211,23,9,1653,554,0.71875,1099,0.7489805165382872
2007,3212,9,19,615,1130,0.32142857142857145,-515,0.3524355300859599
2007,3214,15,13,1016,737,0.5357142857142857,279,0.5795778665145465
2007,3216,24,8,1478,406,0.75,1072,0.7845010615711253
2007,3217,15,12,1073,758,0.5555555555555556,315,0.58601856908793
2007,3218,15,14,1017,803,0.5172413793103449,214,0.5587912087912088
2007,3219,18,11,1182,601,0.6206896551724138,581,0.6629276500280427
2007,3220,24,7,1642,425,0.7741935483870968,1217,0.7943880019351718
2007,3221,15,17,1013,849,0.46875,164,0.5440386680988185
2007,3222,8,19,659,1044,0.2962962962962963,-385,0.3869641808573106
2007,3224,8,22,625,1332,0.26666666666666666,-707,0.31936637710781807
2007,3225,6,22,430,1312,0.21428571428571427,-882,0.2468427095292767
2007,3226,15,13,1300,903,0.5357142857142857,397,0.5901044030867
2007,3227,19,12,1405,725,0.6129032258064516,680,0.6596244131455399
2007,3228,18,11,1268,642,0.6206896551724138,626,0.6638743455497382
2007,3229,21,10,1599,659,0.6774193548387096,940,0.70814880425155
2007,3231,18,13,1319,773,0.5806451612903226,546,0.6304971319311663
2007,3232,19,11,1530,799,0.6333333333333333,731,0.656934306569343
2007,3233,20,12,1331,612,0.625,719,0.6850231600617601
2007,3234,14,16,1053,981,0.4666666666666667,72,0.5176991150442478
2007,3235,25,8,1803,435,0.7575757575757576,1368,0.8056300268096515
2007,3236,10,16,688,993,0.38461538461538464,-305,0.4092801903628792
2007,3237,14,16,845,900,0.4666666666666667,-55,0.48424068767908307
2007,3238,22,10,1408,550,0.6875,858,0.7191011235955056
2007,3239,21,9,1415,571,0.7,844,0.7124874118831823
2007,3240,7,22,561,1416,0.2413793103448276,-855,0.283763277693475
2007,3241,27,5,2004,326,0.84375,1678,0.8600858369098713
2007,3242,11,20,755,1120,0.3548387096774194,-365,0.4026666666666667
2007,3243,16,14,1126,810,0.5333333333333333,316,0.5816115702479339
2007,3244,13,16,912,983,0.4482758620689655,-71,0.48126649076517153
2007,3245,15,13,1195,852,0.5357142857142857,343,0.583781143136297
2007,3246,18,13,1365,816,0.5806451612903226,549,0.6258596973865199
2007,3247,19,11,1339,578,0.6333333333333333,761,0.6984872196139802
2007,3248,7,23,470,1230,0.23333333333333334,-760,0.27647058823529413
2007,3249,11,17,763,1044,0.39285714285714285,-281,0.4222468179302712
2007,3250,11,19,694,1002,0.36666666666666664,-308,0.4091981132075472
2007,3251,17,12,1216,668,0.5862068965517241,548,0.6454352441613588
2007,3252,7,21,454,1121,0.25,-667,0.28825396825396826
2007,3253,9,23,598,1188,0.28125,-590,0.3348264277715566
2007,3254,22,8,1418,469,0.7333333333333333,949,0.7514573396926338
2007,3255,7,21,420,992,0.25,-572,0.29745042492917845
2007,3256,17,13,1237,741,0.5666666666666667,496,0.6253791708796764
2007,3257,26,7,1998,438,0.7878787878787878,1560,0.8201970443349754
2007,3258,19,12,1255,677,0.6129032258064516,578,0.6495859213250518
2007,3259,18,12,1250,676,0.6,574,0.6490134994807892
2007,3260,7,21,520,1361,0.25,-841,0.27644869750132905
2007,3261,26,7,1806,410,0.7878787878787878,1396,0.8149819494584838
2007,3263,13,15,910,838,0.4642857142857143,72,0.5205949656750573
2007,3264,11,20,738,1009,0.3548387096774194,-271,0.4224384659416142
2007,3265,27,5,1892,281,0.84375,1611,0.8706856879889554
2007,3266,25,6,1826,380,0.8064516129032258,1446,0.827742520398912
2007,3267,15,15,1025,870,0.5,155,0.5408970976253298
2007,3268,27,5,2309,334,0.84375,1975,0.8736284525160802
2007,3269,17,13,1123,760,0.5666666666666667,363,0.596388741370154
2007,3270,3,23,191,1240,0.11538461538461539,-1049,0.1334730957372467
2007,3271,11,20,656,1005,0.3548387096774194,-349,0.39494280553883204
2007,3272,4,27,287,1647,0.12903225806451613,-1360,0.1483971044467425
2007,3273,5,25,296,1136,0.16666666666666666,-840,0.20670391061452514
2007,3274,11,19,853,1146,0.36666666666666664,-293,0.42671335667833915
2007,3275,12,18,972,1209,0.4,-237,0.44566712517193946
2007,3276,10,20,638,1067,0.3333333333333333,-429,0.3741935483870968
2007,3277,23,8,1571,442,0.7419354838709677,1129,0.7804272230501739
2007,3278,16,15,1169,881,0.5161290322580645,288,0.5702439024390243
2007,3279,21,10,1717,672,0.6774193548387096,1045,0.7187107576391796
2007,3280,17,13,1268,769,0.5666666666666667,499,0.6224840451644575
2007,3281,17,13,1275,821,0.5666666666666667,454,0.6083015267175572
2007,3282,9,20,545,1068,0.3103448275862069,-523,0.337879727216367
2007,3283,7,21,479,1245,0.25,-766,0.27784222737819025
2007,3284,18,13,1287,695,0.5806451612903226,592,0.6493440968718466
2007,3285,26,3,2092,151,0.896551724137931,1941,0.9326794471689701
2007,3286,12,15,897,928,0.4444444444444444,-31,0.4915068493150685
2007,3287,14,16,1030,941,0.4666666666666667,89,0.5225773718924404
2007,3288,18,13,1131,694,0.5806451612903226,437,0.6197260273972602
2007,3290,5,20,339,1104,0.2,-765,0.23492723492723494
2007,3291,12,17,825,966,0.41379310344827586,-141,0.46063651591289784
2007,3292,29,3,2347,201,0.90625,2146,0.9211145996860283
2007,3293,19,9,1457,548,0.6785714285714286,909,0.7266832917705736
2007,3294,4,24,286,1265,0.14285714285714285,-979,0.18439716312056736
2007,3295,12,11,876,624,0.5217391304347826,252,0.584
2007,3296,19,12,1430,811,0.6129032258064516,619,0.6381079875055778
2007,3298,12,17,728,862,0.41379310344827586,-134,0.4578616352201258
2007,3299,17,13,1299,816,0.5666666666666667,483,0.6141843971631206
2007,3301,23,9,1571,540,0.71875,1031,0.744197063003316
2007,3304,22,9,1649,570,0.7096774193548387,1079,0.7431275349256422
2007,3305,17,14,1194,897,0.5483870967741935,297,0.5710186513629842
2007,3306,9,20,590,1060,0.3103448275862069,-470,0.3575757575757576
2007,3307,24,8,1685,426,0.75,1259,0.7981999052581715
2007,3308,13,18,877,1006,0.41935483870967744,-129,0.46574614976101963
2007,3309,9,21,651,1078,0.3,-427,0.3765182186234818
2007,3310,14,16,985,904,0.4666666666666667,81,0.5214399152991
2007,3311,7,20,520,1072,0.25925925925925924,-552,0.32663316582914576
2007,3312,3,23,211,1124,0.11538461538461539,-913,0.15805243445692885
2007,3313,5,24,342,1356,0.1724137931034483,-1014,0.20141342756183744
2007,3314,30,3,2640,180,0.9090909090909091,2460,0.9361702127659575
2007,3316,8,21,467,994,0.27586206896551724,-527,0.3196440793976728
2007,3317,9,20,688,1139,0.3103448275862069,-451,0.3765736179529283
2007,3318,4,26,280,1562,0.13333333333333333,-1282,0.15200868621064062
2007,3319,19,12,1377,765,0.6129032258064516,612,0.6428571428571429
2007,3320,17,13,1213,753,0.5666666666666667,460,0.6169888097660223
2007,3321,8,22,547,1197,0.26666666666666666,-650,0.3136467889908257
2007,3322,8,20,557,1187,0.2857142857142857,-630,0.31938073394495414
2007,3323,19,11,1464,665,0.6333333333333333,799,0.687646782527008
2007,3324,17,12,1194,672,0.5862068965517241,522,0.639871382636656
2007,3325,18,12,1310,731,0.6,579,0.6418422341989221
2007,3326,28,3,2089,162,0.9032258064516129,1927,0.928031985784096
2007,3328,26,4,2046,249,0.8666666666666667,1797,0.8915032679738563
2007,3329,20,10,1522,612,0.6666666666666666,910,0.7132146204311153
2007,3330,24,8,1762,488,0.75,1274,0.7831111111111111
2007,3331,20,10,1454,540,0.6666666666666666,914,0.7291875626880642
2007,3332,16,13,1080,734,0.5517241379310345,346,0.5953693495038589
2007,3333,9,19,592,1116,0.32142857142857145,-524,0.34660421545667447
2007,3334,8,22,536,1261,0.26666666666666666,-725,0.29827490261547024
2007,3335,12,15,780,830,0.4444444444444444,-50,0.484472049689441
2007,3336,15,16,1065,905,0.4838709677419355,160,0.5406091370558376
2007,3337,14,17,968,957,0.45161290322580644,11,0.5028571428571429
2007,3338,22,8,1581,433,0.7333333333333333,1148,0.7850049652432969
2007,3339,10,20,698,1165,0.3333333333333333,-467,0.3746645195920558
2007,3340,12,18,914,1186,0.4,-272,0.43523809523809526
2007,3341,18,13,1300,783,0.5806451612903226,517,0.6240998559769563
2007,3343,13,15,902,866,0.4642857142857143,36,0.5101809954751131
2007,3344,13,16,984,901,0.4482758620689655,83,0.5220159151193634
2007,3345,28,5,2007,281,0.8484848484848485,1726,0.8771853146853147
2007,3346,16,12,1122,798,0.5714285714285714,324,0.584375
2007,3347,18,11,1279,653,0.6206896551724138,626,0.662008281573499
2007,3348,6,23,466,1288,0.20689655172413793,-822,0.26567844925883694
2007,3349,19,13,1440,797,0.59375,643,0.6437192668752794
2007,3350,13,17,843,975,0.43333333333333335,-132,0.4636963696369637
2007,3351,2,28,126,1614,0.06666666666666667,-1488,0.07241379310344828
2007,3352,24,7,1825,475,0.7741935483870968,1350,0.7934782608695652
2007,3353,22,8,1492,459,0.7333333333333333,1033,0.7647360328036904
2007,3354,7,22,454,1147,0.2413793103448276,-693,0.2835727670206121
2007,3355,21,5,1586,291,0.8076923076923077,1295,0.8449653702717101
2007,3356,20,10,1320,624,0.6666666666666666,696,0.6790123456790124
2007,3357,22,10,1521,559,0.6875,962,0.73125
2007,3358,3,24,232,1362,0.1111111111111111,-1130,0.14554579673776663
2007,3359,18,13,1170,743,0.5806451612903226,427,0.6116048092002091
2007,3360,20,8,1388,417,0.7142857142857143,971,0.7689750692520776
2007,3361,12,16,775,797,0.42857142857142855,-22,0.49300254452926207
2007,3362,10,21,662,1155,0.3225806451612903,-493,0.364336818932306
2007,3363,5,27,327,1543,0.15625,-1216,0.1748663101604278
2007,3364,18,13,1365,776,0.5806451612903226,589,0.6375525455394675
2007,3365,13,17,1007,1051,0.43333333333333335,-44,0.48931000971817296
2007,3366,9,17,597,933,0.34615384615384615,-336,0.39019607843137255
2007,3368,15,13,1020,681,0.5357142857142857,339,0.599647266313933
2007,3369,22,7,1513,381,0.7586206896551724,1132,0.7988384371700106
2007,3371,18,11,1128,641,0.6206896551724138,487,0.637648388920294
2007,3372,21,11,1529,624,0.65625,905,0.7101718532280539
2007,3373,10,20,692,1088,0.3333333333333333,-396,0.3887640449438202
2007,3374,18,12,1318,728,0.6,590,0.6441837732160313
2007,3375,12,16,714,859,0.42857142857142855,-145,0.45390972663699936
2007,3376,17,14,1336,789,0.5483870967741935,547,0.6287058823529412
2007,3378,20,11,1604,649,0.6451612903225806,955,0.7119396360408344
2007,3379,15,15,1088,820,0.5,268,0.570230607966457
2007,3380,5,22,297,1098,0.18518518518518517,-801,0.2129032258064516
2007,3381,7,20,391,963,0.25925925925925924,-572,0.28877400295420974
2007,3382,16,15,1068,879,0.5161290322580645,189,0.5485362095531587
2007,3383,13,18,836,1010,0.41935483870967744,-174,0.4528710725893825
2007,3384,7,22,486,1366,0.2413793103448276,-880,0.26241900647948163
2007,3385,8,20,560,1141,0.2857142857142857,-581,0.3292181069958848
2007,3386,19,13,1314,800,0.59375,514,0.6215704824976348
2007,3387,13,17,1027,1076,0.43333333333333335,-49,0.48834997622444126
2007,3388,14,14,1038,879,0.5,159,0.5414710485133021
2007,3389,12,18,782,1010,0.4,-228,0.43638392857142855
2007,3390,28,4,2030,238,0.875,1792,0.8950617283950617
2007,3391,5,25,322,1366,0.16666666666666666,-1044,0.19075829383886256
2007,3392,18,11,1354,678,0.6206896551724138,676,0.6663385826771654
2007,3393,9,20,612,1084,0.3103448275862069,-472,0.3608490566037736
2007,3394,13,16,925,947,0.4482758620689655,-22,0.49412393162393164
2007,3395,21,10,1642,603,0.6774193548387096,1039,0.7314031180400891
2007,3396,24,7,1690,409,0.7741935483870968,1281,0.8051453072891853
2007,3397,28,3,2121,181,0.9032258064516129,1940,0.921372719374457
2007,3398,6,22,409,1265,0.21428571428571427,-856,0.24432497013142174
2007,3399,11,18,758,1053,0.3793103448275862,-295,0.41855328547763665
2007,3400,18,14,1273,787,0.5625,486,0.6179611650485437
2007,3401,24,6,1674,320,0.8,1354,0.839518555667001
2007,3402,15,12,1025,695,0.5555555555555556,330,0.5959302325581395
2007,3403,15,16,1028,949,0.4838709677419355,79,0.5199797673242287
2007,3404,17,14,1136,707,0.5483870967741935,429,0.6163863266413456
2007,3405,11,19,791,1111,0.36666666666666664,-320,0.41587802313354366
2007,3406,17,12,1137,603,0.5862068965517241,534,0.653448275862069
2007,3407,10,17,680,917,0.37037037037037035,-237,0.4257983719474014
2007,3408,24,6,1767,337,0.8,1430,0.839828897338403
2007,3409,11,19,754,1106,0.36666666666666664,-352,0.4053763440860215
2007,3410,8,18,498,908,0.3076923076923077,-410,0.3541963015647226
2007,3411,4,22,236,1073,0.15384615384615385,-837,0.18029029793735676
2007,3412,18,12,1271,798,0.6,473,0.6143064282261962
2007,3413,11,16,724,918,0.4074074074074074,-194,0.440925700365408
2007,3414,6,24,451,1446,0.2,-995,0.23774380600948866
2007,3415,21,9,1369,475,0.7,894,0.7424078091106291
2007,3416,8,22,533,1203,0.26666666666666666,-670,0.30702764976958524
2007,3417,14,18,1055,1114,0.4375,-59,0.4863992623328723
2007,3418,25,8,1817,434,0.7575757575757576,1383,0.8071968014215904
2007,3419,13,16,859,884,0.4482758620689655,-25,0.49282845668387837
2007,3420,16,16,1044,878,0.5,166,0.5431841831425598
2007,3421,18,11,1255,719,0.6206896551724138,536,0.6357649442755826
2007,3422,20,10,1431,559,0.6666666666666666,872,0.7190954773869347
2007,3423,8,23,466,1239,0.25806451612903225,-773,0.27331378299120235
2007,3424,13,15,894,825,0.4642857142857143,69,0.5200698080279232
2007,3425,17,13,1217,769,0.5666666666666667,448,0.6127895266868076
2007,3426,24,8,1633,458,0.75,1175,0.7809660449545672
2007,3427,14,15,963,817,0.4827586206896552,146,0.5410112359550562
2007,3428,18,13,1195,692,0.5806451612903226,503,0.6332803391626921
2007,3429,11,18,749,979,0.3793103448275862,-230,0.43344907407407407
2007,3430,13,13,977,860,0.5,117,0.5318454001088732
2007,3431,20,8,1464,425,0.7142857142857143,1039,0.7750132345156168
2007,3433,17,13,1149,771,0.5666666666666667,378,0.5984375
2007,3434,18,11,1180,592,0.6206896551724138,588,0.6659142212189616
2007,3435,27,5,2182,295,0.84375,1887,0.880904319741623
2007,3436,19,12,1321,727,0.6129032258064516,594,0.64501953125
2007,3437,8,21,500,1119,0.27586206896551724,-619,0.30883261272390367
2007,3438,17,14,1378,870,0.5483870967741935,508,0.6129893238434164
2007,3439,18,14,1256,843,0.5625,413,0.5983801810385898
2007,3441,23,9,1656,547,0.71875,1109,0.7517022242396731
2007,3442,8,19,449,977,0.2962962962962963,-528,0.31486676016830295
2007,3443,20,8,1505,520,0.7142857142857143,985,0.7432098765432099
2007,3444,14,18,1087,1151,0.4375,-64,0.48570151921358357
2007,3445,8,18,528,887,0.3076923076923077,-359,0.37314487632508836
2007,3447,3,26,202,1362,0.10344827586206896,-1160,0.12915601023017903
2007,3448,9,20,581,1057,0.3103448275862069,-476,0.3547008547008547
2007,3449,18,12,1365,790,0.6,575,0.6334106728538283
2007,3450,5,24,357,1280,0.1724137931034483,-923,0.2180818570555895
2007,3451,16,14,1176,829,0.5333333333333333,347,0.5865336658354114
2007,3452,20,10,1417,514,0.6666666666666666,903,0.7338166752977732
2007,3453,28,3,2180,200,0.9032258064516129,1980,0.9159663865546218
2007,3454,15,16,1086,975,0.4838709677419355,111,0.5269286754002911
2007,3455,9,20,670,1303,0.3103448275862069,-633,0.3395843892549417
2007,3456,19,12,1234,645,0.6129032258064516,589,0.6567323044172432
2007,3457,6,26,409,1324,0.1875,-915,0.2360069244085401
2007,3458,19,12,1436,734,0.6129032258064516,702,0.6617511520737327
2007,3459,11,16,689,895,0.4074074074074074,-206,0.43497474747474746
2007,3460,10,18,618,1018,0.35714285714285715,-400,0.37775061124694376
2007,3461,20,9,1370,496,0.6896551724137931,874,0.7341907824222936
2007,3462,26,7,1896,413,0.7878787878787878,1483,0.8211346903421395
2007,3463,12,16,807,966,0.42857142857142855,-159,0.45516074450084604
2007,3464,6,21,389,1150,0.2222222222222222,-761,0.25276153346328784
2008,1102,14,14,886,726,0.5,160,0.5496277915632755
2008,1103,23,10,1707,644,0.696969696969697,1063,0.7260740110591237
2008,1104,17,16,1383,1101,0.5151515151515151,282,0.5567632850241546
2008,1105,11,15,786,883,0.4230769230769231,-97,0.47094068304373876
2008,1106,17,10,1267,650,0.6296296296296297,617,0.6609285341679708
2008,1107,15,15,1087,961,0.5,126,0.53076171875
2008,1108,6,23,428,1516,0.20689655172413793,-1088,0.22016460905349794
2008,1110,21,11,1420,663,0.65625,757,0.6817090734517522
2008,1111,17,13,1297,835,0.5666666666666667,462,0.6083489681050657
2008,1112,18,14,1395,895,0.5625,500,0.6091703056768559
2008,1113,19,12,1427,658,0.6129032258064516,769,0.6844124700239809
2008,1114,18,11,1250,609,0.6206896551724138,641,0.6724045185583647
2008,1115,11,18,747,963,0.3793103448275862,-216,0.4368421052631579
2008,1116,22,11,1717,713,0.6666666666666666,1004,0.7065843621399177
2008,1117,8,20,590,1335,0.2857142857142857,-745,0.3064935064935065
2008,1119,14,16,879,891,0.4666666666666667,-12,0.4966101694915254
2008,1120,14,16,1071,1070,0.4666666666666667,1,0.5002335357309668
2008,1122,24,10,1851,685,0.7058823529411765,1166,0.7298895899053628
2008,1123,6,24,419,1314,0.2,-895,0.24177726485862666
2008,1124,20,10,1655,767,0.6666666666666666,888,0.6833195706028076
2008,1125,24,8,1974,564,0.75,1410,0.7777777777777778
2008,1126,9,20,536,1121,0.3103448275862069,-585,0.32347616173808086
2008,1127,14,16,954,1022,0.4666666666666667,-68,0.48279352226720645
2008,1129,24,8,1997,602,0.75,1395,0.7683724509426703
2008,1130,14,17,1062,1141,0.45161290322580644,-79,0.4820699046754426
2008,1131,14,17,994,960,0.45161290322580644,34,0.5087001023541453
2008,1132,13,17,907,997,0.43333333333333335,-90,0.47636554621848737
2008,1133,17,15,1290,1055,0.53125,235,0.5501066098081023
2008,1135,19,9,1383,540,0.6785714285714286,843,0.719188767550702
2008,1137,12,19,886,1039,0.3870967741935484,-153,0.46025974025974026
2008,1138,9,20,718,1339,0.3103448275862069,-621,0.34905201750121534
2008,1139,29,3,2029,158,0.90625,1871,0.9277549154092364
2008,1140,27,7,2095,423,0.7941176470588235,1672,0.8320095313741064
2008,1141,13,16,993,1045,0.4482758620689655,-52,0.4872423945044161
2008,1142,11,18,783,1047,0.3793103448275862,-264,0.4278688524590164
2008,1143,16,15,1307,1090,0.5161290322580645,217,0.5452649144764289
2008,1144,9,20,706,1362,0.3103448275862069,-656,0.3413926499032882
2008,1145,6,25,455,1468,0.1935483870967742,-1013,0.23660946437857514
2008,1146,10,16,722,973,0.38461538461538464,-251,0.4259587020648968
2008,1147,9,21,710,1353,0.3,-643,0.34415899175957343
2008,1148,14,16,1083,1012,0.4666666666666667,71,0.516945107398568
2008,1149,6,20,475,1369,0.23076923076923078,-894,0.2575921908893709
2008,1150,20,13,1488,830,0.6060606060606061,658,0.6419327006039689
2008,1151,16,13,1265,870,0.5517241379310345,395,0.5925058548009368
2008,1152,8,17,660,1119,0.32,-459,0.37099494097807756
2008,1153,13,18,843,1157,0.41935483870967744,-314,0.4215
2008,1154,2,24,133,1423,0.07692307692307693,-1290,0.08547557840616966
2008,1155,23,9,1836,698,0.71875,1138,0.7245461720599842
2008,1156,19,12,1341,709,0.6129032258064516,632,0.6541463414634147
2008,1157,10,15,713,960,0.4,-247,0.4261805140466228
2008,1158,16,17,1225,1166,0.48484848484848486,59,0.5123379339188624
2008,1159,18,14,1238,857,0.5625,381,0.5909307875894988
2008,1160,11,20,769,1150,0.3548387096774194,-381,0.4007295466388744
2008,1161,6,24,405,1468,0.2,-1063,0.21623064602242392
2008,1162,13,15,877,860,0.4642857142857143,17,0.5048934945308002
2008,1163,24,8,1921,566,0.75,1355,0.7724165661439485
2008,1164,14,20,985,1026,0.4117647058823529,-41,0.48980606663351567
2008,1165,21,5,1624,368,0.8076923076923077,1256,0.8152610441767069
2008,1166,21,10,1640,592,0.6774193548387096,1048,0.7347670250896058
2008,1167,8,21,617,1312,0.27586206896551724,-695,0.31985484707102124
2008,1168,23,8,1969,588,0.7419354838709677,1381,0.7700430191630817
2008,1169,19,10,1555,691,0.6551724137931034,864,0.6923419412288513
2008,1170,2,24,152,1477,0.07692307692307693,-1325,0.09330877839165132
2008,1171,9,18,683,998,0.3333333333333333,-315,0.40630577037477694
2008,1172,25,6,1984,413,0.8064516129032258,1571,0.8277012932832708
2008,1173,21,10,1521,612,0.6774193548387096,909,0.7130801687763713
2008,1174,14,17,960,996,0.45161290322580644,-36,0.49079754601226994
2008,1175,12,16,781,841,0.42857142857142855,-60,0.4815043156596794
2008,1176,10,19,648,974,0.3448275862068966,-326,0.3995067817509248
2008,1177,11,19,812,1365,0.36666666666666664,-553,0.3729903536977492
2008,1178,6,23,406,1292,0.20689655172413793,-886,0.23910482921083628
2008,1179,26,4,1886,282,0.8666666666666667,1604,0.8699261992619927
2008,1180,12,20,803,1101,0.375,-298,0.4217436974789916
2008,1181,27,5,2318,374,0.84375,1944,0.8610698365527489
2008,1182,17,13,1538,932,0.5666666666666667,606,0.622672064777328
2008,1183,6,22,455,1293,0.21428571428571427,-838,0.2602974828375286
2008,1184,12,16,817,939,0.42857142857142855,-122,0.4652619589977221
2008,1185,14,17,992,1062,0.45161290322580644,-70,0.48296007789678674
2008,1186,9,19,624,1118,0.32142857142857145,-494,0.3582089552238806
2008,1187,9,18,691,1117,0.3333333333333333,-426,0.3821902654867257
2008,1189,13,18,879,1058,0.41935483870967744,-179,0.453794527620031
2008,1190,18,13,1478,938,0.5806451612903226,540,0.6117549668874173
2008,1191,8,21,527,1201,0.27586206896551724,-674,0.30497685185185186
2008,1192,8,20,623,1338,0.2857142857142857,-715,0.31769505354411015
2008,1193,14,16,1023,949,0.4666666666666667,74,0.518762677484787
2008,1194,15,18,1216,1149,0.45454545454545453,67,0.5141649048625793
2008,1195,10,21,730,1315,0.3225806451612903,-585,0.3569682151589242
2008,1196,21,11,1755,745,0.65625,1010,0.702
2008,1197,13,17,923,981,0.43333333333333335,-58,0.4847689075630252
2008,1198,8,20,572,1203,0.2857142857142857,-631,0.3222535211267606
2008,1199,19,14,1388,1003,0.5757575757575758,385,0.5805102467586783
2008,1200,11,17,795,1009,0.39285714285714285,-214,0.4406873614190687
2008,1201,12,19,867,1248,0.3870967741935484,-381,0.4099290780141844
2008,1202,7,23,467,1370,0.23333333333333334,-903,0.2542188350571584
2008,1203,9,17,617,1032,0.34615384615384615,-415,0.3741661613098848
2008,1204,18,12,1344,881,0.6,463,0.6040449438202247
2008,1205,15,16,1228,1138,0.4838709677419355,90,0.5190194420963652
2008,1206,23,10,1667,639,0.696969696969697,1028,0.722896790980052
2008,1207,27,5,1914,317,0.84375,1597,0.8579112505602868
2008,1208,16,16,1181,991,0.5,190,0.5437384898710865
2008,1209,9,21,643,1204,0.3,-561,0.34813210611802925
2008,1210,15,17,1255,1227,0.46875,28,0.5056406124093473
2008,1211,25,7,1978,470,0.78125,1508,0.8080065359477124
2008,1212,7,17,518,1048,0.2916666666666667,-530,0.33077905491698595
2008,1214,18,12,1216,739,0.6,477,0.6219948849104859
2008,1216,18,16,1266,1141,0.5294117647058824,125,0.5259659326963024
2008,1217,8,22,637,1419,0.26666666666666666,-782,0.3098249027237354
2008,1218,11,19,817,1294,0.36666666666666664,-477,0.38702036949313123
2008,1219,13,14,968,854,0.48148148148148145,114,0.531284302963776
2008,1220,12,18,846,1143,0.4,-297,0.4253393665158371
2008,1221,15,14,984,797,0.5172413793103449,187,0.5524985962942167
2008,1222,22,9,1733,708,0.7096774193548387,1025,0.7099549365014338
2008,1223,1,9,63,637,0.1,-574,0.09
2008,1224,6,26,417,1400,0.1875,-983,0.2294991744634012
2008,1225,7,21,530,1239,0.25,-709,0.29960429621254947
2008,1226,10,19,662,1047,0.3448275862068966,-385,0.38736102984201287
2008,1227,17,15,1277,888,0.53125,389,0.589838337182448
2008,1228,16,19,1102,1125,0.45714285714285713,-23,0.49483610237988324
2008,1229,23,9,1528,579,0.71875,949,0.7252017085904129
2008,1231,25,7,1965,439,0.78125,1526,0.81738768718802
2008,1232,14,16,986,955,0.4666666666666667,31,0.5079855744461618
2008,1233,12,20,847,1252,0.375,-405,0.40352548832777513
2008,1234,13,19,768,1026,0.40625,-258,0.4280936454849498
2008,1235,13,18,904,1067,0.41935483870967744,-163,0.45865043125317095
2008,1236,11,18,825,1098,0.3793103448275862,-273,0.4290171606864275
2008,1237,23,7,1785,452,0.7666666666666667,1333,0.7979436745641484
2008,1238,14,20,1034,1306,0.4117647058823529,-272,0.44188034188034186
2008,1239,17,13,1323,847,0.5666666666666667,476,0.6096774193548387
2008,1240,5,22,387,1515,0.18518518518518517,-1128,0.20347003154574134
2008,1241,13,17,1047,1141,0.43333333333333335,-94,0.47851919561243145
2008,1242,30,3,2475,204,0.9090909090909091,2271,0.9238521836506159
2008,1243,19,11,1575,788,0.6333333333333333,787,0.6665256030469742
2008,1244,9,20,677,1308,0.3103448275862069,-631,0.3410579345088161
2008,1245,28,6,1970,384,0.8235294117647058,1586,0.836873406966865
2008,1246,18,12,1268,790,0.6,478,0.6161321671525753
2008,1247,14,17,1062,1245,0.45161290322580644,-183,0.46033810143042914
2008,1248,15,15,1178,1069,0.5,109,0.5242545616377392
2008,1249,15,11,1263,763,0.5769230769230769,500,0.623395853899309
2008,1250,14,15,877,973,0.4827586206896552,-96,0.47405405405405404
2008,1251,13,16,997,1003,0.4482758620689655,-6,0.4985
2008,1252,14,16,1037,1113,0.4666666666666667,-76,0.4823255813953488
2008,1253,6,25,404,1540,0.1935483870967742,-1136,0.20781893004115226
2008,1254,15,15,1176,996,0.5,180,0.5414364640883977
2008,1255,6,22,494,1356,0.21428571428571427,-862,0.267027027027027
2008,1256,6,24,443,1381,0.2,-938,0.24287280701754385
2008,1257,24,8,1775,527,0.75,1248,0.7710686359687229
2008,1258,5,26,401,1517,0.16129032258064516,-1116,0.20907194994786235
2008,1259,19,14,1434,931,0.5757575757575758,503,0.6063424947145878
2008,1260,10,19,687,1051,0.3448275862068966,-364,0.3952819332566168
2008,1261,12,18,903,1150,0.4,-247,0.4398441305406722
2008,1263,6,23,468,1363,0.20689655172413793,-895,0.255598033861278
2008,1264,12,19,899,1248,0.3870967741935484,-349,0.41872380065207265
2008,1265,18,14,1297,940,0.5625,357,0.5797943674564149
2008,1266,23,9,1827,602,0.71875,1225,0.7521613832853026
2008,1267,14,14,999,872,0.5,127,0.5339390700160342
2008,1268,18,14,1389,954,0.5625,435,0.5928297055057619
2008,1269,21,10,1809,733,0.6774193548387096,1076,0.7116443745082612
2008,1270,10,16,726,932,0.38461538461538464,-206,0.4378769601930036
2008,1271,4,28,257,1621,0.125,-1364,0.13684771033013846
2008,1272,33,1,2647,62,0.9705882352941176,2585,0.9771133259505352
2008,1273,10,19,840,1369,0.3448275862068966,-529,0.38026256224535987
2008,1274,21,10,1607,681,0.6774193548387096,926,0.7023601398601399
2008,1275,17,15,1159,858,0.53125,301,0.5746157659890927
2008,1276,10,22,708,1298,0.3125,-590,0.35294117647058826
2008,1277,25,8,1904,449,0.7575757575757576,1455,0.8091797705057373
2008,1278,20,13,1508,756,0.6060606060606061,752,0.666077738515901
2008,1279,21,10,1746,717,0.6774193548387096,1029,0.7088915956151035
2008,1280,22,10,1686,653,0.6875,1033,0.7208208636169303
2008,1281,16,16,1319,1149,0.5,170,0.5344408427876823
2008,1282,9,21,644,1385,0.3,-741,0.3173977328733366
2008,1283,16,16,1177,973,0.5,204,0.5474418604651162
2008,1284,7,24,428,1406,0.22580645161290322,-978,0.23336968375136313
2008,1285,12,16,890,1028,0.42857142857142855,-138,0.4640250260688217
2008,1286,13,15,990,1018,0.4642857142857143,-28,0.49302788844621515
2008,1287,13,15,947,825,0.4642857142857143,122,0.5344243792325056
2008,1288,21,10,1435,653,0.6774193548387096,782,0.6872605363984674
2008,1290,15,15,1035,796,0.5,239,0.5652648825778264
2008,1291,18,14,1311,899,0.5625,412,0.5932126696832579
2008,1292,16,15,1141,948,0.5161290322580645,193,0.5461943513642892
2008,1293,16,13,1248,850,0.5517241379310345,398,0.5948522402287894
2008,1294,11,16,821,1037,0.4074074074074074,-216,0.4418729817007535
2008,1295,14,13,1177,849,0.5185185185185185,328,0.5809476801579467
2008,1296,6,22,413,1427,0.21428571428571427,-1014,0.22445652173913044
2008,1298,16,14,1266,1023,0.5333333333333333,243,0.5530799475753604
2008,1299,12,16,928,945,0.42857142857142855,-17,0.4954618259476775
2008,1300,3,24,200,1279,0.1111111111111111,-1079,0.1352265043948614
2008,1301,15,16,1040,1046,0.4838709677419355,-6,0.49856184084372
2008,1304,19,12,1348,724,0.6129032258064516,624,0.6505791505791506
2008,1305,20,11,1579,726,0.6451612903225806,853,0.6850325379609544
2008,1306,8,20,595,1271,0.2857142857142857,-676,0.31886387995712756
2008,1307,24,8,1827,553,0.75,1274,0.7676470588235295
2008,1308,20,14,1654,1039,0.5882352941176471,615,0.6141849238767174
2008,1309,17,13,1286,884,0.5666666666666667,402,0.5926267281105991
2008,1310,19,10,1502,717,0.6551724137931034,785,0.6768814781433078
2008,1311,9,21,658,1257,0.3,-599,0.34360313315926894
2008,1313,16,15,1186,972,0.5161290322580645,214,0.5495829471733086
2008,1314,32,2,2858,158,0.9411764705882353,2700,0.9476127320954907
2008,1316,2,26,137,1529,0.07142857142857142,-1392,0.0822328931572629
2008,1317,17,11,1319,779,0.6071428571428571,540,0.628693994280267
2008,1318,14,17,928,1037,0.45161290322580644,-109,0.472264631043257
2008,1319,19,11,1416,734,0.6333333333333333,682,0.6586046511627907
2008,1320,17,14,1141,756,0.5483870967741935,385,0.6014760147601476
2008,1321,7,22,493,1266,0.2413793103448276,-773,0.2802728823194997
2008,1322,13,17,1007,1168,0.43333333333333335,-161,0.4629885057471264
2008,1323,24,7,1993,506,0.7741935483870968,1487,0.7975190076030412
2008,1324,15,14,1255,961,0.5172413793103449,294,0.5663357400722022
2008,1325,19,12,1359,722,0.6129032258064516,637,0.6530514175876982
2008,1326,19,13,1392,755,0.59375,637,0.648346530041919
2008,1328,22,11,1648,610,0.6666666666666666,1038,0.7298494242692648
2008,1329,16,15,1224,918,0.5161290322580645,306,0.5714285714285714
2008,1330,17,15,1213,906,0.53125,307,0.5724398301085417
2008,1331,23,8,1654,481,0.7419354838709677,1173,0.7747072599531616
2008,1332,18,13,1502,879,0.5806451612903226,623,0.6308273834523309
2008,1333,6,24,403,1395,0.2,-992,0.22413793103448276
2008,1334,20,10,1533,612,0.6666666666666666,921,0.7146853146853147
2008,1335,13,18,955,1141,0.41935483870967744,-186,0.4556297709923664
2008,1336,15,16,1076,943,0.4838709677419355,133,0.532937097573056
2008,1337,10,21,788,1459,0.3225806451612903,-671,0.3506898086337339
2008,1338,26,9,2042,553,0.7428571428571429,1489,0.786897880539499
2008,1339,8,22,570,1315,0.26666666666666666,-745,0.30238726790450926
2008,1340,21,9,1652,571,0.7,1081,0.7431399010346379
2008,1341,7,22,544,1345,0.2413793103448276,-801,0.2879830598200106
2008,1342,2,25,114,1386,0.07407407407407407,-1272,0.076
2008,1343,5,22,325,1218,0.18518518518518517,-893,0.21062864549578741
2008,1344,15,16,1234,1019,0.4838709677419355,215,0.5477141588992455
2008,1345,24,8,1645,554,0.75,1091,0.7480673033196907
2008,1346,15,15,1162,1064,0.5,98,0.5220125786163522
2008,1347,8,20,666,1247,0.2857142857142857,-581,0.34814427600627285
2008,1348,21,11,1748,837,0.65625,911,0.6762088974854932
2008,1349,3,27,213,1465,0.1,-1252,0.12693682955899882
2008,1350,16,14,1054,856,0.5333333333333333,198,0.5518324607329843
2008,1351,23,10,1851,694,0.696969696969697,1157,0.7273084479371317
2008,1352,26,7,1980,489,0.7878787878787878,1491,0.8019441069258809
2008,1353,11,20,780,1148,0.3548387096774194,-368,0.4045643153526971
2008,1354,12,20,895,1355,0.375,-460,0.3977777777777778
2008,1355,7,21,483,1360,0.25,-877,0.26207270754205103
2008,1356,17,14,1210,735,0.5483870967741935,475,0.622107969151671
2008,1357,18,14,1351,949,0.5625,402,0.587391304347826
2008,1358,19,8,1283,574,0.7037037037037037,709,0.6908992999461497
2008,1359,12,16,747,883,0.42857142857142855,-136,0.4582822085889571
2008,1360,20,13,1380,765,0.6060606060606061,615,0.6433566433566433
2008,1361,19,12,1361,718,0.6129032258064516,643,0.6546416546416547
2008,1362,9,21,702,1280,0.3,-578,0.35418768920282545
2008,1363,13,19,910,1227,0.40625,-317,0.4258306036499766
2008,1364,22,8,1598,491,0.7333333333333333,1107,0.7649593106749641
2008,1365,13,16,903,902,0.4482758620689655,1,0.5002770083102493
2008,1366,10,17,646,898,0.37037037037037035,-252,0.4183937823834197
2008,1367,6,22,409,1331,0.21428571428571427,-922,0.23505747126436782
2008,1368,13,13,913,764,0.5,149,0.5444245676803816
2008,1369,10,19,827,1384,0.3448275862068966,-557,0.37403889642695615
2008,1371,17,15,1429,1023,0.53125,406,0.58278955954323
2008,1372,22,5,1489,288,0.8148148148148148,1201,0.8379290939786156
2008,1373,22,10,1747,711,0.6875,1036,0.710740439381611
2008,1374,9,20,654,1181,0.3103448275862069,-527,0.3564032697547684
2008,1375,25,6,1908,436,0.8064516129032258,1472,0.8139931740614335
2008,1376,14,18,1096,1218,0.4375,-122,0.4736387208297321
2008,1378,12,19,932,1200,0.3870967741935484,-268,0.4371482176360225
2008,1379,15,14,1168,857,0.5172413793103449,311,0.5767901234567901
2008,1380,10,18,746,971,0.35714285714285715,-225,0.4344787419918462
2008,1381,11,18,847,1147,0.3793103448275862,-300,0.4247743229689067
2008,1382,8,22,584,1408,0.26666666666666666,-824,0.2931726907630522
2008,1383,7,22,479,1474,0.2413793103448276,-995,0.2452636968766001
2008,1384,5,23,360,1411,0.17857142857142858,-1051,0.20327498588368154
2008,1385,11,19,761,1103,0.36666666666666664,-342,0.4082618025751073
2008,1386,21,12,1579,841,0.6363636363636364,738,0.6524793388429752
2008,1387,16,15,1071,791,0.5161290322580645,280,0.575187969924812
2008,1388,24,6,1900,375,0.8,1525,0.8351648351648352
2008,1389,6,24,427,1575,0.2,-1148,0.21328671328671328
2008,1390,26,7,1869,463,0.7878787878787878,1406,0.8014579759862779
2008,1391,15,16,1054,980,0.4838709677419355,74,0.5181907571288102
2008,1392,7,23,484,1353,0.23333333333333334,-869,0.2634730538922156
2008,1393,19,13,1583,930,0.59375,653,0.6299243931555909
2008,1394,9,20,644,1213,0.3103448275862069,-569,0.34679590737749055
2008,1395,13,16,1009,939,0.4482758620689655,70,0.5179671457905544
2008,1396,21,12,1577,819,0.6363636363636364,758,0.6581803005008348
2008,1397,28,4,2333,304,0.875,2029,0.8847174819871065
2008,1398,13,17,963,1273,0.43333333333333335,-310,0.43067978533094814
2008,1399,11,19,859,1338,0.36666666666666664,-479,0.3909877105143377
2008,1400,27,6,2031,439,0.8181818181818182,1592,0.8222672064777328
2008,1401,23,10,1737,610,0.696969696969697,1127,0.7400937366851299
2008,1402,10,16,863,1247,0.38461538461538464,-384,0.4090047393364929
2008,1403,15,15,1164,928,0.5,236,0.5564053537284895
2008,1404,15,16,1199,1142,0.4838709677419355,57,0.5121742844938061
2008,1405,11,19,718,1076,0.36666666666666664,-358,0.40022296544035674
2008,1406,13,18,966,1061,0.41935483870967744,-95,0.47656635421805627
2008,1407,10,19,823,1326,0.3448275862068966,-503,0.3829688227082364
2008,1408,16,15,1142,885,0.5161290322580645,257,0.5633941785890478
2008,1409,20,13,1503,823,0.6060606060606061,680,0.6461736887360275
2008,1410,14,13,1080,864,0.5185185185185185,216,0.5555555555555556
2008,1411,7,25,507,1503,0.21875,-996,0.25223880597014925
2008,1412,22,10,1722,650,0.6875,1072,0.7259696458684655
2008,1413,7,22,498,1296,0.2413793103448276,-798,0.27759197324414714
2008,1414,17,16,1194,1030,0.5151515151515151,164,0.5368705035971223
2008,1415,8,21,575,1143,0.27586206896551724,-568,0.33469150174621654
2008,1416,16,15,1240,1029,0.5161290322580645,211,0.5464962538563244
2008,1417,30,3,2258,185,0.9090909090909091,2073,0.9242734343020876
2008,1418,14,15,973,899,0.4827586206896552,74,0.5197649572649573
2008,1419,7,21,534,1333,0.25,-799,0.28602035350830207
2008,1420,23,8,1780,541,0.7419354838709677,1239,0.7669108143041792
2008,1421,19,9,1493,593,0.6785714285714286,900,0.7157238734419943
2008,1422,19,12,1444,750,0.6129032258064516,694,0.658158614402917
2008,1423,20,13,1550,847,0.6060606060606061,703,0.6466416353775553
2008,1424,25,7,1840,376,0.78125,1464,0.8303249097472925
2008,1425,21,11,1545,665,0.65625,880,0.6990950226244343
2008,1426,17,11,1278,752,0.6071428571428571,526,0.6295566502463055
2008,1427,9,17,675,919,0.34615384615384615,-244,0.4234629861982434
2008,1428,16,14,1169,869,0.5333333333333333,300,0.5736015701668302
2008,1429,23,10,1795,656,0.696969696969697,1139,0.7323541411668707
2008,1430,13,14,1002,893,0.48148148148148145,109,0.5287598944591029
2008,1431,19,13,1510,948,0.59375,562,0.6143205858421481
2008,1433,24,7,1670,410,0.7741935483870968,1260,0.8028846153846154
2008,1434,19,13,1398,838,0.59375,560,0.6252236135957067
2008,1435,26,7,2183,476,0.7878787878787878,1707,0.8209853328318917
2008,1436,16,15,1235,1006,0.5161290322580645,229,0.5510932619366354
2008,1437,20,12,1543,788,0.625,755,0.661947661947662
2008,1438,15,15,1255,1049,0.5,206,0.5447048611111112
2008,1439,19,13,1363,852,0.59375,511,0.6153498871331828
2008,1440,10,15,945,1178,0.4,-233,0.44512482336316533
2008,1441,9,21,610,1282,0.3,-672,0.3224101479915433
2008,1442,10,18,729,1126,0.35714285714285715,-397,0.3929919137466307
2008,1443,25,6,1958,417,0.8064516129032258,1541,0.8244210526315789
2008,1444,20,12,1440,791,0.625,649,0.6454504706409682
2008,1445,10,18,714,1019,0.35714285714285715,-305,0.41200230813618005
2008,1447,23,8,1739,478,0.7419354838709677,1261,0.7843933243121335
2008,1448,17,13,1277,889,0.5666666666666667,388,0.5895660203139428
2008,1449,16,16,1286,1059,0.5,227,0.5484008528784649
2008,1450,24,8,1644,502,0.75,1142,0.766076421248835
2008,1451,15,13,1069,771,0.5357142857142857,298,0.5809782608695652
2008,1452,23,10,1869,596,0.696969696969697,1273,0.7582150101419878
2008,1453,15,15,1081,990,0.5,91,0.521970062771608
2008,1454,13,16,940,989,0.4482758620689655,-49,0.48729911871435977
2008,1455,11,20,753,1186,0.3548387096774194,-433,0.38834450747808147
2008,1456,16,16,1054,918,0.5,136,0.5344827586206896
2008,1457,20,11,1388,631,0.6451612903225806,757,0.6874690440812283
2008,1458,29,4,1965,257,0.8787878787878788,1708,0.8843384338433843
2008,1459,12,16,867,951,0.42857142857142855,-84,0.4768976897689769
2008,1460,21,10,1326,618,0.6774193548387096,708,0.6820987654320988
2008,1461,10,18,733,1175,0.35714285714285715,-442,0.3841719077568134
2008,1462,27,6,2121,365,0.8181818181818182,1756,0.8531777956556718
2008,1463,12,15,915,911,0.4444444444444444,4,0.5010952902519168
2008,1464,7,21,491,1281,0.25,-790,0.2770880361173815
2008,3102,8,19,517,965,0.2962962962962963,-448,0.34885290148448045
2008,3103,7,24,519,1408,0.22580645161290322,-889,0.269330565646082
2008,3104,8,22,499,1147,0.26666666666666666,-648,0.3031591737545565
2008,3105,14,14,932,801,0.5,131,0.5377957299480669
2008,3106,11,18,701,1024,0.3793103448275862,-323,0.4063768115942029
2008,3107,13,18,919,1001,0.41935483870967744,-82,0.4786458333333333
2008,3108,12,18,759,921,0.4,-162,0.4517857142857143
2008,3110,18,13,1184,688,0.5806451612903226,496,0.6324786324786325
2008,3111,7,22,502,1294,0.2413793103448276,-792,0.2795100222717149
2008,3112,10,20,684,1173,0.3333333333333333,-489,0.3683360258481422
2008,3113,21,10,1440,591,0.6774193548387096,849,0.7090103397341211
2008,3114,22,8,1407,388,0.7333333333333333,1019,0.7838440111420613
2008,3115,12,19,838,1108,0.3870967741935484,-270,0.4306269270298047
2008,3116,17,13,1221,747,0.5666666666666667,474,0.6204268292682927
2008,3117,20,12,1347,669,0.625,678,0.6681547619047619
2008,3119,17,12,1077,595,0.5862068965517241,482,0.6441387559808612
2008,3120,20,11,1503,652,0.6451612903225806,851,0.6974477958236659
2008,3122,6,23,396,1268,0.20689655172413793,-872,0.23798076923076922
2008,3123,15,15,1128,889,0.5,239,0.5592464055528011
2008,3124,24,6,1806,363,0.8,1443,0.8326417704011065
2008,3125,13,16,863,902,0.4482758620689655,-39,0.4889518413597734
2008,3126,4,23,267,1165,0.14814814814814814,-898,0.18645251396648044
2008,3127,11,19,762,1071,0.36666666666666664,-309,0.4157119476268412
2008,3129,23,7,1748,449,0.7666666666666667,1299,0.7956304050978608
2008,3130,20,11,1343,634,0.6451612903225806,709,0.6793120890237734
2008,3131,20,12,1508,712,0.625,796,0.6792792792792792
2008,3132,25,7,1867,454,0.78125,1413,0.8043946574752262
2008,3133,12,18,861,1040,0.4,-179,0.4529195160441873
2008,3135,2,26,137,1185,0.07142857142857142,-1048,0.10363086232980333
2008,3137,16,15,1035,827,0.5161290322580645,208,0.5558539205155747
2008,3138,15,15,989,875,0.5,114,0.5305793991416309
2008,3139,19,10,1282,607,0.6551724137931034,675,0.6786659608258337
2008,3140,13,16,777,781,0.4482758620689655,-4,0.4987163029525032
2008,3141,6,23,457,1466,0.20689655172413793,-1009,0.2376495059802392
2008,3142,13,19,934,1203,0.40625,-269,0.43706130088909684
2008,3143,26,6,1747,318,0.8125,1429,0.8460048426150121
2008,3144,12,18,799,963,0.4,-164,0.4534619750283768
2008,3145,13,18,848,1021,0.41935483870967744,-173,0.4537185660781166
2008,3146,6,21,442,1246,0.2222222222222222,-804,0.2618483412322275
2008,3147,3,25,194,1366,0.10714285714285714,-1172,0.12435897435897436
2008,3148,4,25,257,1341,0.13793103448275862,-1084,0.16082603254067585
2008,3149,6,22,442,1176,0.21428571428571427,-734,0.273176761433869
2008,3150,18,13,1240,794,0.5806451612903226,446,0.6096361848574238
2008,3151,29,3,2066,172,0.90625,1894,0.9231456657730116
2008,3152,14,11,959,583,0.56,376,0.6219195849546044
2008,3153,12,16,924,818,0.42857142857142855,106,0.5304247990815155
2008,3155,12,19,865,1054,0.3870967741935484,-189,0.4507556018759771
2008,3156,19,12,1354,713,0.6129032258064516,641,0.6550556361877117
2008,3157,12,12,702,618,0.5,84,0.5318181818181819
2008,3158,14,16,914,804,0.4666666666666667,110,0.5320139697322468
2008,3159,1,29,58,1283,0.03333333333333333,-1225,0.04325130499627144
2008,3160,16,14,1110,859,0.5333333333333333,251,0.563737938039614
2008,3161,4,28,271,1458,0.125,-1187,0.156737998843262
2008,3162,10,18,682,1000,0.35714285714285715,-318,0.4054696789536266
2008,3163,32,1,2620,71,0.9696969696969697,2549,0.9736157562244518
2008,3164,21,11,1531,641,0.65625,890,0.7048802946593001
2008,3165,20,8,1413,429,0.7142857142857143,984,0.7671009771986971
2008,3166,20,11,1443,637,0.6451612903225806,806,0.69375
2008,3167,11,16,874,1057,0.4074074074074074,-183,0.45261522527187986
2008,3168,11,19,780,1111,0.36666666666666664,-331,0.41248016922263353
2008,3169,1,26,73,1446,0.037037037037037035,-1373,0.04805793285055958
2008,3170,6,22,427,1272,0.21428571428571427,-845,0.2513243084167157
2008,3171,15,15,905,729,0.5,176,0.5538555691554468
2008,3172,19,11,1306,643,0.6333333333333333,663,0.6700872242175474
2008,3173,25,8,1697,490,0.7575757575757576,1207,0.7759487882944673
2008,3174,7,24,409,1160,0.22580645161290322,-751,0.2606755895474825
2008,3175,17,14,1044,736,0.5483870967741935,308,0.5865168539325842
2008,3176,11,19,789,986,0.36666666666666664,-197,0.4445070422535211
2008,3177,20,11,1697,733,0.6451612903225806,964,0.6983539094650206
2008,3178,6,24,357,1265,0.2,-908,0.22009864364981505
2008,3179,22,10,1559,616,0.6875,943,0.7167816091954023
2008,3180,18,12,1150,645,0.6,505,0.6406685236768802
2008,3181,22,9,1611,590,0.7096774193548387,1021,0.7319400272603362
2008,3182,14,15,992,952,0.4827586206896552,40,0.5102880658436214
2008,3183,18,13,1258,785,0.5806451612903226,473,0.6157611355849242
2008,3184,13,14,1008,916,0.48148148148148145,92,0.5239085239085239
2008,3185,16,12,1086,699,0.5714285714285714,387,0.6084033613445378
2008,3186,2,25,134,1551,0.07407407407407407,-1417,0.07952522255192879
2008,3187,13,17,982,1034,0.43333333333333335,-52,0.4871031746031746
2008,3189,10,20,661,1119,0.3333333333333333,-458,0.37134831460674156
2008,3190,21,11,1677,728,0.65625,949,0.6972972972972973
2008,3191,20,11,1471,705,0.6451612903225806,766,0.6760110294117647
2008,3192,13,17,832,895,0.43333333333333335,-63,0.48176027793862186
2008,3193,22,9,1413,502,0.7096774193548387,911,0.7378590078328982
2008,3194,5,22,353,1225,0.18518518518518517,-872,0.22370088719898606
2008,3195,21,8,1475,430,0.7241379310344828,1045,0.7742782152230971
2008,3196,18,13,1311,831,0.5806451612903226,480,0.6120448179271709
2008,3197,12,17,799,970,0.41379310344827586,-171,0.45166760881854157
2008,3198,12,18,772,1020,0.4,-248,0.43080357142857145
2008,3199,18,13,1285,866,0.5806451612903226,419,0.597396559739656
2008,3201,22,10,1685,626,0.6875,1059,0.7291215923842492
2008,3202,9,20,641,1102,0.3103448275862069,-461,0.36775674125071717
2008,3203,25,6,1784,343,0.8064516129032258,1441,0.8387400094029149
2008,3204,17,13,1123,718,0.5666666666666667,405,0.6099945681694731
2008,3205,12,18,862,1079,0.4,-217,0.4441009788768676
2008,3206,9,21,541,1103,0.3,-562,0.3290754257907543
2008,3207,15,14,1047,757,0.5172413793103449,290,0.5803769401330376
2008,3208,22,9,1658,491,0.7096774193548387,1167,0.7715216379711494
2008,3209,8,22,519,1206,0.26666666666666666,-687,0.3008695652173913
2008,3210,22,9,1602,594,0.7096774193548387,1008,0.7295081967213115
2008,3211,24,8,1946,530,0.75,1416,0.7859450726978998
2008,3212,1,24,89,1296,0.04,-1207,0.06425992779783393
2008,3214,18,13,1224,749,0.5806451612903226,475,0.6203750633552965
2008,3216,27,5,1811,282,0.84375,1529,0.8652651696129957
2008,3217,18,11,1231,660,0.6206896551724138,571,0.6509783183500794
2008,3218,12,18,866,1057,0.4,-191,0.4503380135205408
2008,3219,12,15,849,875,0.4444444444444444,-26,0.49245939675174016
2008,3220,5,25,302,1370,0.16666666666666666,-1068,0.180622009569378
2008,3221,19,13,1207,661,0.59375,546,0.6461456102783726
2008,3222,15,16,1092,1005,0.4838709677419355,87,0.5207439198855508
2008,3224,4,26,336,1599,0.13333333333333333,-1263,0.17364341085271318
2008,3225,4,25,256,1311,0.13793103448275862,-1055,0.1633694958519464
2008,3226,18,9,1440,575,0.6666666666666666,865,0.7146401985111662
2008,3227,10,20,665,1104,0.3333333333333333,-439,0.3759185980780102
2008,3228,19,14,1290,775,0.5757575757575758,515,0.6246973365617433
2008,3229,26,6,2056,420,0.8125,1636,0.8303715670436187
2008,3231,18,14,1327,815,0.5625,512,0.619514472455649
2008,3232,14,15,1023,961,0.4827586206896552,62,0.515625
2008,3233,19,13,1484,787,0.59375,697,0.6534566270365477
2008,3234,21,10,1481,560,0.6774193548387096,921,0.72562469377756
2008,3235,20,12,1352,645,0.625,707,0.6770155232849274
2008,3236,11,18,811,1132,0.3793103448275862,-321,0.41739577972207925
2008,3237,17,16,1092,818,0.5151515151515151,274,0.5717277486910994
2008,3238,18,13,1147,685,0.5806451612903226,462,0.6260917030567685
2008,3239,23,9,1582,585,0.71875,997,0.730041532071989
2008,3240,11,19,779,1194,0.36666666666666664,-415,0.39483020780537254
2008,3241,22,9,1655,552,0.7096774193548387,1103,0.7498867240598097
2008,3242,16,15,1102,765,0.5161290322580645,337,0.5902517407605785
2008,3243,21,9,1496,531,0.7,965,0.7380365071534287
2008,3244,16,12,1121,710,0.5714285714285714,411,0.6122337520480612
2008,3245,9,21,636,1258,0.3,-622,0.3357972544878564
2008,3246,15,15,957,851,0.5,106,0.5293141592920354
2008,3247,12,17,782,898,0.41379310344827586,-116,0.4654761904761905
2008,3248,14,16,894,843,0.4666666666666667,51,0.5146804835924007
2008,3249,16,13,1047,746,0.5517241379310345,301,0.5839375348577802
2008,3250,18,13,1059,658,0.5806451612903226,401,0.6167734420500873
2008,3251,26,3,1878,187,0.896551724137931,1691,0.9094430992736078
2008,3252,9,22,608,1179,0.2903225806451613,-571,0.34023503077783995
2008,3253,9,20,593,1127,0.3103448275862069,-534,0.3447674418604651
2008,3254,24,8,1481,489,0.75,992,0.7517766497461928
2008,3255,16,13,1050,700,0.5517241379310345,350,0.6
2008,3256,16,15,1220,900,0.5161290322580645,320,0.5754716981132075
2008,3257,24,9,1865,595,0.7272727272727273,1270,0.758130081300813
2008,3258,15,15,1097,845,0.5,252,0.5648815653964985
2008,3259,13,17,797,950,0.43333333333333335,-153,0.45621064682312534
2008,3260,7,23,499,1321,0.23333333333333334,-822,0.2741758241758242
2008,3261,27,5,1973,285,0.84375,1688,0.8737821080602303
2008,3263,7,23,446,1275,0.23333333333333334,-829,0.25915165601394535
2008,3264,15,15,1056,876,0.5,180,0.546583850931677
2008,3265,31,2,2288,89,0.9393939393939394,2199,0.9625578460244005
2008,3266,16,14,1179,898,0.5333333333333333,281,0.5676456427539721
2008,3267,17,16,1314,930,0.5151515151515151,384,0.5855614973262032
2008,3268,30,3,2503,209,0.9090909090909091,2294,0.9229351032448377
2008,3269,13,17,914,972,0.43333333333333335,-58,0.48462354188759277
2008,3270,10,21,699,1139,0.3225806451612903,-440,0.38030467899891185
2008,3271,16,13,1212,748,0.5517241379310345,464,0.6183673469387755
2008,3272,10,20,725,1269,0.3333333333333333,-544,0.36359077231695086
2008,3273,4,26,268,1470,0.13333333333333333,-1202,0.15420023014959724
2008,3274,9,21,619,1191,0.3,-572,0.3419889502762431
2008,3275,23,10,1690,669,0.696969696969697,1021,0.7164052564646036
2008,3276,17,13,1112,677,0.5666666666666667,435,0.62157629960872
2008,3277,19,13,1264,755,0.59375,509,0.6260525012382367
2008,3278,20,11,1419,671,0.6451612903225806,748,0.6789473684210526
2008,3279,13,16,938,936,0.4482758620689655,2,0.5005336179295624
2008,3280,16,14,1246,744,0.5333333333333333,502,0.6261306532663317
2008,3281,10,21,685,1125,0.3225806451612903,-440,0.3784530386740331
2008,3282,10,20,707,1139,0.3333333333333333,-432,0.3829902491874323
2008,3283,11,19,846,1155,0.36666666666666664,-309,0.42278860569715143
2008,3284,11,20,813,1132,0.3548387096774194,-319,0.41799485861182517
2008,3285,23,6,1781,415,0.7931034482758621,1366,0.8110200364298725
2008,3286,17,12,1344,772,0.5862068965517241,572,0.6351606805293005
2008,3287,10,19,642,1053,0.3448275862068966,-411,0.3787610619469027
2008,3288,18,12,1218,734,0.6,484,0.6239754098360656
2008,3290,10,16,635,858,0.38461538461538464,-223,0.4253181513730743
2008,3291,8,22,548,1189,0.26666666666666666,-641,0.3154864709268854
2008,3292,21,11,1620,700,0.65625,920,0.6982758620689655
2008,3293,23,7,1736,476,0.7666666666666667,1260,0.7848101265822784
2008,3294,14,16,983,957,0.4666666666666667,26,0.506701030927835
2008,3295,16,11,1214,690,0.5925925925925926,524,0.6376050420168067
2008,3296,10,18,725,1029,0.35714285714285715,-304,0.41334093500570124
2008,3298,7,23,436,1134,0.23333333333333334,-698,0.27770700636942675
2008,3299,25,7,1957,448,0.78125,1509,0.8137214137214137
2008,3301,18,12,1248,741,0.6,507,0.6274509803921569
2008,3304,20,11,1472,710,0.6451612903225806,762,0.6746104491292392
2008,3305,18,12,1320,726,0.6,594,0.6451612903225806
2008,3306,7,22,494,1201,0.2413793103448276,-707,0.2914454277286136
2008,3307,20,12,1419,589,0.625,830,0.7066733067729084
2008,3308,23,9,1590,579,0.71875,1011,0.7330567081604425
2008,3309,13,17,879,903,0.43333333333333335,-24,0.49326599326599324
2008,3310,8,22,564,1275,0.26666666666666666,-711,0.3066884176182708
2008,3311,5,21,383,1171,0.19230769230769232,-788,0.24646074646074645
2008,3312,10,19,695,1066,0.3448275862068966,-371,0.39466212379329924
2008,3313,3,22,225,1263,0.12,-1038,0.15120967741935484
2008,3314,29,2,2555,150,0.9354838709677419,2405,0.944547134935305
2008,3316,13,16,727,749,0.4482758620689655,-22,0.49254742547425473
2008,3317,12,18,851,1083,0.4,-232,0.4400206825232678
2008,3318,14,16,981,910,0.4666666666666667,71,0.5187731359069275
2008,3319,10,20,736,1168,0.3333333333333333,-432,0.3865546218487395
2008,3320,13,18,856,1009,0.41935483870967744,-153,0.45898123324396783
2008,3321,5,26,326,1311,0.16129032258064516,-985,0.19914477703115455
2008,3322,12,14,909,805,0.46153846153846156,104,0.530338389731622
2008,3323,23,8,1902,471,0.7419354838709677,1431,0.8015170670037927
2008,3324,18,10,1327,633,0.6428571428571429,694,0.6770408163265306
2008,3325,20,13,1513,818,0.6060606060606061,695,0.6490776490776491
2008,3326,22,8,1667,484,0.7333333333333333,1183,0.7749883774988378
2008,3328,21,8,1614,501,0.7241379310344828,1113,0.7631205673758865
2008,3329,25,7,2002,433,0.78125,1569,0.82217659137577
2008,3330,29,4,2257,218,0.8787878787878788,2039,0.9119191919191919
2008,3331,18,13,1320,752,0.5806451612903226,568,0.637065637065637
2008,3332,14,17,913,901,0.45161290322580644,12,0.5033076074972437
2008,3333,11,19,749,1042,0.36666666666666664,-293,0.41820212171970966
2008,3334,13,15,962,965,0.4642857142857143,-3,0.49922158796056043
2008,3335,7,22,482,1147,0.2413793103448276,-665,0.29588704726826276
2008,3336,13,18,924,1040,0.41935483870967744,-116,0.47046843177189407
2008,3337,10,18,746,1147,0.35714285714285715,-401,0.3940834653988378
2008,3338,22,10,1677,605,0.6875,1072,0.7348816827344434
2008,3339,15,15,1163,923,0.5,240,0.5575263662511984
2008,3340,22,9,1685,654,0.7096774193548387,1031,0.7203933304831125
2008,3341,21,11,1484,639,0.65625,845,0.6990108337258596
2008,3342,1,23,63,1191,0.041666666666666664,-1128,0.050239234449760764
2008,3343,7,23,450,1360,0.23333333333333334,-910,0.24861878453038674
2008,3344,12,17,814,907,0.41379310344827586,-93,0.47298082510168504
2008,3345,18,14,1143,747,0.5625,396,0.6047619047619047
2008,3346,25,5,1753,326,0.8333333333333334,1427,0.8431938431938432
2008,3347,22,11,1519,671,0.6666666666666666,848,0.693607305936073
2008,3348,13,18,838,935,0.41935483870967744,-97,0.47264523406655384
2008,3349,14,18,947,1032,0.4375,-85,0.4785245073269328
2008,3350,14,17,951,978,0.45161290322580644,-27,0.49300155520995337
2008,3351,8,22,512,1260,0.26666666666666666,-748,0.28893905191873587
2008,3352,23,9,1775,591,0.71875,1184,0.7502113271344041
2008,3353,24,6,1495,316,0.8,1179,0.8255107675317505
2008,3354,13,17,958,927,0.43333333333333335,31,0.5082228116710875
2008,3355,22,6,1656,360,0.7857142857142857,1296,0.8214285714285714
2008,3356,9,20,684,1261,0.3103448275862069,-577,0.35167095115681235
2008,3357,19,11,1288,595,0.6333333333333333,693,0.6840148698884758
2008,3358,1,28,72,1563,0.034482758620689655,-1491,0.044036697247706424
2008,3359,23,9,1547,494,0.71875,1053,0.7579617834394905
2008,3360,19,12,1356,771,0.6129032258064516,585,0.6375176304654443
2008,3361,18,13,1309,706,0.5806451612903226,603,0.6496277915632754
2008,3362,14,16,1107,942,0.4666666666666667,165,0.5402635431918009
2008,3363,3,28,182,1667,0.0967741935483871,-1485,0.09843158464034614
2008,3364,23,7,1682,403,0.7666666666666667,1279,0.8067146282973621
2008,3365,20,10,1447,647,0.6666666666666666,800,0.6910219675262655
2008,3366,10,15,642,731,0.4,-89,0.4675892206846322
2008,3367,4,24,274,1263,0.14285714285714285,-989,0.1782693558880937
2008,3368,10,17,718,968,0.37037037037037035,-250,0.4258600237247924
2008,3369,21,8,1400,395,0.7241379310344828,1005,0.7799442896935933
2008,3371,13,15,853,844,0.4642857142857143,9,0.502651738361815
2008,3372,12,17,863,990,0.41379310344827586,-127,0.4657312466270912
2008,3373,11,18,771,1086,0.3793103448275862,-315,0.41518578352180935
2008,3374,24,8,1843,512,0.75,1331,0.7825902335456476
2008,3375,19,11,1183,592,0.6333333333333333,591,0.6664788732394367
2008,3376,15,15,1115,814,0.5,301,0.5780196993260757
2008,3378,16,15,1216,819,0.5161290322580645,397,0.5975429975429976
2008,3379,18,13,1399,847,0.5806451612903226,552,0.6228851291184327
2008,3380,12,16,689,872,0.42857142857142855,-183,0.44138372837924406
2008,3381,5,24,289,1164,0.1724137931034483,-875,0.1988988300068823
2008,3382,18,12,1183,639,0.6,544,0.6492864983534578
2008,3383,10,20,616,1036,0.3333333333333333,-420,0.3728813559322034
2008,3384,6,23,400,1196,0.20689655172413793,-796,0.2506265664160401
2008,3385,16,14,1156,817,0.5333333333333333,339,0.58590978205778
2008,3386,17,14,1140,771,0.5483870967741935,369,0.5965463108320251
2008,3387,10,20,723,1245,0.3333333333333333,-522,0.3673780487804878
2008,3388,15,17,1132,1099,0.46875,33,0.5073957866427611
2008,3389,19,12,1253,721,0.6129032258064516,532,0.6347517730496454
2008,3390,30,3,2273,182,0.9090909090909091,2091,0.9258655804480652
2008,3391,9,21,591,1044,0.3,-453,0.3614678899082569
2008,3392,8,23,524,1228,0.25806451612903225,-704,0.2990867579908676
2008,3393,22,8,1632,518,0.7333333333333333,1114,0.7590697674418605
2008,3394,12,20,839,1015,0.375,-176,0.4525350593311758
2008,3395,21,11,1573,661,0.65625,912,0.7041181736794987
2008,3396,21,12,1382,592,0.6363636363636364,790,0.7001013171225937
2008,3397,30,2,2375,131,0.9375,2244,0.9477254588986432
2008,3398,12,17,885,1013,0.41379310344827586,-128,0.46628029504741836
2008,3399,8,22,555,1270,0.26666666666666666,-715,0.3041095890410959
2008,3400,21,12,1573,742,0.6363636363636364,831,0.6794816414686825
2008,3401,26,7,1763,395,0.7878787878787878,1368,0.8169601482854495
2008,3402,16,10,1263,676,0.6153846153846154,587,0.6513666838576586
2008,3403,16,15,1233,818,0.5161290322580645,415,0.6011701608971234
2008,3404,5,25,354,1264,0.16666666666666666,-910,0.21878862793572312
2008,3405,14,16,970,880,0.4666666666666667,90,0.5243243243243243
2008,3406,21,10,1302,596,0.6774193548387096,706,0.6859852476290832
2008,3407,12,18,801,985,0.4,-184,0.448488241881299
2008,3408,16,14,1114,848,0.5333333333333333,266,0.5677879714576962
2008,3409,11,20,788,1020,0.3548387096774194,-232,0.4358407079646018
2008,3410,9,18,603,905,0.3333333333333333,-302,0.39986737400530503
2008,3411,7,20,456,964,0.25925925925925924,-508,0.3211267605633803
2008,3412,14,16,1011,1036,0.4666666666666667,-25,0.49389350268685883
2008,3413,19,11,1323,648,0.6333333333333333,675,0.6712328767123288
2008,3414,7,24,508,1495,0.22580645161290322,-987,0.25361957064403395
2008,3415,14,16,954,904,0.4666666666666667,50,0.5134553283100107
2008,3416,10,20,735,1322,0.3333333333333333,-587,0.3573164803111327
2008,3417,16,15,1177,906,0.5161290322580645,271,0.5650504080652905
2008,3418,6,22,408,1246,0.21428571428571427,-838,0.24667472793228537
2008,3419,17,13,1137,768,0.5666666666666667,369,0.5968503937007874
2008,3420,9,21,573,1193,0.3,-620,0.3244620611551529
2008,3421,11,18,788,1064,0.3793103448275862,-276,0.42548596112311016
2008,3422,6,24,380,1199,0.2,-819,0.24065864471184295
2008,3423,17,14,1174,754,0.5483870967741935,420,0.6089211618257261
2008,3424,8,22,540,1247,0.26666666666666666,-707,0.302182428651371
2008,3425,17,13,1138,741,0.5666666666666667,397,0.6056412985630655
2008,3426,18,10,1324,589,0.6428571428571429,735,0.6921066387872452
2008,3427,22,9,1590,542,0.7096774193548387,1048,0.7457786116322702
2008,3428,27,4,1900,240,0.8709677419354839,1660,0.8878504672897196
2008,3429,9,20,562,1131,0.3103448275862069,-569,0.33195510927347904
2008,3430,14,12,1191,793,0.5384615384615384,398,0.6003024193548387
2008,3431,27,3,1951,189,0.9,1762,0.9116822429906543
2008,3433,25,7,1696,394,0.78125,1302,0.8114832535885167
2008,3434,13,16,943,970,0.4482758620689655,-27,0.4929430214323053
2008,3435,23,8,1734,477,0.7419354838709677,1257,0.7842605156037992
2008,3436,23,8,1561,515,0.7419354838709677,1046,0.7519267822736031
2008,3437,15,15,1020,822,0.5,198,0.5537459283387622
2008,3438,23,9,1780,589,0.71875,1191,0.7513718868720979
2008,3439,15,15,1158,848,0.5,310,0.5772681954137587
2008,3441,25,8,1921,528,0.7575757575757576,1393,0.7844017966516945
2008,3442,12,16,768,878,0.42857142857142855,-110,0.4665856622114216
2008,3443,26,7,2013,420,0.7878787878787878,1593,0.8273736128236745
2008,3444,13,19,967,1281,0.40625,-314,0.43016014234875444
2008,3445,3,23,183,985,0.11538461538461539,-802,0.1566780821917808
2008,3447,7,22,480,1104,0.2413793103448276,-624,0.30303030303030304
2008,3448,15,15,947,747,0.5,200,0.5590318772136954
2008,3449,13,18,910,1061,0.41935483870967744,-151,0.46169457128361235
2008,3450,5,25,338,1215,0.16666666666666666,-877,0.21764327108821635
2008,3451,11,16,746,899,0.4074074074074074,-153,0.4534954407294833
2008,3452,24,7,1749,429,0.7741935483870968,1320,0.803030303030303
2008,3453,26,5,1952,330,0.8387096774193549,1622,0.8553900087642419
2008,3454,16,14,1163,843,0.5333333333333333,320,0.5797607178464607
2008,3455,9,22,572,1127,0.2903225806451613,-555,0.3366686286050618
2008,3456,14,18,989,992,0.4375,-3,0.49924280666330134
2008,3457,18,12,1216,625,0.6,591,0.6605105920695274
2008,3458,16,13,1210,850,0.5517241379310345,360,0.587378640776699
2008,3459,9,21,594,1210,0.3,-616,0.32926829268292684
2008,3460,16,16,1027,882,0.5,145,0.5379779989523311
2008,3461,22,6,1451,322,0.7857142857142857,1129,0.8183869148336154
2008,3462,24,8,1614,434,0.75,1180,0.7880859375
2008,3463,9,18,641,1076,0.3333333333333333,-435,0.37332556785090276
2008,3464,14,17,941,1041,0.45161290322580644,-100,0.4747729566094854
2009,1102,8,21,553,1112,0.27586206896551724,-559,0.3321321321321321
2009,1103,22,12,1534,724,0.6470588235294118,810,0.6793622674933569
2009,1104,16,14,1216,969,0.5333333333333333,247,0.5565217391304348
2009,1105,7,17,504,1032,0.2916666666666667,-528,0.328125
2009,1106,20,9,1423,592,0.6896551724137931,831,0.7062034739454094
2009,1107,15,16,1033,951,0.4838709677419355,82,0.5206653225806451
2009,1108,4,24,338,1602,0.14285714285714285,-1264,0.17422680412371133
2009,1110,24,7,1607,391,0.7741935483870968,1216,0.8043043043043043
2009,1111,12,18,958,1286,0.4,-328,0.4269162210338681
2009,1112,19,13,1491,819,0.59375,672,0.6454545454545455
2009,1113,24,9,1725,570,0.7272727272727273,1155,0.7516339869281046
2009,1114,23,8,1626,433,0.7419354838709677,1193,0.7897037396794561
2009,1115,13,18,920,1023,0.41935483870967744,-103,0.4734945959855893
2009,1116,14,16,1180,1058,0.4666666666666667,122,0.5272564789991063
2009,1117,11,17,736,1064,0.39285714285714285,-328,0.4088888888888889
2009,1119,11,19,750,991,0.36666666666666664,-241,0.43078690407811604
2009,1120,21,11,1568,744,0.65625,824,0.6782006920415224
2009,1122,17,13,1346,889,0.5666666666666667,457,0.6022371364653244
2009,1123,14,17,837,958,0.45161290322580644,-121,0.46629526462395543
2009,1124,19,14,1516,970,0.5757575757575758,546,0.6098149637972646
2009,1125,19,12,1510,864,0.6129032258064516,646,0.6360572872788542
2009,1126,14,16,856,848,0.4666666666666667,8,0.5023474178403756
2009,1127,22,8,1571,526,0.7333333333333333,1045,0.7491654744873629
2009,1129,18,12,1373,780,0.6,593,0.6377148165350673
2009,1130,22,11,1739,734,0.6666666666666666,1005,0.7031945006065508
2009,1131,17,13,1256,802,0.5666666666666667,454,0.6103012633624878
2009,1132,17,13,1143,750,0.5666666666666667,393,0.6038034865293186
2009,1133,18,14,1270,867,0.5625,403,0.5942910622367805
2009,1135,9,19,616,1096,0.32142857142857145,-480,0.3598130841121495
2009,1136,8,21,531,1139,0.27586206896551724,-608,0.31796407185628744
2009,1137,7,23,506,1422,0.23333333333333334,-916,0.262448132780083
2009,1138,21,11,1416,666,0.65625,750,0.6801152737752162
2009,1139,25,5,1712,298,0.8333333333333334,1414,0.8517412935323383
2009,1140,24,7,1875,518,0.7741935483870968,1357,0.783535311324697
2009,1141,12,19,784,1144,0.3870967741935484,-360,0.4066390041493776
2009,1142,7,21,496,1326,0.25,-830,0.2722283205268935
2009,1143,22,10,1733,668,0.6875,1065,0.7217825905872554
2009,1144,12,16,911,1083,0.42857142857142855,-172,0.45687061183550653
2009,1145,11,20,790,1159,0.3548387096774194,-369,0.40533606977937403
2009,1146,6,19,411,1102,0.24,-691,0.271645736946464
2009,1147,8,23,571,1422,0.25806451612903225,-851,0.28650275965880584
2009,1148,13,17,926,1017,0.43333333333333335,-91,0.47658260422027793
2009,1149,6,20,396,1301,0.23076923076923078,-905,0.23335297583971715
2009,1150,11,20,817,1313,0.3548387096774194,-496,0.3835680751173709
2009,1151,16,16,1262,1138,0.5,124,0.5258333333333334
2009,1152,17,13,1511,974,0.5666666666666667,537,0.6080482897384306
2009,1153,18,14,1341,846,0.5625,495,0.6131687242798354
2009,1154,18,12,1258,730,0.6,528,0.6327967806841046
2009,1155,23,8,1856,592,0.7419354838709677,1264,0.7581699346405228
2009,1156,22,10,1489,590,0.6875,899,0.7162097162097162
2009,1157,8,19,595,1228,0.2962962962962963,-633,0.3263850795392211
2009,1158,26,8,2095,521,0.7647058823529411,1574,0.8008409785932722
2009,1159,10,20,625,1076,0.3333333333333333,-451,0.36743092298647856
2009,1160,8,22,566,1320,0.26666666666666666,-754,0.30010604453870626
2009,1161,9,21,684,1382,0.3,-698,0.33107454017424975
2009,1162,12,16,800,889,0.42857142857142855,-89,0.47365304914150386
2009,1163,27,4,2089,308,0.8709677419354839,1781,0.871506049228202
2009,1164,12,19,803,1146,0.3870967741935484,-343,0.4120061570035916
2009,1165,20,9,1565,558,0.6896551724137931,1007,0.7371643900141309
2009,1166,26,7,2006,423,0.7878787878787878,1583,0.8258542610127625
2009,1167,8,21,534,1341,0.27586206896551724,-807,0.2848
2009,1168,14,17,1109,1130,0.45161290322580644,-21,0.4953104064314426
2009,1169,16,13,1259,880,0.5517241379310345,379,0.5885928003740065
2009,1170,2,27,154,1498,0.06896551724137931,-1344,0.09322033898305085
2009,1171,8,19,528,1126,0.2962962962962963,-598,0.3192261185006046
2009,1172,25,7,2040,439,0.78125,1601,0.8229124647035094
2009,1173,26,7,1776,452,0.7878787878787878,1324,0.7971274685816876
2009,1174,13,19,978,1196,0.40625,-218,0.44986200551977923
2009,1175,7,23,483,1229,0.23333333333333334,-746,0.2821261682242991
2009,1176,15,16,953,931,0.4838709677419355,22,0.5058386411889597
2009,1177,9,24,657,1466,0.2727272727272727,-809,0.3094677343382007
2009,1178,6,23,383,1253,0.20689655172413793,-870,0.2341075794621027
2009,1179,16,15,1124,862,0.5161290322580645,262,0.5659617321248741
2009,1180,15,14,1002,786,0.5172413793103449,216,0.5604026845637584
2009,1181,28,6,2233,420,0.8235294117647058,1813,0.841688654353562
2009,1182,21,12,1752,823,0.6363636363636364,929,0.6803883495145631
2009,1183,10,18,687,1087,0.35714285714285715,-400,0.38726042841037206
2009,1184,16,12,1209,781,0.5714285714285714,428,0.607537688442211
2009,1185,6,24,394,1254,0.2,-860,0.23907766990291263
2009,1186,11,18,757,1058,0.3793103448275862,-301,0.41707988980716254
2009,1187,10,17,849,1093,0.37037037037037035,-244,0.437178166838311
2009,1188,4,19,303,1186,0.17391304347826086,-883,0.20349227669576897
2009,1189,9,20,620,1257,0.3103448275862069,-637,0.3303143313798615
2009,1190,22,10,1807,692,0.6875,1115,0.7230892356942777
2009,1191,16,13,1108,822,0.5517241379310345,286,0.5740932642487047
2009,1192,7,23,486,1423,0.23333333333333334,-937,0.25458355159769513
2009,1193,17,15,1165,928,0.53125,237,0.5566172957477306
2009,1194,6,26,416,1663,0.1875,-1247,0.2000962000962001
2009,1195,10,20,684,1271,0.3333333333333333,-587,0.34987212276214835
2009,1196,23,10,1854,700,0.696969696969697,1154,0.725920125293657
2009,1197,10,21,703,1196,0.3225806451612903,-493,0.3701948393891522
2009,1198,12,19,830,1120,0.3870967741935484,-290,0.4256410256410256
2009,1199,25,9,1742,591,0.7352941176470589,1151,0.7466780968709815
2009,1200,3,25,206,1512,0.10714285714285714,-1306,0.119906868451688
2009,1201,13,21,953,1346,0.38235294117647056,-393,0.414528055676381
2009,1202,4,24,264,1431,0.14285714285714285,-1167,0.15575221238938053
2009,1203,10,18,739,1114,0.35714285714285715,-375,0.3988127361036158
2009,1204,7,22,490,1528,0.2413793103448276,-1038,0.24281466798810702
2009,1205,10,17,794,1181,0.37037037037037035,-387,0.4020253164556962
2009,1206,22,10,1508,608,0.6875,900,0.7126654064272212
2009,1207,16,14,1152,924,0.5333333333333333,228,0.5549132947976878
2009,1208,12,20,890,1187,0.375,-297,0.4285026480500722
2009,1209,10,20,651,1129,0.3333333333333333,-478,0.3657303370786517
2009,1210,12,19,930,1278,0.3870967741935484,-348,0.421195652173913
2009,1211,25,5,2032,332,0.8333333333333334,1700,0.8595600676818951
2009,1212,5,23,371,1297,0.17857142857142858,-926,0.2224220623501199
2009,1214,15,16,876,906,0.4838709677419355,-30,0.49158249158249157
2009,1216,7,26,502,1496,0.21212121212121213,-994,0.25125125125125125
2009,1217,13,14,918,878,0.48148148148148145,40,0.5111358574610245
2009,1218,13,17,904,1017,0.43333333333333335,-113,0.47058823529411764
2009,1219,6,21,384,1284,0.2222222222222222,-900,0.2302158273381295
2009,1220,20,11,1406,654,0.6451612903225806,752,0.6825242718446602
2009,1221,18,14,1236,831,0.5625,405,0.5979680696661829
2009,1222,21,11,1712,744,0.65625,968,0.6970684039087948
2009,1223,4,25,275,1699,0.13793103448275862,-1424,0.1393110435663627
2009,1224,8,23,553,1347,0.25806451612903225,-794,0.2910526315789474
2009,1225,15,15,1078,879,0.5,199,0.5508431272355646
2009,1226,12,19,824,1190,0.3870967741935484,-366,0.40913604766633566
2009,1227,15,15,1092,915,0.5,177,0.5440956651718983
2009,1228,24,9,1633,499,0.7272727272727273,1134,0.7659474671669794
2009,1229,24,9,1777,558,0.7272727272727273,1219,0.7610278372591006
2009,1231,5,25,349,1432,0.16666666666666666,-1083,0.19595732734418866
2009,1232,10,21,726,1227,0.3225806451612903,-501,0.3717357910906298
2009,1233,12,19,843,1087,0.3870967741935484,-244,0.4367875647668394
2009,1234,15,17,1013,914,0.46875,99,0.5256875973015049
2009,1235,15,17,1061,1017,0.46875,44,0.5105871029836381
2009,1236,12,17,907,984,0.41379310344827586,-77,0.4796404019037546
2009,1237,13,14,904,819,0.48148148148148145,85,0.5246662797446314
2009,1238,18,15,1330,977,0.5454545454545454,353,0.576506285218899
2009,1239,18,13,1394,907,0.5806451612903226,487,0.6058235549760973
2009,1240,9,17,693,1102,0.34615384615384615,-409,0.3860724233983287
2009,1241,19,14,1432,908,0.5757575757575758,524,0.611965811965812
2009,1242,25,7,2009,459,0.78125,1550,0.8140194489465153
2009,1243,20,11,1617,722,0.6451612903225806,895,0.6913210773834972
2009,1244,6,22,408,1212,0.21428571428571427,-804,0.2518518518518518
2009,1245,18,14,1312,864,0.5625,448,0.6029411764705882
2009,1246,20,13,1565,902,0.6060606060606061,663,0.6343737332792866
2009,1247,18,13,1346,861,0.5806451612903226,485,0.6098776619845945
2009,1248,8,22,569,1390,0.26666666666666666,-821,0.29045431342521694
2009,1249,11,15,791,998,0.4230769230769231,-207,0.4421464505310229
2009,1250,15,14,1038,816,0.5172413793103449,222,0.5598705501618123
2009,1251,18,11,1396,745,0.6206896551724138,651,0.6520317608594115
2009,1252,16,14,1281,968,0.5333333333333333,313,0.5695864828812806
2009,1253,15,15,1140,998,0.5,142,0.5332086061739943
2009,1254,16,14,1206,913,0.5333333333333333,293,0.5691363850873054
2009,1255,13,14,1032,971,0.48148148148148145,61,0.5152271592611083
2009,1256,15,17,1088,943,0.46875,145,0.535696701132447
2009,1257,28,5,2159,281,0.8484848484848485,1878,0.8848360655737705
2009,1258,3,28,198,1528,0.0967741935483871,-1330,0.11471610660486674
2009,1259,12,20,877,1270,0.375,-393,0.40847694457382394
2009,1260,14,17,962,985,0.45161290322580644,-23,0.4940934771443246
2009,1261,26,7,2044,428,0.7878787878787878,1616,0.8268608414239482
2009,1263,8,21,544,1310,0.27586206896551724,-766,0.29341963322545844
2009,1264,16,14,1077,854,0.5333333333333333,223,0.5577421025375453
2009,1265,10,23,670,1441,0.30303030303030304,-771,0.3173851255329228
2009,1266,24,9,1950,652,0.7272727272727273,1298,0.749423520368947
2009,1267,12,17,901,1093,0.41379310344827586,-192,0.4518555667001003
2009,1268,20,13,1533,825,0.6060606060606061,708,0.6501272264631043
2009,1269,11,18,839,1217,0.3793103448275862,-378,0.4080739299610895
2009,1270,9,18,669,1012,0.3333333333333333,-343,0.39797739440809043
2009,1271,7,23,464,1293,0.23333333333333334,-829,0.2640865110984633
2009,1272,31,3,2325,193,0.9117647058823529,2132,0.9233518665607625
2009,1273,16,15,1290,1013,0.5161290322580645,277,0.5601389491966999
2009,1274,17,12,1269,822,0.5862068965517241,447,0.6068866571018652
2009,1275,17,13,1124,723,0.5666666666666667,401,0.6085544125609096
2009,1276,19,13,1414,725,0.59375,689,0.6610565684899485
2009,1277,26,6,1921,380,0.8125,1541,0.8348544111255976
2009,1278,21,10,1475,576,0.6774193548387096,899,0.7191613846903949
2009,1279,16,15,1246,1008,0.5161290322580645,238,0.5527950310559007
2009,1280,22,12,1695,822,0.6470588235294118,873,0.6734207389749702
2009,1281,28,6,2354,404,0.8235294117647058,1950,0.8535170413343002
2009,1282,7,24,480,1528,0.22580645161290322,-1048,0.23904382470119523
2009,1283,11,20,705,1182,0.3548387096774194,-477,0.37360890302066774
2009,1284,8,23,531,1394,0.25806451612903225,-863,0.27584415584415584
2009,1285,16,12,1132,698,0.5714285714285714,434,0.6185792349726776
2009,1286,13,17,945,1030,0.43333333333333335,-85,0.47848101265822784
2009,1287,17,15,1277,942,0.53125,335,0.5754844524560613
2009,1288,22,11,1577,632,0.6666666666666666,945,0.7138976912630149
2009,1290,7,25,521,1508,0.21875,-987,0.25677673730901923
2009,1291,19,13,1374,809,0.59375,565,0.6294090700870362
2009,1292,17,14,1267,893,0.5483870967741935,374,0.586574074074074
2009,1293,17,12,1225,734,0.5862068965517241,491,0.6253190403266973
2009,1294,13,18,1009,1182,0.41935483870967744,-173,0.46052031036056595
2009,1295,24,6,1916,458,0.8,1458,0.8070766638584668
2009,1296,9,20,705,1209,0.3103448275862069,-504,0.3683385579937304
2009,1298,19,11,1407,722,0.6333333333333333,685,0.6608736496007516
2009,1299,13,16,944,952,0.4482758620689655,-8,0.4978902953586498
2009,1300,3,26,222,1522,0.10344827586206896,-1300,0.12729357798165136
2009,1301,16,14,1237,952,0.5333333333333333,285,0.56509821836455
2009,1304,18,12,1231,697,0.6,534,0.6384854771784232
2009,1305,20,12,1476,752,0.625,724,0.6624775583482945
2009,1306,13,16,839,936,0.4482758620689655,-97,0.47267605633802817
2009,1307,21,11,1627,732,0.65625,895,0.6896990250105978
2009,1308,17,15,1376,1067,0.53125,309,0.5632419156774457
2009,1309,10,19,675,1111,0.3448275862068966,-436,0.37793952967525196
2009,1310,26,8,2043,560,0.7647058823529411,1483,0.7848636189012678
2009,1311,17,11,1144,622,0.6071428571428571,522,0.6477916194790487
2009,1312,1,30,61,1484,0.03225806451612903,-1423,0.039482200647249194
2009,1313,13,18,1006,1113,0.41935483870967744,-107,0.4747522416234073
2009,1314,27,4,2449,322,0.8709677419354839,2127,0.8837964633706243
2009,1315,5,10,350,626,0.3333333333333333,-276,0.35860655737704916
2009,1316,7,22,457,1170,0.2413793103448276,-713,0.28088506453595574
2009,1317,19,12,1549,836,0.6129032258064516,713,0.649475890985325
2009,1318,18,12,1181,690,0.6,491,0.6312132549438803
2009,1319,6,19,443,1177,0.24,-734,0.2734567901234568
2009,1320,23,10,1600,634,0.696969696969697,966,0.7162041181736795
2009,1321,17,13,1186,722,0.5666666666666667,464,0.6215932914046122
2009,1322,8,20,639,1285,0.2857142857142857,-646,0.3321205821205821
2009,1323,18,14,1484,967,0.5625,517,0.6054671562627499
2009,1324,21,12,1678,778,0.6363636363636364,900,0.6832247557003257
2009,1325,15,17,1084,991,0.46875,93,0.5224096385542168
2009,1326,22,10,1555,579,0.6875,976,0.7286785379568884
2009,1328,27,5,2166,368,0.84375,1798,0.8547750591949487
2009,1329,22,11,1852,825,0.6666666666666666,1027,0.691819200597684
2009,1330,21,10,1482,567,0.6774193548387096,915,0.7232796486090776
2009,1331,15,15,1105,1007,0.5,98,0.5232007575757576
2009,1332,8,23,629,1459,0.25806451612903225,-830,0.30124521072796934
2009,1333,12,17,790,924,0.41379310344827586,-134,0.46091015169194866
2009,1334,18,12,1248,740,0.6,508,0.6277665995975855
2009,1335,10,18,688,1147,0.35714285714285715,-459,0.3749318801089918
2009,1336,22,11,1521,657,0.6666666666666666,864,0.6983471074380165
2009,1337,7,23,460,1346,0.23333333333333334,-886,0.2547065337763012
2009,1338,27,4,2156,253,0.8709677419354839,1903,0.8949771689497716
2009,1339,19,12,1374,799,0.6129032258064516,575,0.6323055683387022
2009,1340,22,9,1653,632,0.7096774193548387,1021,0.7234135667396061
2009,1341,13,16,990,988,0.4482758620689655,2,0.5005055611729019
2009,1342,12,17,791,938,0.41379310344827586,-147,0.4574898785425101
2009,1343,12,14,761,736,0.46153846153846156,25,0.5083500334001336
2009,1344,19,13,1575,936,0.59375,639,0.6272401433691757
2009,1345,25,9,1775,583,0.7352941176470589,1192,0.7527565733672604
2009,1346,15,16,1054,1004,0.4838709677419355,50,0.5121477162293488
2009,1347,18,11,1425,744,0.6206896551724138,681,0.656984785615491
2009,1348,22,10,1832,724,0.6875,1108,0.7167449139280125
2009,1349,10,22,757,1283,0.3125,-526,0.37107843137254903
2009,1350,17,15,1230,989,0.53125,241,0.5543037404236142
2009,1351,19,12,1418,821,0.6129032258064516,597,0.633318445734703
2009,1352,24,10,1785,620,0.7058823529411765,1165,0.7422037422037422
2009,1353,11,21,725,1296,0.34375,-571,0.3587333003463632
2009,1354,13,14,910,909,0.48148148148148145,1,0.5002748763056625
2009,1355,11,20,813,1306,0.3548387096774194,-493,0.38367154318074564
2009,1356,12,18,819,1081,0.4,-262,0.43105263157894735
2009,1357,17,14,1357,920,0.5483870967741935,437,0.5959595959595959
2009,1358,14,12,1133,815,0.5384615384615384,318,0.5816221765913757
2009,1359,14,16,947,880,0.4666666666666667,67,0.518336070060208
2009,1360,14,16,942,870,0.4666666666666667,72,0.5198675496688742
2009,1361,22,9,1555,535,0.7096774193548387,1020,0.7440191387559809
2009,1362,9,19,668,1208,0.32142857142857145,-540,0.35607675906183367
2009,1363,11,17,764,1099,0.39285714285714285,-335,0.4100912506709608
2009,1364,15,15,1041,925,0.5,116,0.529501525940997
2009,1365,14,17,1004,1025,0.45161290322580644,-21,0.4948250369640217
2009,1366,11,14,688,704,0.44,-16,0.4942528735632184
2009,1367,9,21,638,1174,0.3,-536,0.35209713024282563
2009,1368,9,17,683,1057,0.34615384615384615,-374,0.39252873563218393
2009,1369,2,27,145,1801,0.06896551724137931,-1656,0.07451181911613566
2009,1370,13,8,933,494,0.6190476190476191,439,0.6538192011212334
2009,1371,16,15,1209,1075,0.5161290322580645,134,0.5293345008756567
2009,1372,20,7,1364,370,0.7407407407407407,994,0.7866205305651672
2009,1373,26,7,2038,525,0.7878787878787878,1513,0.7951619196254389
2009,1374,8,21,566,1279,0.27586206896551724,-713,0.30677506775067753
2009,1375,19,13,1397,816,0.59375,581,0.6312697695436059
2009,1376,21,9,1664,698,0.7,966,0.7044877222692634
2009,1377,5,7,481,469,0.4166666666666667,12,0.5063157894736842
2009,1378,9,22,592,1238,0.2903225806451613,-646,0.32349726775956283
2009,1379,12,17,871,1052,0.41379310344827586,-181,0.452938117524701
2009,1380,8,21,583,1243,0.27586206896551724,-660,0.3192771084337349
2009,1381,10,19,740,1127,0.3448275862068966,-387,0.3963577932512051
2009,1382,15,15,1115,988,0.5,127,0.5301949595815502
2009,1383,10,20,731,1239,0.3333333333333333,-508,0.3710659898477157
2009,1384,6,23,412,1359,0.20689655172413793,-947,0.2326369282891022
2009,1385,16,17,1160,1013,0.48484848484848486,147,0.53382420616659
2009,1386,17,15,1274,910,0.53125,364,0.5833333333333334
2009,1387,17,14,1147,782,0.5483870967741935,365,0.5946086054950752
2009,1388,24,6,1813,370,0.8,1443,0.8305084745762712
2009,1389,11,19,712,1068,0.36666666666666664,-356,0.4
2009,1390,18,13,1381,879,0.5806451612903226,502,0.6110619469026549
2009,1391,11,17,760,1090,0.39285714285714285,-330,0.41081081081081083
2009,1392,15,14,959,897,0.5172413793103449,62,0.5167025862068966
2009,1393,25,9,2113,640,0.7352941176470589,1473,0.7675263349073738
2009,1394,15,15,1144,857,0.5,287,0.5717141429285357
2009,1395,13,17,888,1010,0.43333333333333335,-122,0.4678609062170706
2009,1396,22,11,1568,708,0.6666666666666666,860,0.6889279437609842
2009,1397,21,12,1755,835,0.6363636363636364,920,0.6776061776061776
2009,1398,11,17,850,1141,0.39285714285714285,-291,0.42692114515318935
2009,1399,10,18,837,1209,0.35714285714285715,-372,0.4090909090909091
2009,1400,22,11,1651,736,0.6666666666666666,915,0.6916631755341432
2009,1401,23,9,1722,573,0.71875,1149,0.7503267973856209
2009,1402,10,16,811,1210,0.38461538461538464,-399,0.4012864918357249
2009,1403,13,19,1029,1367,0.40625,-338,0.42946577629382304
2009,1404,20,9,1636,587,0.6896551724137931,1049,0.7359424201529464
2009,1405,6,25,409,1407,0.1935483870967742,-998,0.22522026431718062
2009,1406,12,22,859,1354,0.35294117647058826,-495,0.38816086760054225
2009,1407,18,12,1452,877,0.6,575,0.6234435379991413
2009,1408,13,17,919,1011,0.43333333333333335,-92,0.4761658031088083
2009,1409,23,10,1646,569,0.696969696969697,1077,0.7431151241534989
2009,1410,6,17,406,1022,0.2608695652173913,-616,0.28431372549019607
2009,1411,7,25,549,1514,0.21875,-965,0.26611730489578284
2009,1412,22,11,1666,731,0.6666666666666666,935,0.6950354609929078
2009,1413,13,19,1016,1322,0.40625,-306,0.4345594525235244
2009,1414,12,19,857,1171,0.3870967741935484,-314,0.42258382642998027
2009,1415,16,13,1037,707,0.5517241379310345,330,0.5946100917431193
2009,1416,16,14,1235,877,0.5333333333333333,358,0.5847537878787878
2009,1417,25,8,1984,524,0.7575757575757576,1460,0.7910685805422647
2009,1418,9,20,671,1243,0.3103448275862069,-572,0.3505747126436782
2009,1419,9,20,646,1218,0.3103448275862069,-572,0.3465665236051502
2009,1420,14,17,995,1016,0.45161290322580644,-21,0.494778717056191
2009,1421,12,16,957,1054,0.42857142857142855,-97,0.47588264545002484
2009,1422,4,25,332,1466,0.13793103448275862,-1134,0.1846496106785317
2009,1423,7,25,628,1652,0.21875,-1024,0.2754385964912281
2009,1424,21,10,1512,628,0.6774193548387096,884,0.7065420560747664
2009,1425,21,12,1479,777,0.6363636363636364,702,0.6555851063829787
2009,1426,13,14,1079,1005,0.48148148148148145,74,0.5177543186180422
2009,1427,16,13,1172,918,0.5517241379310345,254,0.5607655502392345
2009,1428,24,8,1769,502,0.75,1267,0.7789520035226772
2009,1429,29,4,2152,254,0.8787878787878788,1898,0.8944305901911886
2009,1430,15,11,1143,667,0.5769230769230769,476,0.6314917127071823
2009,1431,19,12,1452,889,0.6129032258064516,563,0.6202477573686459
2009,1433,24,9,1715,661,0.7272727272727273,1054,0.7218013468013468
2009,1434,7,22,476,1259,0.2413793103448276,-783,0.2743515850144092
2009,1435,19,12,1432,753,0.6129032258064516,679,0.6553775743707094
2009,1436,23,8,1812,575,0.7419354838709677,1237,0.7591118558860495
2009,1437,26,7,2072,454,0.7878787878787878,1618,0.8202692003167062
2009,1438,10,18,806,1154,0.35714285714285715,-348,0.41122448979591836
2009,1439,18,14,1352,936,0.5625,416,0.5909090909090909
2009,1440,20,8,1848,677,0.7142857142857143,1171,0.7318811881188119
2009,1441,14,15,1066,997,0.4827586206896552,69,0.5167232186136694
2009,1442,8,20,496,1130,0.2857142857142857,-634,0.3050430504305043
2009,1443,23,8,1699,536,0.7419354838709677,1163,0.760178970917226
2009,1444,10,21,676,1242,0.3225806451612903,-566,0.3524504692387904
2009,1445,6,22,406,1182,0.21428571428571427,-776,0.25566750629722923
2009,1447,16,14,1187,834,0.5333333333333333,353,0.5873330034636318
2009,1448,24,6,2013,428,0.8,1585,0.8246620237607538
2009,1449,25,8,1999,606,0.7575757575757576,1393,0.7673704414587332
2009,1450,17,15,1108,789,0.53125,319,0.5840801265155509
2009,1451,20,9,1494,555,0.6896551724137931,939,0.7291361639824304
2009,1452,23,11,1806,655,0.6764705882352942,1151,0.7338480292563998
2009,1453,22,9,1678,591,0.7096774193548387,1087,0.7395328338475099
2009,1454,16,14,1150,871,0.5333333333333333,279,0.5690252350321623
2009,1455,16,16,1066,932,0.5,134,0.5335335335335335
2009,1456,9,20,622,1139,0.3103448275862069,-517,0.3532084043157297
2009,1457,10,19,623,1143,0.3448275862068966,-520,0.3527746319365798
2009,1458,19,12,1281,715,0.6129032258064516,566,0.6417835671342685
2009,1459,15,14,1099,884,0.5172413793103449,215,0.5542107917297024
2009,1460,20,13,1277,718,0.6060606060606061,559,0.6401002506265664
2009,1461,17,13,1318,886,0.5666666666666667,432,0.5980036297640653
2009,1462,25,7,1873,443,0.78125,1430,0.8087219343696027
2009,1463,12,15,844,842,0.4444444444444444,2,0.5005931198102017
2009,1464,9,19,631,1173,0.32142857142857145,-542,0.34977827050997784
2009,3102,2,26,133,1189,0.07142857142857142,-1056,0.10060514372163389
2009,3103,11,19,713,1073,0.36666666666666664,-360,0.3992161254199328
2009,3104,13,17,915,989,0.43333333333333335,-74,0.4805672268907563
2009,3105,10,18,592,926,0.35714285714285715,-334,0.38998682476943347
2009,3106,14,15,846,680,0.4827586206896552,166,0.5543905635648755
2009,3107,6,25,413,1360,0.1935483870967742,-947,0.2329385222786238
2009,3108,5,26,277,1269,0.16129032258064516,-992,0.17917205692108668
2009,3110,19,11,1299,651,0.6333333333333333,648,0.6661538461538462
2009,3111,9,22,623,1217,0.2903225806451613,-594,0.33858695652173915
2009,3112,12,19,795,991,0.3870967741935484,-196,0.44512877939529677
2009,3113,23,8,1666,493,0.7419354838709677,1173,0.7716535433070866
2009,3114,25,6,1565,326,0.8064516129032258,1239,0.8276044420941301
2009,3115,12,19,788,1070,0.3870967741935484,-282,0.4241119483315393
2009,3116,17,13,1244,769,0.5666666666666667,475,0.6179831097863885
2009,3117,16,14,1121,793,0.5333333333333333,328,0.5856844305120167
2009,3119,19,12,1110,592,0.6129032258064516,518,0.6521739130434783
2009,3120,29,3,2283,182,0.90625,2101,0.9261663286004057
2009,3122,17,15,1231,890,0.53125,341,0.5803866100895804
2009,3123,25,8,1833,543,0.7575757575757576,1290,0.7714646464646465
2009,3124,27,5,1974,267,0.84375,1707,0.8808567603748326
2009,3125,18,13,1154,739,0.5806451612903226,415,0.6096143687268886
2009,3126,10,17,683,1018,0.37037037037037035,-335,0.40152851263962375
2009,3127,14,17,946,920,0.45161290322580644,26,0.5069667738478028
2009,3129,15,15,981,867,0.5,114,0.5308441558441559
2009,3130,20,11,1492,700,0.6451612903225806,792,0.6806569343065694
2009,3131,24,7,1820,433,0.7741935483870968,1387,0.8078118064802485
2009,3132,28,4,2165,204,0.875,1961,0.9138877163360067
2009,3133,21,10,1526,614,0.6774193548387096,912,0.7130841121495327
2009,3135,3,25,193,1189,0.10714285714285714,-996,0.13965267727930536
2009,3136,11,18,711,1059,0.3793103448275862,-348,0.4016949152542373
2009,3137,16,12,1013,638,0.5714285714285714,375,0.6135675348273774
2009,3138,8,24,545,1513,0.25,-968,0.26482021379980564
2009,3139,18,11,1221,605,0.6206896551724138,616,0.6686746987951807
2009,3140,18,11,1112,565,0.6206896551724138,547,0.6630888491353608
2009,3141,18,14,1498,1007,0.5625,491,0.5980039920159681
2009,3142,21,11,1464,646,0.65625,818,0.6938388625592417
2009,3143,25,6,1708,353,0.8064516129032258,1355,0.8287239204269772
2009,3144,11,18,714,924,0.3793103448275862,-210,0.4358974358974359
2009,3145,24,8,1656,429,0.75,1227,0.7942446043165468
2009,3146,6,22,423,1230,0.21428571428571427,-807,0.2558983666061706
2009,3147,4,25,289,1341,0.13793103448275862,-1052,0.17730061349693252
2009,3148,18,13,1246,772,0.5806451612903226,474,0.6174430128840436
2009,3149,9,18,668,1133,0.3333333333333333,-465,0.3709050527484731
2009,3150,23,8,1585,526,0.7419354838709677,1059,0.7508289909995263
2009,3151,22,9,1586,564,0.7096774193548387,1022,0.7376744186046512
2009,3152,15,13,1023,732,0.5357142857142857,291,0.582905982905983
2009,3153,14,17,885,951,0.45161290322580644,-66,0.4820261437908497
2009,3155,14,17,1019,977,0.45161290322580644,42,0.5105210420841684
2009,3156,19,13,1319,744,0.59375,575,0.6393601551139118
2009,3157,13,14,784,759,0.48148148148148145,25,0.508101101749838
2009,3158,22,8,1451,482,0.7333333333333333,969,0.7506466632177962
2009,3159,5,25,301,1214,0.16666666666666666,-913,0.19867986798679868
2009,3160,11,18,807,956,0.3793103448275862,-149,0.4577424844015882
2009,3161,9,21,581,1196,0.3,-615,0.3269555430500844
2009,3162,13,15,952,869,0.4642857142857143,83,0.5227896760021966
2009,3163,33,0,2764,0,1.0,2764,1.0
2009,3164,14,14,904,686,0.5,218,0.5685534591194968
2009,3165,10,16,636,824,0.38461538461538464,-188,0.43561643835616437
2009,3166,21,11,1315,597,0.65625,718,0.6877615062761506
2009,3167,18,9,1380,610,0.6666666666666666,770,0.6934673366834171
2009,3168,10,20,681,1195,0.3333333333333333,-514,0.36300639658848616
2009,3169,8,22,584,1225,0.26666666666666666,-641,0.3228302929795467
2009,3170,9,21,632,1233,0.3,-601,0.3388739946380697
2009,3171,18,10,1075,514,0.6428571428571429,561,0.6765261170547514
2009,3172,12,18,887,1074,0.4,-187,0.452320244773075
2009,3173,20,13,1417,704,0.6060606060606061,713,0.6680810938236681
2009,3174,15,15,947,719,0.5,228,0.5684273709483794
2009,3175,14,15,819,702,0.4827586206896552,117,0.5384615384615384
2009,3176,16,15,1067,861,0.5161290322580645,206,0.5534232365145229
2009,3177,23,9,1732,550,0.71875,1182,0.7589833479404031
2009,3178,12,19,794,980,0.3870967741935484,-186,0.447576099210823
2009,3179,19,12,1261,647,0.6129032258064516,614,0.660901467505241
2009,3180,24,8,1544,441,0.75,1103,0.7778337531486146
2009,3181,26,5,1913,334,0.8387096774193549,1579,0.851357365376057
2009,3182,20,11,1482,668,0.6451612903225806,814,0.6893023255813954
2009,3183,24,9,1710,521,0.7272727272727273,1189,0.7664724338861497
2009,3184,5,20,325,1059,0.2,-734,0.23482658959537572
2009,3185,7,21,460,1271,0.25,-811,0.2657423454650491
2009,3186,8,19,593,1116,0.2962962962962963,-523,0.3469865418373318
2009,3187,18,13,1325,868,0.5806451612903226,457,0.6041951664386684
2009,3188,2,18,132,1062,0.1,-930,0.11055276381909548
2009,3189,4,26,246,1413,0.13333333333333333,-1167,0.14828209764918626
2009,3190,20,10,1472,658,0.6666666666666666,814,0.6910798122065728
2009,3191,15,18,983,1065,0.45454545454545453,-82,0.47998046875
2009,3192,10,20,660,1025,0.3333333333333333,-365,0.3916913946587537
2009,3193,18,13,1181,689,0.5806451612903226,492,0.6315508021390375
2009,3194,12,17,839,960,0.41379310344827586,-121,0.4663702056698166
2009,3195,24,4,1790,252,0.8571428571428571,1538,0.8765915768854065
2009,3196,23,7,1755,482,0.7666666666666667,1273,0.7845328565042468
2009,3197,13,17,846,952,0.43333333333333335,-106,0.47052280311457173
2009,3198,6,24,359,1247,0.2,-888,0.22353673723536738
2009,3199,25,7,1792,453,0.78125,1339,0.7982182628062361
2009,3200,8,21,484,1049,0.27586206896551724,-565,0.3157208088714938
2009,3201,24,8,1705,499,0.75,1206,0.7735934664246824
2009,3202,11,18,807,978,0.3793103448275862,-171,0.45210084033613446
2009,3203,17,13,1156,736,0.5666666666666667,420,0.6109936575052854
2009,3204,15,14,991,690,0.5172413793103449,301,0.5895300416418798
2009,3205,14,15,927,844,0.4827586206896552,83,0.52343308865048
2009,3206,4,26,255,1315,0.13333333333333333,-1060,0.1624203821656051
2009,3207,17,13,1213,704,0.5666666666666667,509,0.6327595200834637
2009,3208,18,13,1318,682,0.5806451612903226,636,0.659
2009,3209,12,18,853,1001,0.4,-148,0.46008629989212513
2009,3210,21,9,1482,544,0.7,938,0.7314906219151036
2009,3211,25,6,1924,375,0.8064516129032258,1549,0.8368856024358416
2009,3212,8,21,480,1140,0.27586206896551724,-660,0.2962962962962963
2009,3214,16,16,1101,929,0.5,172,0.5423645320197045
2009,3216,20,11,1387,646,0.6451612903225806,741,0.6822429906542056
2009,3217,19,9,1376,551,0.6785714285714286,825,0.7140633108458744
2009,3218,8,23,535,1247,0.25806451612903225,-712,0.3002244668911336
2009,3219,13,16,880,955,0.4482758620689655,-75,0.47956403269754766
2009,3220,16,14,1038,786,0.5333333333333333,252,0.569078947368421
2009,3221,13,17,892,930,0.43333333333333335,-38,0.48957189901207465
2009,3222,19,10,1342,612,0.6551724137931034,730,0.6867963152507677
2009,3223,5,17,357,1027,0.22727272727272727,-670,0.2579479768786127
2009,3224,9,22,602,1049,0.2903225806451613,-447,0.3646274984857662
2009,3225,13,15,845,804,0.4642857142857143,41,0.5124317768344451
2009,3226,10,20,662,1165,0.3333333333333333,-503,0.3623426382047072
2009,3227,14,16,898,925,0.4666666666666667,-27,0.4925946242457488
2009,3228,10,21,592,1046,0.3225806451612903,-454,0.3614163614163614
2009,3229,24,7,1837,440,0.7741935483870968,1397,0.8067632850241546
2009,3231,19,10,1360,605,0.6551724137931034,755,0.6921119592875318
2009,3232,14,16,893,850,0.4666666666666667,43,0.5123350545037292
2009,3233,18,13,1220,751,0.5806451612903226,469,0.6189751395230847
2009,3234,21,10,1557,557,0.6774193548387096,1000,0.7365184484389783
2009,3235,24,8,1629,405,0.75,1224,0.8008849557522124
2009,3236,9,21,599,1206,0.3,-607,0.3318559556786704
2009,3237,15,15,970,824,0.5,146,0.5406911928651059
2009,3238,8,20,574,1063,0.2857142857142857,-489,0.3506414172266341
2009,3239,19,13,1253,717,0.59375,536,0.6360406091370558
2009,3240,6,23,365,1299,0.20689655172413793,-934,0.21935096153846154
2009,3241,23,9,1696,531,0.71875,1165,0.7615626403233049
2009,3242,18,13,1330,727,0.5806451612903226,603,0.6465726786582402
2009,3243,24,7,1607,346,0.7741935483870968,1261,0.8228366615463389
2009,3244,15,14,1016,925,0.5172413793103449,91,0.52344152498712
2009,3245,18,10,1354,627,0.6428571428571429,727,0.6834931852599697
2009,3246,15,15,1036,862,0.5,174,0.5458377239199157
2009,3247,10,19,620,1036,0.3448275862068966,-416,0.3743961352657005
2009,3248,10,22,654,1137,0.3125,-483,0.36515912897822445
2009,3249,18,11,1277,608,0.6206896551724138,669,0.6774535809018568
2009,3250,26,6,1829,342,0.8125,1487,0.8424689083371718
2009,3251,23,8,1504,430,0.7419354838709677,1074,0.7776628748707343
2009,3252,6,24,419,1276,0.2,-857,0.2471976401179941
2009,3253,8,21,541,1231,0.27586206896551724,-690,0.30530474040632055
2009,3254,9,20,551,1013,0.3103448275862069,-462,0.3523017902813299
2009,3255,8,21,502,1159,0.27586206896551724,-657,0.30222757375075254
2009,3256,20,12,1539,680,0.625,859,0.6935556557007662
2009,3257,29,4,2142,253,0.8787878787878788,1889,0.8943632567849686
2009,3258,18,12,1290,773,0.6,517,0.6253029568589433
2009,3259,10,20,702,1024,0.3333333333333333,-322,0.406720741599073
2009,3260,6,21,413,1162,0.2222222222222222,-749,0.26222222222222225
2009,3261,18,10,1117,556,0.6428571428571429,561,0.6676628810520024
2009,3263,5,25,290,1270,0.16666666666666666,-980,0.1858974358974359
2009,3264,10,20,690,1167,0.3333333333333333,-477,0.3715670436187399
2009,3265,29,3,2155,182,0.90625,1973,0.922122379118528
2009,3266,16,15,1190,848,0.5161290322580645,342,0.5839057899901865
2009,3267,17,15,1229,861,0.53125,368,0.5880382775119617
2009,3268,28,4,2282,271,0.875,2011,0.8938503721112416
2009,3269,12,18,820,1078,0.4,-258,0.4320337197049526
2009,3270,13,16,881,893,0.4482758620689655,-12,0.49661781285231116
2009,3271,15,14,1032,719,0.5172413793103449,313,0.5893774985722444
2009,3272,12,18,796,1056,0.4,-260,0.4298056155507559
2009,3273,17,14,1231,833,0.5483870967741935,398,0.5964147286821705
2009,3274,13,17,941,1028,0.43333333333333335,-87,0.4779075672930422
2009,3275,16,15,1117,915,0.5161290322580645,202,0.5497047244094488
2009,3276,10,20,624,1038,0.3333333333333333,-414,0.37545126353790614
2009,3277,20,10,1366,540,0.6666666666666666,826,0.7166841552990556
2009,3278,19,11,1300,573,0.6333333333333333,727,0.6940736785904965
2009,3279,17,14,1267,801,0.5483870967741935,466,0.6126692456479691
2009,3280,22,9,1576,540,0.7096774193548387,1036,0.7448015122873346
2009,3281,13,17,871,947,0.43333333333333335,-76,0.4790979097909791
2009,3282,11,18,733,1045,0.3793103448275862,-312,0.41226096737907764
2009,3283,10,20,703,1191,0.3333333333333333,-488,0.37117212249208026
2009,3284,18,13,1076,663,0.5806451612903226,413,0.6187464059804485
2009,3285,27,4,1945,242,0.8709677419354839,1703,0.8893461362597165
2009,3286,14,15,1113,1011,0.4827586206896552,102,0.5240112994350282
2009,3287,17,14,1226,855,0.5483870967741935,371,0.5891398366170111
2009,3288,15,13,1000,739,0.5357142857142857,261,0.5750431282346176
2009,3290,12,19,732,982,0.3870967741935484,-250,0.42707117852975496
2009,3291,14,16,881,859,0.4666666666666667,22,0.5063218390804598
2009,3292,28,5,2249,285,0.8484848484848485,1964,0.8875295974743489
2009,3293,20,8,1606,519,0.7142857142857143,1087,0.7557647058823529
2009,3294,10,18,732,1028,0.35714285714285715,-296,0.4159090909090909
2009,3295,15,13,1022,646,0.5357142857142857,376,0.6127098321342925
2009,3296,15,15,1085,932,0.5,153,0.5379276152702033
2009,3298,16,15,954,845,0.5161290322580645,109,0.5302946081156198
2009,3299,26,6,2067,385,0.8125,1682,0.8429853181076672
2009,3300,10,17,663,790,0.37037037037037035,-127,0.45629731589814176
2009,3301,13,17,848,964,0.43333333333333335,-116,0.46799116997792495
2009,3304,15,15,1057,827,0.5,230,0.5610403397027601
2009,3305,18,14,1257,761,0.5625,496,0.6228939544103073
2009,3306,8,23,540,1174,0.25806451612903225,-634,0.31505250875145857
2009,3307,22,10,1589,511,0.6875,1078,0.7566666666666667
2009,3308,9,22,628,1257,0.2903225806451613,-629,0.33315649867374003
2009,3309,14,17,917,901,0.45161290322580644,16,0.5044004400440044
2009,3310,3,28,206,1526,0.0967741935483871,-1320,0.11893764434180139
2009,3311,2,25,147,1277,0.07407407407407407,-1130,0.10323033707865169
2009,3312,8,21,539,1216,0.27586206896551724,-677,0.3071225071225071
2009,3313,1,27,75,1476,0.03571428571428571,-1401,0.048355899419729204
2009,3314,26,6,2240,424,0.8125,1816,0.8408408408408409
2009,3315,8,10,656,630,0.4444444444444444,26,0.5101088646967341
2009,3316,8,21,524,987,0.27586206896551724,-463,0.34679020516214426
2009,3317,11,20,763,1297,0.3548387096774194,-534,0.3703883495145631
2009,3318,12,19,729,1038,0.3870967741935484,-309,0.41256366723259763
2009,3319,9,21,597,1216,0.3,-619,0.329288472145615
2009,3320,11,18,770,972,0.3793103448275862,-202,0.44202066590126293
2009,3321,7,23,445,1263,0.23333333333333334,-818,0.2605386416861827
2009,3322,15,13,1049,803,0.5357142857142857,246,0.566414686825054
2009,3323,22,8,1656,489,0.7333333333333333,1167,0.772027972027972
2009,3324,25,6,1758,385,0.8064516129032258,1373,0.8203453103126458
2009,3325,13,18,900,1065,0.41935483870967744,-165,0.4580152671755725
2009,3326,27,5,1888,320,0.84375,1568,0.855072463768116
2009,3328,28,4,2180,275,0.875,1905,0.8879837067209776
2009,3329,16,15,1258,933,0.5161290322580645,325,0.5741670470104975
2009,3330,17,13,1246,746,0.5666666666666667,500,0.6255020080321285
2009,3331,13,17,990,985,0.43333333333333335,5,0.5012658227848101
2009,3332,9,21,610,1089,0.3,-479,0.3590347263095939
2009,3333,18,11,1259,592,0.6206896551724138,667,0.6801728795245813
2009,3334,13,16,906,943,0.4482758620689655,-37,0.4899945916711736
2009,3335,9,19,568,1004,0.32142857142857145,-436,0.361323155216285
2009,3336,11,18,774,1081,0.3793103448275862,-307,0.4172506738544474
2009,3337,16,13,1051,710,0.5517241379310345,341,0.5968199886428166
2009,3338,22,7,1717,420,0.7586206896551724,1297,0.8034627983153955
2009,3339,17,12,1148,644,0.5862068965517241,504,0.640625
2009,3340,21,9,1547,577,0.7,970,0.7283427495291902
2009,3341,23,10,1650,532,0.696969696969697,1118,0.7561869844179652
2009,3342,2,25,124,1026,0.07407407407407407,-902,0.10782608695652174
2009,3343,14,14,951,749,0.5,202,0.5594117647058824
2009,3344,10,20,678,1067,0.3333333333333333,-389,0.38853868194842406
2009,3345,22,10,1473,587,0.6875,886,0.7150485436893204
2009,3346,18,11,1243,637,0.6206896551724138,606,0.6611702127659574
2009,3347,9,18,605,913,0.3333333333333333,-308,0.39855072463768115
2009,3348,10,21,610,1063,0.3225806451612903,-453,0.3646144650328751
2009,3349,7,23,457,1326,0.23333333333333334,-869,0.25630959057767805
2009,3350,23,9,1487,497,0.71875,990,0.7494959677419355
2009,3351,10,20,643,1144,0.3333333333333333,-501,0.35982092893116957
2009,3352,13,18,866,1112,0.41935483870967744,-246,0.4378159757330637
2009,3353,18,12,1190,674,0.6,516,0.6384120171673819
2009,3354,6,23,446,1322,0.20689655172413793,-876,0.252262443438914
2009,3355,31,2,2303,107,0.9393939393939394,2196,0.9556016597510374
2009,3356,9,19,649,1032,0.32142857142857145,-383,0.3860797144556811
2009,3357,25,7,1804,416,0.78125,1388,0.8126126126126126
2009,3358,9,20,692,1266,0.3103448275862069,-574,0.3534218590398366
2009,3359,22,7,1416,350,0.7586206896551724,1066,0.8018120045300113
2009,3360,17,13,1225,810,0.5666666666666667,415,0.601965601965602
2009,3361,23,7,1520,419,0.7666666666666667,1101,0.7839092315626611
2009,3362,6,22,378,1203,0.21428571428571427,-825,0.23908918406072105
2009,3363,2,27,103,1402,0.06896551724137931,-1299,0.06843853820598006
2009,3364,22,9,1370,496,0.7096774193548387,874,0.7341907824222936
2009,3365,4,27,241,1401,0.12903225806451613,-1160,0.14677222898903775
2009,3366,5,22,289,967,0.18518518518518517,-678,0.2300955414012739
2009,3367,12,16,853,1010,0.42857142857142855,-157,0.45786366076221147
2009,3368,17,11,1204,588,0.6071428571428571,616,0.671875
2009,3369,13,15,824,832,0.4642857142857143,-8,0.4975845410628019
2009,3371,16,14,1170,767,0.5333333333333333,403,0.6040268456375839
2009,3372,15,14,1066,798,0.5172413793103449,268,0.5718884120171673
2009,3373,10,18,660,1014,0.35714285714285715,-354,0.3942652329749104
2009,3374,20,11,1418,720,0.6451612903225806,698,0.6632366697848456
2009,3375,21,11,1440,663,0.65625,777,0.6847360912981455
2009,3376,10,18,647,974,0.35714285714285715,-327,0.39913633559531153
2009,3378,22,10,1908,579,0.6875,1329,0.767189384800965
2009,3379,19,12,1390,741,0.6129032258064516,649,0.652275926794932
2009,3380,14,13,828,644,0.5185185185185185,184,0.5625
2009,3381,7,20,486,1102,0.25925925925925924,-616,0.3060453400503778
2009,3382,21,10,1365,615,0.6774193548387096,750,0.6893939393939394
2009,3383,4,25,238,1313,0.13793103448275862,-1075,0.15344938749194068
2009,3384,15,17,1076,1083,0.46875,-7,0.4983788791106994
2009,3385,17,14,1156,814,0.5483870967741935,342,0.5868020304568528
2009,3386,13,17,921,981,0.43333333333333335,-60,0.4842271293375394
2009,3387,12,18,820,1125,0.4,-305,0.42159383033419023
2009,3388,10,19,694,1206,0.3448275862068966,-512,0.36526315789473685
2009,3389,13,15,823,808,0.4642857142857143,15,0.5045984058859595
2009,3390,29,4,2280,240,0.8787878787878788,2040,0.9047619047619048
2009,3391,8,22,567,1210,0.26666666666666666,-643,0.31907709622960045
2009,3392,6,23,390,1238,0.20689655172413793,-848,0.23955773955773957
2009,3393,16,13,1182,884,0.5517241379310345,298,0.5721200387221684
2009,3394,10,19,666,1057,0.3448275862068966,-391,0.3865351131746953
2009,3395,20,10,1436,654,0.6666666666666666,782,0.6870813397129186
2009,3396,21,9,1481,530,0.7,951,0.7364495275982098
2009,3397,22,10,1628,623,0.6875,1005,0.7232341181697024
2009,3398,17,13,1150,828,0.5666666666666667,322,0.5813953488372093
2009,3399,9,21,656,1237,0.3,-581,0.34653988378235606
2009,3400,21,11,1617,636,0.65625,981,0.7177097203728362
2009,3401,25,7,1766,399,0.78125,1367,0.8157043879907622
2009,3402,8,16,555,954,0.3333333333333333,-399,0.36779324055666
2009,3403,16,15,1145,830,0.5161290322580645,315,0.579746835443038
2009,3404,2,27,132,1376,0.06896551724137931,-1244,0.08753315649867374
2009,3405,18,13,1262,790,0.5806451612903226,472,0.615009746588694
2009,3406,17,13,1067,694,0.5666666666666667,373,0.6059057353776264
2009,3407,15,14,1021,740,0.5172413793103449,281,0.5797842135150483
2009,3408,18,14,1291,770,0.5625,521,0.626394953905871
2009,3409,7,22,454,1157,0.2413793103448276,-703,0.281812538795779
2009,3410,11,16,638,768,0.4074074074074074,-130,0.45376955903271693
2009,3411,10,20,571,933,0.3333333333333333,-362,0.3796542553191489
2009,3412,10,20,644,1164,0.3333333333333333,-520,0.3561946902654867
2009,3413,11,17,703,922,0.39285714285714285,-219,0.4326153846153846
2009,3414,7,23,407,1077,0.23333333333333334,-670,0.2742587601078167
2009,3415,19,11,1210,566,0.6333333333333333,644,0.6813063063063063
2009,3416,17,16,1251,1013,0.5151515151515151,238,0.5525618374558304
2009,3417,19,12,1385,680,0.6129032258064516,705,0.6707021791767555
2009,3418,3,27,191,1456,0.1,-1265,0.11596842744383729
2009,3419,14,16,976,893,0.4666666666666667,83,0.5222043873729267
2009,3420,14,16,1127,956,0.4666666666666667,171,0.5410465674507922
2009,3421,8,19,563,1006,0.2962962962962963,-443,0.35882727852135116
2009,3422,13,18,869,911,0.41935483870967744,-42,0.48820224719101124
2009,3423,16,15,1021,847,0.5161290322580645,174,0.5465738758029979
2009,3424,14,18,1017,1033,0.4375,-16,0.49609756097560975
2009,3425,17,15,1320,1014,0.53125,306,0.5655526992287918
2009,3426,21,10,1634,612,0.6774193548387096,1022,0.7275155832591274
2009,3427,22,8,1569,458,0.7333333333333333,1111,0.7740503206709423
2009,3428,21,9,1414,483,0.7,931,0.7453874538745388
2009,3429,15,15,915,849,0.5,66,0.5187074829931972
2009,3430,15,10,1199,688,0.6,511,0.6354001059883413
2009,3431,17,12,1265,645,0.5862068965517241,620,0.662303664921466
2009,3433,26,6,1784,367,0.8125,1417,0.8293816829381683
2009,3434,16,14,1146,764,0.5333333333333333,382,0.6
2009,3435,24,8,1847,448,0.75,1399,0.80479302832244
2009,3436,21,11,1497,636,0.65625,861,0.7018284106891702
2009,3437,19,13,1096,684,0.59375,412,0.6157303370786517
2009,3438,23,9,1736,599,0.71875,1137,0.7434689507494646
2009,3439,12,18,840,1026,0.4,-186,0.45016077170418006
2009,3441,21,11,1536,675,0.65625,861,0.694708276797829
2009,3442,8,21,534,991,0.27586206896551724,-457,0.3501639344262295
2009,3443,16,13,1195,767,0.5517241379310345,428,0.609072375127421
2009,3444,7,23,469,1434,0.23333333333333334,-965,0.2464529689963216
2009,3445,6,23,409,1113,0.20689655172413793,-704,0.26872536136662284
2009,3447,7,22,428,1245,0.2413793103448276,-817,0.255827854154214
2009,3448,19,11,1353,619,0.6333333333333333,734,0.686105476673428
2009,3449,7,22,464,1222,0.2413793103448276,-758,0.2752075919335706
2009,3450,11,19,760,1028,0.36666666666666664,-268,0.4250559284116331
2009,3451,9,19,647,1082,0.32142857142857145,-435,0.3742047426257953
2009,3452,16,14,1120,819,0.5333333333333333,301,0.5776173285198556
2009,3453,29,3,1952,164,0.90625,1788,0.9224952741020794
2009,3454,15,18,1054,991,0.45454545454545453,63,0.5154034229828851
2009,3455,13,18,858,1000,0.41935483870967744,-142,0.46178686759956944
2009,3456,14,17,928,968,0.45161290322580644,-40,0.48945147679324896
2009,3457,14,15,889,711,0.4827586206896552,178,0.555625
2009,3458,18,14,1085,739,0.5625,346,0.5948464912280702
2009,3459,4,24,283,1431,0.14285714285714285,-1148,0.16511085180863477
2009,3460,14,16,862,808,0.4666666666666667,54,0.5161676646706587
2009,3461,15,14,987,750,0.5172413793103449,237,0.5682210708117443
2009,3462,25,6,1710,359,0.8064516129032258,1351,0.8264862252295795
2009,3463,11,17,760,982,0.39285714285714285,-222,0.4362801377726751
2009,3464,3,27,179,1326,0.1,-1147,0.11893687707641196
2010,1102,8,21,551,1062,0.27586206896551724,-511,0.3415995040297582
2010,1103,23,10,1714,630,0.696969696969697,1084,0.7312286689419796
2010,1104,17,15,1236,956,0.53125,280,0.5638686131386861
2010,1105,8,15,580,888,0.34782608695652173,-308,0.39509536784741145
2010,1106,13,15,938,855,0.4642857142857143,83,0.5231455660903513
2010,1107,7,25,511,1496,0.21875,-985,0.25460886895864476
2010,1108,2,29,124,1756,0.06451612903225806,-1632,0.06595744680851064
2010,1110,11,20,763,1178,0.3548387096774194,-415,0.3930963420917053
2010,1111,20,11,1568,703,0.6451612903225806,865,0.6904447380008807
2010,1112,16,15,1258,971,0.5161290322580645,287,0.5643786451323464
2010,1113,22,10,1556,580,0.6875,976,0.7284644194756554
2010,1114,6,22,445,1405,0.21428571428571427,-960,0.24054054054054055
2010,1115,17,15,1127,934,0.53125,193,0.5468219311014071
2010,1116,14,18,1138,1253,0.4375,-115,0.4759514847344207
2010,1117,15,14,1083,886,0.5172413793103449,197,0.5500253936008126
2010,1119,13,15,803,884,0.4642857142857143,-81,0.4759928867812685
2010,1120,14,17,1124,1202,0.45161290322580644,-78,0.4832330180567498
2010,1122,15,15,1113,1023,0.5,90,0.5210674157303371
2010,1123,14,15,953,796,0.4827586206896552,157,0.544882790165809
2010,1124,24,7,1861,517,0.7741935483870968,1344,0.7825904121110177
2010,1125,19,12,1479,787,0.6129032258064516,692,0.6526919682259488
2010,1126,14,16,920,834,0.4666666666666667,86,0.5245153933865451
2010,1127,11,18,780,1009,0.3793103448275862,-229,0.4359977641140302
2010,1129,14,17,1090,1204,0.45161290322580644,-114,0.47515257192676547
2010,1130,15,16,1139,1006,0.4838709677419355,133,0.531002331002331
2010,1131,19,13,1416,850,0.59375,566,0.6248896734333628
2010,1132,13,16,870,952,0.4482758620689655,-82,0.4774972557628979
2010,1133,16,15,1149,942,0.5161290322580645,207,0.5494978479196556
2010,1135,9,20,648,1282,0.3103448275862069,-634,0.33575129533678755
2010,1136,1,29,53,1503,0.03333333333333333,-1450,0.03406169665809768
2010,1137,14,17,986,1091,0.45161290322580644,-105,0.47472315840154067
2010,1138,17,12,1271,806,0.5862068965517241,465,0.6119402985074627
2010,1139,28,4,1979,264,0.875,1715,0.8823004904146232
2010,1140,28,5,2372,354,0.8484848484848485,2018,0.8701393983859135
2010,1141,14,15,960,895,0.4827586206896552,65,0.5175202156334232
2010,1142,12,19,960,1216,0.3870967741935484,-256,0.4411764705882353
2010,1143,23,10,1865,708,0.696969696969697,1157,0.7248348231636222
2010,1144,17,11,1227,668,0.6071428571428571,559,0.6474934036939314
2010,1145,15,17,1060,1065,0.46875,-5,0.4988235294117647
2010,1146,6,20,441,1166,0.23076923076923078,-725,0.2744243932794026
2010,1147,6,21,486,1367,0.2222222222222222,-881,0.26227738801942796
2010,1148,12,18,829,1005,0.4,-176,0.4520174482006543
2010,1149,9,17,654,1018,0.34615384615384615,-364,0.3911483253588517
2010,1150,19,12,1498,778,0.6129032258064516,720,0.6581722319859402
2010,1151,13,18,979,1135,0.41935483870967744,-156,0.4631031220435194
2010,1152,6,22,411,1266,0.21428571428571427,-855,0.24508050089445438
2010,1153,18,15,1333,933,0.5454545454545454,400,0.588261253309797
2010,1154,14,16,929,888,0.4666666666666667,41,0.5112823335167859
2010,1155,21,10,1645,627,0.6774193548387096,1018,0.7240316901408451
2010,1156,14,17,1022,1049,0.45161290322580644,-27,0.49348140994688555
2010,1157,24,6,1817,352,0.8,1465,0.8377132319041033
2010,1158,21,11,1645,736,0.65625,909,0.6908861822763545
2010,1159,10,19,747,1208,0.3448275862068966,-461,0.38209718670076726
2010,1160,13,16,1049,1107,0.4482758620689655,-58,0.4865491651205937
2010,1161,15,15,1087,894,0.5,193,0.5487127713276123
2010,1162,11,17,762,924,0.39285714285714285,-162,0.45195729537366547
2010,1163,17,15,1317,941,0.53125,376,0.58325952170062
2010,1164,5,22,366,1256,0.18518518518518517,-890,0.22564734895191121
2010,1165,25,4,1898,282,0.8620689655172413,1616,0.8706422018348624
2010,1166,16,15,1201,950,0.5161290322580645,251,0.5583449558344956
2010,1167,7,22,465,1442,0.2413793103448276,-977,0.24383848977451494
2010,1168,14,15,1115,998,0.4827586206896552,117,0.5276857548509228
2010,1169,11,21,859,1423,0.34375,-564,0.3764241893076249
2010,1170,7,21,484,1287,0.25,-803,0.2732919254658385
2010,1171,4,23,230,1200,0.14814814814814814,-970,0.16083916083916083
2010,1172,14,15,1052,982,0.4827586206896552,70,0.5172074729596854
2010,1173,20,12,1456,775,0.625,681,0.6526221425369789
2010,1174,7,24,497,1468,0.22580645161290322,-971,0.2529262086513995
2010,1175,14,12,867,644,0.5384615384615384,223,0.5737921906022502
2010,1176,19,13,1352,727,0.59375,625,0.6503126503126503
2010,1177,8,23,517,1374,0.25806451612903225,-857,0.27340031729243786
2010,1178,19,14,1416,862,0.5757575757575758,554,0.6215978928884986
2010,1179,14,19,1076,1121,0.42424242424242425,-45,0.4897587619481111
2010,1180,16,16,1100,944,0.5,156,0.538160469667319
2010,1181,29,5,2292,359,0.8529411764705882,1933,0.8645794039984911
2010,1182,15,15,1151,974,0.5,177,0.5416470588235294
2010,1183,17,12,1240,679,0.5862068965517241,561,0.6461698801459094
2010,1184,18,12,1341,755,0.6,586,0.6397900763358778
2010,1185,15,15,1042,934,0.5,108,0.5273279352226721
2010,1186,7,21,548,1328,0.25,-780,0.2921108742004264
2010,1187,7,21,508,1354,0.25,-846,0.2728249194414608
2010,1188,3,23,222,1349,0.11538461538461539,-1127,0.1413112667091025
2010,1189,8,23,623,1416,0.25806451612903225,-793,0.30554193231976456
2010,1190,19,14,1348,930,0.5757575757575758,418,0.591747146619842
2010,1191,8,21,563,1289,0.27586206896551724,-726,0.30399568034557234
2010,1192,11,21,780,1247,0.34375,-467,0.3848051307350765
2010,1193,22,10,1574,684,0.6875,890,0.6970770593445527
2010,1194,12,16,930,1080,0.42857142857142855,-150,0.4626865671641791
2010,1195,8,21,593,1282,0.27586206896551724,-689,0.31626666666666664
2010,1196,21,12,1541,822,0.6363636363636364,719,0.652137113838341
2010,1197,8,22,573,1306,0.26666666666666666,-733,0.30494944119212347
2010,1198,6,25,447,1641,0.1935483870967742,-1194,0.21408045977011494
2010,1199,22,9,1566,557,0.7096774193548387,1009,0.7376354215732454
2010,1200,2,26,169,1624,0.07142857142857142,-1455,0.09425543781372002
2010,1201,14,18,1028,1095,0.4375,-67,0.4842204427696656
2010,1202,11,17,788,1114,0.39285714285714285,-326,0.41430073606729756
2010,1203,16,14,1204,903,0.5333333333333333,301,0.5714285714285714
2010,1204,7,23,550,1516,0.23333333333333334,-966,0.26621490803484993
2010,1205,5,21,379,1365,0.19230769230769232,-986,0.21731651376146788
2010,1206,17,14,1217,832,0.5483870967741935,385,0.5939482674475354
2010,1207,23,10,1775,642,0.696969696969697,1133,0.7343814646255689
2010,1208,14,17,1008,1120,0.45161290322580644,-112,0.47368421052631576
2010,1209,11,20,734,1182,0.3548387096774194,-448,0.38308977035490605
2010,1210,21,12,1578,815,0.6363636363636364,763,0.6594233180108651
2010,1211,25,6,2011,392,0.8064516129032258,1619,0.8368705784436121
2010,1212,6,21,412,1297,0.2222222222222222,-885,0.24107665301345815
2010,1214,14,18,1012,1090,0.4375,-78,0.4814462416745956
2010,1216,8,22,545,1323,0.26666666666666666,-778,0.2917558886509636
2010,1217,20,7,1566,420,0.7407407407407407,1146,0.7885196374622356
2010,1218,9,20,700,1274,0.3103448275862069,-574,0.3546099290780142
2010,1219,13,15,935,1030,0.4642857142857143,-95,0.4758269720101781
2010,1220,18,14,1371,866,0.5625,505,0.6128743853375056
2010,1221,9,22,658,1489,0.2903225806451613,-831,0.3064741499767117
2010,1222,18,15,1491,1110,0.5454545454545454,381,0.5732410611303345
2010,1223,12,21,921,1426,0.36363636363636365,-505,0.3924158500213038
2010,1224,7,25,477,1391,0.21875,-914,0.25535331905781583
2010,1225,13,16,1007,1046,0.4482758620689655,-39,0.4905017048222114
2010,1226,5,22,376,1411,0.18518518518518517,-1035,0.21040850587576945
2010,1227,7,22,492,1312,0.2413793103448276,-820,0.2727272727272727
2010,1228,19,14,1399,926,0.5757575757575758,473,0.6017204301075268
2010,1229,22,10,1622,619,0.6875,1003,0.7237840249888443
2010,1231,10,21,794,1259,0.3225806451612903,-465,0.3867510959571359
2010,1232,16,14,1097,874,0.5333333333333333,223,0.556570268899036
2010,1233,21,10,1440,610,0.6774193548387096,830,0.7024390243902439
2010,1234,10,22,717,1220,0.3125,-503,0.3701600413009809
2010,1235,15,17,1184,1139,0.46875,45,0.509685751183814
2010,1236,14,15,972,970,0.4827586206896552,2,0.5005149330587023
2010,1237,22,10,1703,646,0.6875,1057,0.7249893571732652
2010,1238,18,12,1206,667,0.6,539,0.6438868126001068
2010,1239,19,12,1394,779,0.6129032258064516,615,0.6415094339622641
2010,1240,9,19,701,1215,0.32142857142857145,-514,0.36586638830897705
2010,1241,13,20,969,1241,0.3939393939393939,-272,0.43846153846153846
2010,1242,32,2,2635,145,0.9411764705882353,2490,0.947841726618705
2010,1243,25,7,2042,501,0.78125,1541,0.8029885961462839
2010,1244,11,20,835,1180,0.3548387096774194,-345,0.4143920595533499
2010,1245,22,9,1626,560,0.7096774193548387,1066,0.7438243366880146
2010,1246,32,2,2567,127,0.9411764705882353,2440,0.9528582034149963
2010,1247,12,18,924,1187,0.4,-263,0.43770724774988157
2010,1248,19,13,1515,805,0.59375,710,0.6530172413793104
2010,1249,10,18,721,1169,0.35714285714285715,-448,0.3814814814814815
2010,1250,22,10,1709,695,0.6875,1014,0.7108985024958403
2010,1251,12,16,889,946,0.42857142857142855,-57,0.48446866485013623
2010,1252,16,13,1294,974,0.5517241379310345,320,0.5705467372134039
2010,1253,15,16,1084,1078,0.4838709677419355,6,0.5013876040703052
2010,1254,14,17,1028,1134,0.45161290322580644,-106,0.47548566142460685
2010,1255,8,19,620,1281,0.2962962962962963,-661,0.32614413466596526
2010,1256,23,10,1809,642,0.696969696969697,1167,0.7380660954712362
2010,1257,20,12,1621,822,0.625,799,0.6635284486287352
2010,1258,17,15,1366,1045,0.53125,321,0.5665698880132725
2010,1259,13,17,925,1024,0.43333333333333335,-99,0.4746023601847101
2010,1260,12,16,855,946,0.42857142857142855,-91,0.47473625763464744
2010,1261,11,20,751,1154,0.3548387096774194,-403,0.3942257217847769
2010,1263,18,11,1171,627,0.6206896551724138,544,0.6512791991101223
2010,1264,11,20,808,1223,0.3548387096774194,-415,0.39783357951747905
2010,1265,1,29,72,1612,0.03333333333333333,-1540,0.04275534441805225
2010,1266,22,11,1716,691,0.6666666666666666,1025,0.7129206481096801
2010,1267,20,9,1627,589,0.6896551724137931,1038,0.7342057761732852
2010,1268,22,8,1833,545,0.7333333333333333,1288,0.7708158116063919
2010,1269,11,20,830,1338,0.3548387096774194,-508,0.3828413284132841
2010,1270,7,20,486,1295,0.25925925925925924,-809,0.27288040426726556
2010,1271,11,21,724,1221,0.34375,-497,0.3722365038560411
2010,1272,23,9,1843,568,0.71875,1275,0.7644131065947739
2010,1273,14,17,1117,1200,0.45161290322580644,-83,0.4820889080707812
2010,1274,19,13,1445,837,0.59375,608,0.633216476774759
2010,1275,14,18,930,1066,0.4375,-136,0.46593186372745493
2010,1276,14,17,1005,957,0.45161290322580644,48,0.5122324159021406
2010,1277,24,8,1780,544,0.75,1236,0.76592082616179
2010,1278,21,13,1671,808,0.6176470588235294,863,0.6740621218233158
2010,1279,21,10,1724,692,0.6774193548387096,1032,0.7135761589403974
2010,1280,23,11,1738,729,0.6764705882352942,1009,0.7044993919740575
2010,1281,22,10,1857,625,0.6875,1232,0.7481869460112812
2010,1282,10,18,717,1127,0.35714285714285715,-410,0.3888286334056399
2010,1283,20,12,1474,797,0.625,677,0.6490532804931748
2010,1284,12,19,822,1154,0.3870967741935484,-332,0.4159919028340081
2010,1285,20,9,1489,525,0.6896551724137931,964,0.7393247269116187
2010,1286,13,14,932,889,0.48148148148148145,43,0.5118066996155958
2010,1287,21,10,1551,624,0.6774193548387096,927,0.713103448275862
2010,1288,27,9,2126,637,0.75,1489,0.7694534925805284
2010,1290,8,23,569,1386,0.25806451612903225,-817,0.29104859335038363
2010,1291,16,15,1116,929,0.5161290322580645,187,0.545721271393643
2010,1292,17,13,1225,798,0.5666666666666667,427,0.6055363321799307
2010,1293,28,4,2147,288,0.875,1859,0.8817248459958932
2010,1294,23,7,1716,482,0.7666666666666667,1234,0.7807097361237488
2010,1295,9,18,662,1185,0.3333333333333333,-523,0.35841905793178125
2010,1296,10,20,748,1269,0.3333333333333333,-521,0.3708477937530987
2010,1298,13,17,1035,1103,0.43333333333333335,-68,0.48409728718428435
2010,1299,8,22,578,1423,0.26666666666666666,-845,0.2888555722138931
2010,1300,3,22,219,1201,0.12,-982,0.15422535211267605
2010,1301,19,15,1380,908,0.5588235294117647,472,0.6031468531468531
2010,1304,15,18,1089,1105,0.45454545454545453,-16,0.49635369188696443
2010,1305,19,12,1584,873,0.6129032258064516,711,0.6446886446886447
2010,1306,12,17,810,924,0.41379310344827586,-114,0.4671280276816609
2010,1307,29,4,2268,261,0.8787878787878788,2007,0.896797153024911
2010,1308,21,11,1730,782,0.65625,948,0.6886942675159236
2010,1309,6,22,414,1225,0.21428571428571427,-811,0.2525930445393533
2010,1310,18,15,1378,1004,0.5454545454545454,374,0.5785054575986566
2010,1311,8,18,552,1100,0.3076923076923077,-548,0.3341404358353511
2010,1312,7,21,485,1179,0.25,-694,0.29146634615384615
2010,1313,11,19,792,1327,0.36666666666666664,-535,0.37376120811703634
2010,1314,16,16,1348,1058,0.5,290,0.5602660016625104
2010,1315,6,22,440,1292,0.21428571428571427,-852,0.2540415704387991
2010,1316,12,18,727,1037,0.4,-310,0.4121315192743764
2010,1317,22,8,1666,538,0.7333333333333333,1128,0.7558983666061706
2010,1318,20,12,1354,713,0.625,641,0.6550556361877117
2010,1319,12,14,893,846,0.46153846153846156,47,0.5135135135135135
2010,1320,28,4,1810,216,0.875,1594,0.8933859822309971
2010,1321,20,13,1444,843,0.6060606060606061,601,0.6313948404022737
2010,1322,7,18,594,1266,0.28,-672,0.3193548387096774
2010,1323,23,11,1803,782,0.6764705882352942,1021,0.6974854932301741
2010,1324,24,8,1952,455,0.75,1497,0.8109680099709181
2010,1325,20,14,1573,924,0.5882352941176471,649,0.6299559471365639
2010,1326,27,7,2094,430,0.7941176470588235,1664,0.8296354992076069
2010,1328,13,18,1023,1212,0.41935483870967744,-189,0.4577181208053691
2010,1329,22,10,1729,649,0.6875,1080,0.7270815811606391
2010,1330,26,8,1831,465,0.7647058823529411,1366,0.7974738675958188
2010,1331,19,13,1395,832,0.59375,563,0.6264032330489447
2010,1332,16,16,1246,991,0.5,255,0.556995976754582
2010,1333,14,17,918,933,0.45161290322580644,-15,0.4959481361426256
2010,1334,20,11,1376,643,0.6451612903225806,733,0.6815255076770679
2010,1335,6,22,428,1323,0.21428571428571427,-895,0.24443175328383782
2010,1336,11,20,818,1195,0.3548387096774194,-377,0.40635866865375064
2010,1337,6,23,456,1451,0.20689655172413793,-995,0.23911903513371788
2010,1338,24,8,1716,463,0.75,1253,0.7875172097292336
2010,1339,19,10,1419,641,0.6551724137931034,778,0.6888349514563107
2010,1340,11,19,959,1355,0.36666666666666664,-396,0.41443388072601556
2010,1341,12,14,816,765,0.46153846153846156,51,0.5161290322580645
2010,1342,4,26,277,1528,0.13333333333333333,-1251,0.15346260387811633
2010,1343,19,8,1183,402,0.7037037037037037,781,0.7463722397476341
2010,1344,12,19,1036,1518,0.3870967741935484,-482,0.4056382145653876
2010,1345,27,5,1993,282,0.84375,1711,0.876043956043956
2010,1346,23,9,1778,576,0.71875,1202,0.7553101104502974
2010,1347,17,12,1278,746,0.5862068965517241,532,0.6314229249011858
2010,1348,23,9,1860,570,0.71875,1290,0.7654320987654321
2010,1349,7,23,503,1407,0.23333333333333334,-904,0.26335078534031414
2010,1350,26,8,1857,499,0.7647058823529411,1358,0.7882003395585738
2010,1351,17,16,1275,1020,0.5151515151515151,255,0.5555555555555556
2010,1352,23,11,1663,666,0.6764705882352942,997,0.7140403606698154
2010,1353,14,17,1000,1090,0.45161290322580644,-90,0.4784688995215311
2010,1354,15,14,1129,876,0.5172413793103449,253,0.5630922693266833
2010,1355,12,16,918,1125,0.42857142857142855,-207,0.44933920704845814
2010,1356,14,15,1082,938,0.4827586206896552,144,0.5356435643564357
2010,1357,14,15,1065,1022,0.4827586206896552,43,0.5103018687110685
2010,1358,21,7,1687,550,0.75,1137,0.7541350022351363
2010,1359,8,20,502,1106,0.2857142857142857,-604,0.31218905472636815
2010,1360,10,21,668,1244,0.3225806451612903,-576,0.3493723849372385
2010,1361,23,8,1619,545,0.7419354838709677,1074,0.7481515711645101
2010,1362,10,18,764,1131,0.35714285714285715,-367,0.40316622691292875
2010,1363,13,17,1012,1188,0.43333333333333335,-176,0.46
2010,1364,19,9,1363,529,0.6785714285714286,834,0.7204016913319239
2010,1365,9,21,617,1284,0.3,-667,0.3245660178853235
2010,1366,7,15,431,789,0.3181818181818182,-358,0.35327868852459016
2010,1367,6,23,416,1325,0.20689655172413793,-909,0.2389431361286617
2010,1368,15,12,1137,781,0.5555555555555556,356,0.5928050052137643
2010,1369,6,23,442,1369,0.20689655172413793,-927,0.24406405300938708
2010,1370,17,14,1389,1100,0.5483870967741935,289,0.5580554439533949
2010,1371,19,12,1637,857,0.6129032258064516,780,0.6563753007217321
2010,1372,20,9,1364,505,0.6896551724137931,859,0.7298020331728197
2010,1373,27,6,2100,390,0.8181818181818182,1710,0.8433734939759037
2010,1374,12,17,898,1009,0.41379310344827586,-111,0.47089669638175147
2010,1375,15,15,1051,921,0.5,130,0.5329614604462475
2010,1376,15,16,1188,1039,0.4838709677419355,149,0.5334530758868433
2010,1377,18,9,1466,585,0.6666666666666666,881,0.7147732813261823
2010,1378,20,12,1467,702,0.625,765,0.6763485477178424
2010,1379,16,13,1070,749,0.5517241379310345,321,0.5882352941176471
2010,1380,5,24,362,1356,0.1724137931034483,-994,0.21071012805587894
2010,1381,5,22,368,1303,0.18518518518518517,-935,0.22022740873728305
2010,1382,14,16,1080,1017,0.4666666666666667,63,0.5150214592274678
2010,1383,11,18,709,1044,0.3793103448275862,-335,0.4044495151169424
2010,1384,11,19,735,1140,0.36666666666666664,-405,0.392
2010,1385,17,15,1216,934,0.53125,282,0.5655813953488372
2010,1386,11,20,830,1311,0.3548387096774194,-481,0.387669313404951
2010,1387,19,11,1293,603,0.6333333333333333,690,0.6819620253164557
2010,1388,25,5,2027,337,0.8333333333333334,1690,0.8574450084602369
2010,1389,16,14,1081,782,0.5333333333333333,299,0.5802469135802469
2010,1390,14,18,1008,1204,0.4375,-196,0.45569620253164556
2010,1391,5,22,338,1251,0.18518518518518517,-913,0.21271239773442416
2010,1392,21,9,1505,547,0.7,958,0.7334307992202729
2010,1393,28,4,2323,284,0.875,2039,0.8910625239739164
2010,1394,14,15,1028,929,0.4827586206896552,99,0.5252938170669392
2010,1395,11,19,802,1204,0.36666666666666664,-402,0.39980059820538383
2010,1396,29,5,1945,263,0.8529411764705882,1682,0.8808876811594203
2010,1397,25,8,1924,506,0.7575757575757576,1418,0.7917695473251029
2010,1398,9,23,705,1449,0.28125,-744,0.32729805013927576
2010,1399,13,17,1001,1182,0.43333333333333335,-181,0.4585432890517636
2010,1400,24,9,2050,631,0.7272727272727273,1419,0.7646400596792242
2010,1401,22,9,1610,598,0.7096774193548387,1012,0.7291666666666666
2010,1402,11,16,933,1122,0.4074074074074074,-189,0.454014598540146
2010,1403,17,15,1355,1086,0.53125,269,0.5551003687013519
2010,1404,2,25,141,1569,0.07407407407407407,-1428,0.0824561403508772
2010,1405,3,28,194,1475,0.0967741935483871,-1281,0.11623726782504494
2010,1406,10,21,785,1339,0.3225806451612903,-554,0.3695856873822976
2010,1407,17,12,1259,818,0.5862068965517241,441,0.6061627347135291
2010,1408,8,22,602,1262,0.26666666666666666,-660,0.3229613733905579
2010,1409,22,11,1647,707,0.6666666666666666,940,0.699660152931181
2010,1410,6,27,391,1628,0.18181818181818182,-1237,0.19366022783556217
2010,1411,15,16,1111,952,0.4838709677419355,159,0.538536112457586
2010,1412,23,8,1583,501,0.7419354838709677,1082,0.7595969289827256
2010,1413,12,18,903,1145,0.4,-242,0.44091796875
2010,1414,12,18,887,1112,0.4,-225,0.44372186093046523
2010,1415,10,17,682,979,0.37037037037037035,-297,0.4105960264900662
2010,1416,14,17,1003,1050,0.45161290322580644,-47,0.48855333658061373
2010,1417,14,18,1021,1118,0.4375,-97,0.47732585320243104
2010,1418,12,16,873,1016,0.42857142857142855,-143,0.4621492853361567
2010,1419,10,19,683,1252,0.3448275862068966,-569,0.35297157622739017
2010,1420,4,26,272,1621,0.13333333333333333,-1349,0.14368726888536715
2010,1421,12,16,1000,1005,0.42857142857142855,-5,0.49875311720698257
2010,1422,8,23,567,1399,0.25806451612903225,-832,0.2884028484231943
2010,1423,9,22,701,1350,0.2903225806451613,-649,0.3417844953681131
2010,1424,24,8,1820,508,0.75,1312,0.781786941580756
2010,1425,16,14,1032,757,0.5333333333333333,275,0.5768585802124092
2010,1426,12,14,936,949,0.46153846153846156,-13,0.496551724137931
2010,1427,16,11,1167,694,0.5925925925925926,473,0.6270822138635143
2010,1428,14,17,949,1110,0.45161290322580644,-161,0.46090335114133074
2010,1429,26,7,2000,428,0.7878787878787878,1572,0.8237232289950577
2010,1430,8,18,550,1040,0.3076923076923077,-490,0.34591194968553457
2010,1431,26,6,1971,454,0.8125,1517,0.8127835051546392
2010,1433,22,9,1719,619,0.7096774193548387,1100,0.7352437981180496
2010,1434,12,17,933,1164,0.41379310344827586,-231,0.4449213161659514
2010,1435,23,8,1898,506,0.7419354838709677,1392,0.7895174708818635
2010,1436,25,9,1840,561,0.7352941176470589,1279,0.7663473552686381
2010,1437,24,7,2045,514,0.7741935483870968,1531,0.7991402891754592
2010,1438,15,16,1106,923,0.4838709677419355,183,0.5450961064563824
2010,1439,23,8,1728,527,0.7419354838709677,1201,0.7662971175166298
2010,1440,6,19,570,1582,0.24,-1012,0.2648698884758364
2010,1441,19,11,1452,726,0.6333333333333333,726,0.6666666666666666
2010,1442,10,17,611,932,0.37037037037037035,-321,0.3959818535320804
2010,1443,21,13,1580,842,0.6176470588235294,738,0.652353426919901
2010,1444,17,15,1219,982,0.53125,237,0.5538391640163562
2010,1445,8,17,543,928,0.32,-385,0.3691366417403127
2010,1447,5,26,350,1534,0.16129032258064516,-1184,0.18577494692144372
2010,1448,19,10,1482,634,0.6551724137931034,848,0.7003780718336484
2010,1449,24,9,2008,625,0.7272727272727273,1383,0.7626281807823775
2010,1450,15,15,1153,989,0.5,164,0.53828197945845
2010,1451,18,10,1447,690,0.6428571428571429,757,0.6771174543752925
2010,1452,27,6,1975,433,0.8181818181818182,1542,0.8201827242524917
2010,1453,19,12,1412,706,0.6129032258064516,706,0.6666666666666666
2010,1454,18,14,1339,880,0.5625,459,0.6034249662009914
2010,1455,24,9,1745,533,0.7272727272727273,1212,0.7660228270412642
2010,1456,21,10,1433,614,0.6774193548387096,819,0.7000488519785051
2010,1457,17,13,1159,718,0.5666666666666667,441,0.6174746936600959
2010,1458,23,8,1630,462,0.7419354838709677,1168,0.7791586998087954
2010,1459,25,8,1763,515,0.7575757575757576,1248,0.7739244951712028
2010,1460,20,12,1430,733,0.625,697,0.6611188164586222
2010,1461,8,21,629,1318,0.27586206896551724,-689,0.32306111967128914
2010,1462,24,8,1998,563,0.75,1435,0.7801639984381101
2010,1463,11,19,730,1245,0.36666666666666664,-515,0.369620253164557
2010,1464,6,22,441,1392,0.21428571428571427,-951,0.24058919803600654
2010,3102,1,27,68,1383,0.03571428571428571,-1315,0.04686423156443832
2010,3103,17,13,1128,739,0.5666666666666667,389,0.6041778253883235
2010,3104,12,18,862,1059,0.4,-197,0.4487246225923998
2010,3105,14,13,930,711,0.5185185185185185,219,0.56672760511883
2010,3106,12,17,718,881,0.41379310344827586,-163,0.44903064415259536
2010,3107,11,19,695,997,0.36666666666666664,-302,0.4107565011820331
2010,3108,8,20,534,1156,0.2857142857142857,-622,0.31597633136094677
2010,3110,22,9,1436,487,0.7096774193548387,949,0.7467498699947998
2010,3111,19,12,1340,719,0.6129032258064516,621,0.6508013598834386
2010,3112,14,17,1062,966,0.45161290322580644,96,0.5236686390532544
2010,3113,17,13,1140,737,0.5666666666666667,403,0.607352157698455
2010,3114,26,6,1803,336,0.8125,1467,0.8429172510518934
2010,3115,8,22,588,1313,0.26666666666666666,-725,0.3093108890057864
2010,3116,12,18,901,1047,0.4,-146,0.4625256673511294
2010,3117,13,18,938,1100,0.41935483870967744,-162,0.4602551521099117
2010,3119,10,18,603,858,0.35714285714285715,-255,0.4127310061601643
2010,3120,15,16,1008,909,0.4838709677419355,99,0.5258215962441315
2010,3122,15,17,1103,1015,0.46875,88,0.5207743153918791
2010,3123,14,17,1034,1045,0.45161290322580644,-11,0.4973544973544973
2010,3124,23,9,1796,511,0.71875,1285,0.7785002167316861
2010,3125,15,15,1039,907,0.5,132,0.5339157245632066
2010,3126,16,15,1081,841,0.5161290322580645,240,0.5624349635796045
2010,3127,11,19,796,1048,0.36666666666666664,-252,0.4316702819956616
2010,3129,18,12,1301,804,0.6,497,0.6180522565320665
2010,3130,17,15,1259,949,0.53125,310,0.5701992753623188
2010,3131,16,14,1121,824,0.5333333333333333,297,0.5763496143958869
2010,3132,27,6,2054,379,0.8181818181818182,1675,0.8442252363337444
2010,3133,16,13,1086,739,0.5517241379310345,347,0.5950684931506849
2010,3135,8,20,516,977,0.2857142857142857,-461,0.34561286001339586
2010,3136,13,16,909,935,0.4482758620689655,-26,0.49295010845986986
2010,3137,6,21,373,1061,0.2222222222222222,-688,0.2601115760111576
2010,3138,7,23,494,1385,0.23333333333333334,-891,0.26290580095795635
2010,3139,23,9,1587,582,0.71875,1005,0.7316735822959889
2010,3140,20,9,1401,488,0.6896551724137931,913,0.7416622551614611
2010,3141,12,18,994,1155,0.4,-161,0.46254071661237783
2010,3142,18,11,1384,697,0.6206896551724138,687,0.6650648726573762
2010,3143,18,13,1309,719,0.5806451612903226,590,0.6454635108481263
2010,3144,14,16,1035,924,0.4666666666666667,111,0.5283307810107197
2010,3145,12,19,755,966,0.3870967741935484,-211,0.4386984311446833
2010,3146,17,8,1266,552,0.68,714,0.6963696369636964
2010,3147,2,27,135,1250,0.06896551724137931,-1115,0.09747292418772563
2010,3148,12,18,814,979,0.4,-165,0.4539877300613497
2010,3149,14,13,997,751,0.5185185185185185,246,0.5703661327231121
2010,3150,17,13,1144,737,0.5666666666666667,407,0.6081871345029239
2010,3151,24,8,1704,449,0.75,1255,0.791453785415699
2010,3152,10,18,701,1044,0.35714285714285715,-343,0.4017191977077364
2010,3153,12,17,784,860,0.41379310344827586,-76,0.4768856447688564
2010,3155,13,18,990,977,0.41935483870967744,13,0.5033045246568378
2010,3156,18,13,1268,798,0.5806451612903226,470,0.6137463697967086
2010,3157,14,12,845,576,0.5384615384615384,269,0.5946516537649542
2010,3158,19,11,1284,593,0.6333333333333333,691,0.6840703249866809
2010,3159,10,19,639,995,0.3448275862068966,-356,0.39106487148102814
2010,3160,13,17,968,1041,0.43333333333333335,-73,0.4818317570930811
2010,3161,12,17,838,921,0.41379310344827586,-83,0.4764070494599204
2010,3162,18,10,1236,603,0.6428571428571429,633,0.6721044045676998
2010,3163,33,0,2690,0,1.0,2690,1.0
2010,3164,8,19,519,986,0.2962962962962963,-467,0.34485049833887044
2010,3165,6,20,429,1060,0.23076923076923078,-631,0.28811282740094024
2010,3166,20,10,1352,589,0.6666666666666666,763,0.6965481710458526
2010,3167,16,12,1245,849,0.5714285714285714,396,0.5945558739255015
2010,3168,15,17,1137,1018,0.46875,119,0.5276102088167053
2010,3169,4,23,268,1381,0.14814814814814814,-1113,0.16252274105518497
2010,3170,14,15,1178,1104,0.4827586206896552,74,0.516213847502191
2010,3171,11,17,632,806,0.39285714285714285,-174,0.43949930458970793
2010,3172,13,15,958,899,0.4642857142857143,59,0.5158858373721056
2010,3173,24,7,1772,447,0.7741935483870968,1325,0.7985579089680036
2010,3174,21,11,1382,638,0.65625,744,0.6841584158415842
2010,3175,5,24,275,1091,0.1724137931034483,-816,0.20131771595900438
2010,3176,18,13,1174,767,0.5806451612903226,407,0.6048428645028336
2010,3177,21,11,1530,648,0.65625,882,0.7024793388429752
2010,3178,17,14,1151,754,0.5483870967741935,397,0.6041994750656168
2010,3179,15,15,1107,909,0.5,198,0.5491071428571429
2010,3180,17,13,1066,759,0.5666666666666667,307,0.5841095890410959
2010,3181,27,5,2000,291,0.84375,1709,0.8729812309035355
2010,3182,20,11,1383,600,0.6451612903225806,783,0.697428139183056
2010,3183,22,10,1568,642,0.6875,926,0.709502262443439
2010,3184,11,17,686,851,0.39285714285714285,-165,0.44632400780741704
2010,3185,20,8,1461,521,0.7142857142857143,940,0.7371342078708375
2010,3186,17,11,1162,651,0.6071428571428571,511,0.640926640926641
2010,3187,22,10,1730,570,0.6875,1160,0.7521739130434782
2010,3188,5,20,310,1115,0.2,-805,0.21754385964912282
2010,3189,10,19,688,1125,0.3448275862068966,-437,0.3794815223386652
2010,3190,23,8,1846,563,0.7419354838709677,1283,0.7662930676629307
2010,3191,4,26,306,1377,0.13333333333333333,-1071,0.18181818181818182
2010,3192,9,20,605,1061,0.3103448275862069,-456,0.3631452581032413
2010,3193,19,13,1174,694,0.59375,480,0.6284796573875803
2010,3194,13,15,951,903,0.4642857142857143,48,0.5129449838187702
2010,3195,24,6,1710,400,0.8,1310,0.8104265402843602
2010,3196,14,16,987,883,0.4666666666666667,104,0.5278074866310161
2010,3197,17,11,1110,584,0.6071428571428571,526,0.6552538370720189
2010,3198,13,16,874,885,0.4482758620689655,-11,0.4968732234223991
2010,3199,26,5,2025,292,0.8387096774193549,1733,0.8739749676305567
2010,3200,8,22,529,1149,0.26666666666666666,-620,0.31525625744934443
2010,3201,27,6,2070,354,0.8181818181818182,1716,0.8539603960396039
2010,3202,7,24,469,1261,0.22580645161290322,-792,0.27109826589595376
2010,3203,6,22,375,1160,0.21428571428571427,-785,0.24429967426710097
2010,3204,18,12,1165,580,0.6,585,0.667621776504298
2010,3205,26,4,1805,248,0.8666666666666667,1557,0.8792011690209449
2010,3206,10,20,648,965,0.3333333333333333,-317,0.40173589584624925
2010,3207,24,6,1697,344,0.8,1353,0.8314551690347869
2010,3208,23,8,1525,427,0.7419354838709677,1098,0.78125
2010,3209,15,15,986,780,0.5,206,0.5583238958097395
2010,3210,23,9,1611,508,0.71875,1103,0.760264275601699
2010,3211,27,4,2239,270,0.8709677419354839,1969,0.8923874053407732
2010,3212,12,15,765,795,0.4444444444444444,-30,0.49038461538461536
2010,3214,20,11,1318,634,0.6451612903225806,684,0.6752049180327869
2010,3216,27,4,1752,201,0.8709677419354839,1551,0.8970814132104454
2010,3217,20,8,1432,493,0.7142857142857143,939,0.7438961038961039
2010,3218,9,20,569,1170,0.3103448275862069,-601,0.3271995399654974
2010,3219,17,14,1261,799,0.5483870967741935,462,0.6121359223300971
2010,3220,19,13,1294,680,0.59375,614,0.6555217831813577
2010,3221,10,21,623,1218,0.3225806451612903,-595,0.33840304182509506
2010,3222,17,14,1274,893,0.5483870967741935,381,0.5879095523765574
2010,3224,16,14,925,779,0.5333333333333333,146,0.5428403755868545
2010,3225,11,20,756,1112,0.3548387096774194,-356,0.40471092077087795
2010,3226,13,15,870,820,0.4642857142857143,50,0.514792899408284
2010,3227,12,18,840,1044,0.4,-204,0.445859872611465
2010,3228,16,14,1046,786,0.5333333333333333,260,0.5709606986899564
2010,3229,24,7,1781,419,0.7741935483870968,1362,0.8095454545454546
2010,3231,14,16,968,1012,0.4666666666666667,-44,0.4888888888888889
2010,3232,17,14,1189,801,0.5483870967741935,388,0.5974874371859297
2010,3233,18,13,1229,768,0.5806451612903226,461,0.6154231347020531
2010,3234,19,13,1396,826,0.59375,570,0.6282628262826283
2010,3235,22,7,1500,414,0.7586206896551724,1086,0.7836990595611285
2010,3236,12,17,850,1018,0.41379310344827586,-168,0.4550321199143469
2010,3237,2,26,120,1317,0.07142857142857142,-1197,0.08350730688935282
2010,3238,6,22,377,1038,0.21428571428571427,-661,0.2664310954063604
2010,3239,9,20,561,1131,0.3103448275862069,-570,0.33156028368794327
2010,3240,8,20,520,1063,0.2857142857142857,-543,0.32849020846494
2010,3241,26,6,1909,375,0.8125,1534,0.8358143607705779
2010,3242,15,15,1145,883,0.5,262,0.564595660749507
2010,3243,14,18,934,1037,0.4375,-103,0.47387113140537795
2010,3244,11,19,726,1064,0.36666666666666664,-338,0.40558659217877097
2010,3245,20,10,1411,573,0.6666666666666666,838,0.7111895161290323
2010,3246,25,7,1948,417,0.78125,1531,0.8236786469344609
2010,3247,7,22,477,1026,0.2413793103448276,-549,0.31736526946107785
2010,3248,6,23,323,1053,0.20689655172413793,-730,0.23473837209302326
2010,3249,24,7,1878,429,0.7741935483870968,1449,0.8140442132639792
2010,3250,29,3,1919,187,0.90625,1732,0.9112060778727445
2010,3251,26,5,1764,289,0.8387096774193549,1475,0.859230394544569
2010,3252,5,25,337,1426,0.16666666666666666,-1089,0.1911514463981849
2010,3253,13,17,933,1082,0.43333333333333335,-149,0.4630272952853598
2010,3254,22,10,1536,642,0.6875,894,0.7052341597796143
2010,3255,9,20,637,1142,0.3103448275862069,-505,0.3580663293985385
2010,3256,23,8,1767,535,0.7419354838709677,1232,0.7675933970460469
2010,3257,14,17,1038,1037,0.45161290322580644,1,0.5002409638554217
2010,3258,13,17,899,1061,0.43333333333333335,-162,0.4586734693877551
2010,3259,14,16,923,910,0.4666666666666667,13,0.5035460992907801
2010,3260,14,15,961,825,0.4827586206896552,136,0.538073908174692
2010,3261,20,9,1442,570,0.6896551724137931,872,0.7166998011928429
2010,3263,8,21,521,1061,0.27586206896551724,-540,0.3293299620733249
2010,3264,15,15,1026,843,0.5,183,0.5489566613162119
2010,3265,26,7,1836,414,0.7878787878787878,1422,0.816
2010,3266,16,15,1076,823,0.5161290322580645,253,0.5666140073723012
2010,3267,14,16,952,851,0.4666666666666667,101,0.5280088740987243
2010,3268,19,12,1406,735,0.6129032258064516,671,0.6567024754787483
2010,3269,11,19,756,1020,0.36666666666666664,-264,0.42567567567567566
2010,3270,5,22,333,1314,0.18518518518518517,-981,0.20218579234972678
2010,3271,12,16,776,869,0.42857142857142855,-93,0.4717325227963526
2010,3272,17,13,1153,843,0.5666666666666667,310,0.5776553106212425
2010,3273,14,16,956,966,0.4666666666666667,-10,0.49739854318418314
2010,3274,17,13,1385,867,0.5666666666666667,518,0.6150088809946714
2010,3275,9,22,666,1378,0.2903225806451613,-712,0.3258317025440313
2010,3276,17,13,1201,764,0.5666666666666667,437,0.6111959287531806
2010,3277,22,9,1545,545,0.7096774193548387,1000,0.7392344497607656
2010,3278,13,17,954,931,0.43333333333333335,23,0.5061007957559682
2010,3279,17,14,1361,856,0.5483870967741935,505,0.613892647722147
2010,3280,19,12,1507,672,0.6129032258064516,835,0.6916016521340064
2010,3281,12,18,843,1014,0.4,-171,0.45395799676898224
2010,3282,16,15,1097,924,0.5161290322580645,173,0.5428005937654626
2010,3283,20,10,1594,713,0.6666666666666666,881,0.6909406155179887
2010,3284,16,14,1006,719,0.5333333333333333,287,0.5831884057971014
2010,3285,13,14,888,825,0.48148148148148145,63,0.5183887915936952
2010,3286,17,14,1320,897,0.5483870967741935,423,0.5953991880920162
2010,3287,21,10,1490,637,0.6774193548387096,853,0.7005171603196991
2010,3288,17,13,1163,742,0.5666666666666667,421,0.610498687664042
2010,3290,6,20,411,1103,0.23076923076923078,-692,0.2714663143989432
2010,3291,10,18,603,919,0.35714285714285715,-316,0.3961892247043364
2010,3292,25,5,2183,259,0.8333333333333334,1924,0.8939393939393939
2010,3293,12,17,907,1118,0.41379310344827586,-211,0.4479012345679012
2010,3294,12,16,835,928,0.42857142857142855,-93,0.47362450368689735
2010,3295,15,13,1024,751,0.5357142857142857,273,0.5769014084507043
2010,3296,10,19,741,1155,0.3448275862068966,-414,0.39082278481012656
2010,3298,17,14,1099,689,0.5483870967741935,410,0.6146532438478747
2010,3299,21,10,1610,606,0.6774193548387096,1004,0.7265342960288809
2010,3300,10,18,669,923,0.35714285714285715,-254,0.4202261306532663
2010,3301,20,13,1366,774,0.6060606060606061,592,0.6383177570093458
2010,3304,29,1,2252,70,0.9666666666666667,2182,0.9698535745047373
2010,3305,16,15,1109,861,0.5161290322580645,248,0.5629441624365482
2010,3306,9,22,627,1157,0.2903225806451613,-530,0.351457399103139
2010,3307,18,12,1281,637,0.6,644,0.6678832116788321
2010,3308,17,13,1210,837,0.5666666666666667,373,0.5911089399120665
2010,3309,12,20,730,1027,0.375,-297,0.41548093340922027
2010,3310,13,18,803,1021,0.41935483870967744,-218,0.44024122807017546
2010,3311,4,24,230,1356,0.14285714285714285,-1126,0.1450189155107188
2010,3312,10,16,685,820,0.38461538461538464,-135,0.45514950166112955
2010,3313,3,23,189,1240,0.11538461538461539,-1051,0.13226032190342898
2010,3314,19,11,1588,707,0.6333333333333333,881,0.6919389978213507
2010,3315,14,13,1003,737,0.5185185185185185,266,0.5764367816091954
2010,3316,12,20,739,1057,0.375,-318,0.41146993318485525
2010,3317,9,22,700,1325,0.2903225806451613,-625,0.345679012345679
2010,3318,13,18,894,1065,0.41935483870967744,-171,0.4563552833078101
2010,3319,5,24,358,1413,0.1724137931034483,-1055,0.20214568040654998
2010,3320,16,15,1142,955,0.5161290322580645,187,0.5445875059608966
2010,3321,16,14,1095,783,0.5333333333333333,312,0.5830670926517572
2010,3322,12,16,947,968,0.42857142857142855,-21,0.4945169712793734
2010,3323,27,5,2181,278,0.84375,1903,0.8869459129727532
2010,3324,15,13,1052,831,0.5357142857142857,221,0.5586829527349974
2010,3325,8,22,520,1203,0.26666666666666666,-683,0.3017991874637261
2010,3326,30,4,2389,258,0.8823529411764706,2131,0.9025311673592746
2010,3328,23,10,1763,603,0.696969696969697,1160,0.7451394759087067
2010,3329,23,10,1734,667,0.696969696969697,1067,0.7221990837151187
2010,3330,18,13,1186,791,0.5806451612903226,395,0.5998988366211432
2010,3331,22,9,1994,678,0.7096774193548387,1316,0.7462574850299402
2010,3332,16,15,1434,1088,0.5161290322580645,346,0.5685963521015067
2010,3333,11,20,700,1046,0.3548387096774194,-346,0.4009163802978236
2010,3334,6,23,457,1355,0.20689655172413793,-898,0.2522075055187638
2010,3335,2,26,96,1196,0.07142857142857142,-1100,0.07430340557275542
2010,3336,17,13,1214,772,0.5666666666666667,442,0.6112789526686808
2010,3337,20,11,1416,632,0.6451612903225806,784,0.69140625
2010,3338,16,14,1192,869,0.5333333333333333,323,0.5783600194080544
2010,3339,18,12,1367,723,0.6,644,0.654066985645933
2010,3340,16,14,1127,910,0.5333333333333333,217,0.5532646048109966
2010,3341,15,13,1087,732,0.5357142857142857,355,0.5975810885101704
2010,3342,4,25,230,1162,0.13793103448275862,-932,0.16522988505747127
2010,3343,26,2,1895,109,0.9285714285714286,1786,0.9456087824351297
2010,3344,16,14,1137,796,0.5333333333333333,341,0.5882048629073978
2010,3345,14,16,926,870,0.4666666666666667,56,0.5155902004454342
2010,3346,12,18,840,1024,0.4,-184,0.45064377682403434
2010,3347,5,22,315,1166,0.18518518518518517,-851,0.21269412559081702
2010,3348,9,20,519,1033,0.3103448275862069,-514,0.33440721649484534
2010,3349,13,17,904,1020,0.43333333333333335,-116,0.4698544698544699
2010,3350,19,12,1284,643,0.6129032258064516,641,0.666320705760249
2010,3351,4,26,250,1331,0.13333333333333333,-1081,0.15812776723592664
2010,3352,23,8,1609,465,0.7419354838709677,1144,0.7757955641272902
2010,3353,18,14,1076,741,0.5625,335,0.5921849201981287
2010,3354,14,19,913,1139,0.42424242424242425,-226,0.4449317738791423
2010,3355,21,10,1629,677,0.6774193548387096,952,0.7064180398959237
2010,3356,5,24,363,1414,0.1724137931034483,-1051,0.20427687113111986
2010,3357,19,11,1275,606,0.6333333333333333,669,0.6778309409888357
2010,3358,11,18,851,1227,0.3793103448275862,-376,0.4095283926852743
2010,3359,22,10,1462,569,0.6875,893,0.7198424421467258
2010,3360,14,14,953,836,0.5,117,0.5326998323085522
2010,3361,21,10,1435,592,0.6774193548387096,843,0.7079427725703009
2010,3362,5,26,325,1309,0.16129032258064516,-984,0.1988984088127295
2010,3363,6,23,416,1225,0.20689655172413793,-809,0.2535039609993906
2010,3364,15,17,1031,916,0.46875,115,0.529532614278377
2010,3365,4,26,270,1484,0.13333333333333333,-1214,0.15393386545039908
2010,3366,6,20,314,873,0.23076923076923078,-559,0.2645324347093513
2010,3367,19,9,1461,577,0.6785714285714286,884,0.7168792934249264
2010,3368,9,18,599,983,0.3333333333333333,-384,0.3786346396965866
2010,3369,5,21,285,1071,0.19230769230769232,-786,0.21017699115044247
2010,3370,3,22,197,1175,0.12,-978,0.14358600583090378
2010,3371,9,21,543,992,0.3,-449,0.3537459283387622
2010,3372,18,10,1500,705,0.6428571428571429,795,0.6802721088435374
2010,3373,11,18,660,962,0.3793103448275862,-302,0.406905055487053
2010,3374,20,10,1445,606,0.6666666666666666,839,0.704534373476353
2010,3375,14,16,980,923,0.4666666666666667,57,0.5149763531266421
2010,3376,14,15,942,932,0.4827586206896552,10,0.5026680896478122
2010,3378,15,15,1052,829,0.5,223,0.5592769803296119
2010,3379,8,21,575,1250,0.27586206896551724,-675,0.3150684931506849
2010,3380,22,8,1369,390,0.7333333333333333,979,0.778283115406481
2010,3381,7,23,477,1188,0.23333333333333334,-711,0.2864864864864865
2010,3382,22,9,1468,536,0.7096774193548387,932,0.7325349301397206
2010,3383,2,27,123,1288,0.06896551724137931,-1165,0.08717221828490432
2010,3384,17,14,1241,897,0.5483870967741935,344,0.5804490177736202
2010,3385,24,6,1758,359,0.8,1399,0.8304204062352385
2010,3386,17,14,1111,851,0.5483870967741935,260,0.5662589194699287
2010,3387,11,19,757,1108,0.36666666666666664,-351,0.4058981233243968
2010,3388,21,9,1508,582,0.7,926,0.7215311004784689
2010,3389,11,19,632,994,0.36666666666666664,-362,0.3886838868388684
2010,3390,31,1,2400,68,0.96875,2332,0.9724473257698542
2010,3391,6,23,367,1230,0.20689655172413793,-863,0.2298058860363181
2010,3392,10,20,659,1048,0.3333333333333333,-389,0.38605741066198007
2010,3393,22,10,1631,661,0.6875,970,0.7116055846422339
2010,3394,21,10,1557,597,0.6774193548387096,960,0.7228412256267409
2010,3395,22,8,1678,491,0.7333333333333333,1187,0.7736284001844168
2010,3396,24,8,1533,453,0.75,1080,0.7719033232628398
2010,3397,30,2,2269,102,0.9375,2167,0.956980177140447
2010,3398,9,18,603,1092,0.3333333333333333,-489,0.35575221238938054
2010,3399,13,16,950,942,0.4482758620689655,8,0.5021141649048626
2010,3400,22,10,1731,630,0.6875,1101,0.7331639135959339
2010,3401,25,7,2000,412,0.78125,1588,0.8291873963515755
2010,3402,3,20,191,1235,0.13043478260869565,-1044,0.13394109396914447
2010,3403,17,14,1213,800,0.5483870967741935,413,0.6025832091405862
2010,3404,11,19,705,890,0.36666666666666664,-185,0.44200626959247646
2010,3405,24,8,1699,524,0.75,1175,0.7642825011246064
2010,3406,15,15,931,750,0.5,181,0.553837001784652
2010,3407,11,17,746,1010,0.39285714285714285,-264,0.42482915717539865
2010,3408,26,6,1864,373,0.8125,1491,0.8332588287885561
2010,3409,12,16,861,935,0.42857142857142855,-74,0.47939866369710465
2010,3410,9,17,639,940,0.34615384615384615,-301,0.4046865104496517
2010,3411,13,18,866,970,0.41935483870967744,-104,0.47167755991285404
2010,3412,17,15,1088,895,0.53125,193,0.5486636409480585
2010,3413,21,10,1463,562,0.6774193548387096,901,0.7224691358024692
2010,3414,9,21,642,1266,0.3,-624,0.33647798742138363
2010,3415,17,15,1161,866,0.53125,295,0.5727676369018253
2010,3416,11,16,777,966,0.4074074074074074,-189,0.4457831325301205
2010,3417,24,8,1731,432,0.75,1299,0.8002773925104022
2010,3418,9,22,628,1299,0.2903225806451613,-671,0.3258951738453555
2010,3419,10,19,661,1049,0.3448275862068966,-388,0.3865497076023392
2010,3420,13,17,839,921,0.43333333333333335,-82,0.47670454545454544
2010,3421,6,21,381,1160,0.2222222222222222,-779,0.2472420506164828
2010,3422,10,20,677,1071,0.3333333333333333,-394,0.38729977116704806
2010,3423,12,19,794,1076,0.3870967741935484,-282,0.42459893048128344
2010,3424,13,18,891,1034,0.41935483870967744,-143,0.46285714285714286
2010,3425,19,12,1309,699,0.6129032258064516,610,0.6518924302788844
2010,3426,15,16,1145,935,0.4838709677419355,210,0.5504807692307693
2010,3427,15,14,1012,829,0.5172413793103449,183,0.5497012493210212
2010,3428,21,11,1312,564,0.65625,748,0.6993603411513859
2010,3429,12,17,764,933,0.41379310344827586,-169,0.45020624631703005
2010,3430,8,20,582,1080,0.2857142857142857,-498,0.35018050541516244
2010,3431,15,16,1046,910,0.4838709677419355,136,0.5347648261758691
2010,3433,20,12,1420,772,0.625,648,0.6478102189781022
2010,3434,8,21,543,1126,0.27586206896551724,-583,0.32534451767525463
2010,3435,22,10,1634,589,0.6875,1045,0.7350427350427351
2010,3436,26,6,1829,306,0.8125,1523,0.8566744730679157
2010,3437,14,16,787,786,0.4666666666666667,1,0.5003178639542276
2010,3438,21,9,1555,538,0.7,1017,0.7429526994744386
2010,3439,15,15,1060,802,0.5,258,0.569280343716434
2010,3441,7,23,451,1314,0.23333333333333334,-863,0.25552407932011334
2010,3442,9,20,512,899,0.3103448275862069,-387,0.3628632175761871
2010,3443,21,10,1545,594,0.6774193548387096,951,0.7223001402524544
2010,3444,9,21,605,1124,0.3,-519,0.3499132446500868
2010,3445,2,28,142,1288,0.06666666666666667,-1146,0.0993006993006993
2010,3447,9,21,614,1196,0.3,-582,0.3392265193370166
2010,3448,18,13,1191,709,0.5806451612903226,482,0.6268421052631579
2010,3449,12,17,797,949,0.41379310344827586,-152,0.45647193585337914
2010,3450,8,22,551,1300,0.26666666666666666,-749,0.2976769313884387
2010,3451,7,20,460,1173,0.25925925925925924,-713,0.28169014084507044
2010,3452,28,5,1826,262,0.8484848484848485,1564,0.8745210727969349
2010,3453,26,4,1912,265,0.8666666666666667,1647,0.8782728525493799
2010,3454,12,19,837,1048,0.3870967741935484,-211,0.4440318302387268
2010,3455,16,14,1089,807,0.5333333333333333,282,0.5743670886075949
2010,3456,12,18,794,1030,0.4,-236,0.43530701754385964
2010,3457,10,18,586,854,0.35714285714285715,-268,0.40694444444444444
2010,3458,21,10,1350,588,0.6774193548387096,762,0.6965944272445821
2010,3459,7,21,453,1217,0.25,-764,0.2712574850299401
2010,3460,11,19,689,1014,0.36666666666666664,-325,0.40458015267175573
2010,3461,17,11,1240,603,0.6071428571428571,637,0.672816060770483
2010,3462,27,3,1990,171,0.9,1819,0.9208699676075891
2010,3463,13,15,856,879,0.4642857142857143,-23,0.49337175792507204
2011,1102,14,14,994,805,0.5,189,0.5525291828793775
2011,1103,22,12,1625,754,0.6470588235294118,871,0.6830601092896175
2011,1104,21,11,1468,665,0.65625,803,0.6882325363338021
2011,1105,10,15,682,888,0.4,-206,0.43439490445859874
2011,1106,15,17,1040,930,0.46875,110,0.5279187817258884
2011,1107,16,16,1089,924,0.5,165,0.5409836065573771
2011,1108,4,24,309,1529,0.14285714285714285,-1220,0.16811751904243744
2011,1110,22,9,1539,512,0.7096774193548387,1027,0.750365675280351
2011,1111,14,15,1063,1010,0.4827586206896552,53,0.5127834056922335
2011,1112,27,7,2134,468,0.7941176470588235,1666,0.8201383551114527
2011,1113,12,19,831,1152,0.3870967741935484,-321,0.41906202723146746
2011,1114,17,16,1166,1021,0.5151515151515151,145,0.5331504343850023
2011,1115,7,24,503,1347,0.22580645161290322,-844,0.2718918918918919
2011,1116,18,13,1397,794,0.5806451612903226,603,0.6376083979917846
2011,1117,15,15,1059,924,0.5,135,0.5340393343419062
2011,1119,10,19,741,1231,0.3448275862068966,-490,0.3757606490872211
2011,1120,10,20,708,1147,0.3333333333333333,-439,0.3816711590296496
2011,1122,18,13,1340,877,0.5806451612903226,463,0.6044203879115922
2011,1123,18,12,1286,739,0.6,547,0.6350617283950617
2011,1124,17,13,1276,814,0.5666666666666667,462,0.6105263157894737
2011,1125,30,4,2451,281,0.8823529411764706,2170,0.8971449487554904
2011,1126,17,12,1192,680,0.5862068965517241,512,0.6367521367521367
2011,1127,8,23,575,1286,0.25806451612903225,-711,0.30897367006985493
2011,1129,19,12,1460,827,0.6129032258064516,633,0.6383909051158724
2011,1130,20,12,1545,746,0.625,799,0.6743780008729813
2011,1131,21,13,1422,795,0.6176470588235294,627,0.6414073071718539
2011,1132,13,19,915,1120,0.40625,-205,0.44963144963144963
2011,1133,11,20,766,1244,0.3548387096774194,-478,0.38109452736318405
2011,1135,10,17,787,1127,0.37037037037037035,-340,0.4111807732497388
2011,1136,8,21,573,1357,0.27586206896551724,-784,0.29689119170984457
2011,1137,25,8,1802,533,0.7575757575757576,1269,0.7717344753747324
2011,1138,17,13,1273,860,0.5666666666666667,413,0.596812001875293
2011,1139,22,9,1652,595,0.7096774193548387,1057,0.735202492211838
2011,1140,29,4,2408,274,0.8787878787878788,2134,0.8978374347501864
2011,1141,9,21,621,1157,0.3,-536,0.34926884139482567
2011,1142,15,14,952,780,0.5172413793103449,172,0.5496535796766744
2011,1143,17,14,1276,966,0.5483870967741935,310,0.5691347011596789
2011,1144,11,19,818,1137,0.36666666666666664,-319,0.4184143222506394
2011,1145,15,15,1068,975,0.5,93,0.5227606461086637
2011,1146,2,24,147,1569,0.07692307692307693,-1422,0.08566433566433566
2011,1147,1,27,73,1570,0.03571428571428571,-1497,0.044430919050517347
2011,1148,19,12,1396,774,0.6129032258064516,622,0.6433179723502304
2011,1149,12,16,925,1009,0.42857142857142855,-84,0.4782833505687694
2011,1150,10,20,698,1299,0.3333333333333333,-601,0.34952428642964445
2011,1151,14,16,1079,999,0.4666666666666667,80,0.5192492781520693
2011,1152,4,25,295,1590,0.13793103448275862,-1295,0.15649867374005305
2011,1153,25,8,1824,452,0.7575757575757576,1372,0.8014059753954306
2011,1154,8,22,568,1342,0.26666666666666666,-774,0.2973821989528796
2011,1155,21,11,1476,708,0.65625,768,0.6758241758241759
2011,1156,24,8,1730,530,0.75,1200,0.7654867256637168
2011,1157,24,5,1851,290,0.8275862068965517,1561,0.864549276039234
2011,1158,24,10,1920,668,0.7058823529411765,1252,0.7418856259659969
2011,1159,7,23,574,1373,0.23333333333333334,-799,0.2948125321006677
2011,1160,20,13,1667,947,0.6060606060606061,720,0.6377199693955623
2011,1161,18,12,1328,797,0.6,531,0.6249411764705882
2011,1162,14,13,1072,846,0.5185185185185185,226,0.5589155370177268
2011,1163,26,9,1980,589,0.7428571428571429,1391,0.7707279096924874
2011,1164,13,14,1001,947,0.48148148148148145,54,0.5138603696098563
2011,1165,10,18,772,1134,0.35714285714285715,-362,0.4050367261280168
2011,1166,19,14,1338,866,0.5757575757575758,472,0.6070780399274047
2011,1167,9,19,708,1199,0.32142857142857145,-491,0.37126376507603565
2011,1168,10,20,775,1357,0.3333333333333333,-582,0.36350844277673544
2011,1169,12,18,910,1138,0.4,-228,0.4443359375
2011,1170,5,21,339,1241,0.19230769230769232,-902,0.21455696202531646
2011,1171,5,23,353,1314,0.17857142857142858,-961,0.21175764847030593
2011,1172,16,14,1173,934,0.5333333333333333,239,0.5567157095396298
2011,1173,22,13,1564,765,0.6285714285714286,799,0.6715328467153284
2011,1174,14,17,894,1057,0.45161290322580644,-163,0.4582265504869298
2011,1175,7,21,482,1226,0.25,-744,0.2822014051522248
2011,1176,13,17,911,889,0.43333333333333335,22,0.5061111111111111
2011,1177,7,24,563,1541,0.22580645161290322,-978,0.2675855513307985
2011,1178,16,16,1276,1090,0.5,186,0.5393068469991547
2011,1179,13,18,954,1043,0.41935483870967744,-89,0.47771657486229346
2011,1180,21,10,1403,572,0.6774193548387096,831,0.710379746835443
2011,1181,30,4,2490,266,0.8823529411764706,2224,0.9034833091436865
2011,1182,17,12,1419,803,0.5862068965517241,616,0.6386138613861386
2011,1183,7,20,436,1176,0.25925925925925924,-740,0.2704714640198511
2011,1184,13,16,908,952,0.4482758620689655,-44,0.4881720430107527
2011,1185,6,22,382,1287,0.21428571428571427,-905,0.22887956860395448
2011,1186,8,20,606,1209,0.2857142857142857,-603,0.3338842975206612
2011,1187,15,15,1098,919,0.5,179,0.5443728309370351
2011,1188,4,21,308,1247,0.16,-939,0.19807073954983923
2011,1189,11,17,876,1148,0.39285714285714285,-272,0.43280632411067194
2011,1190,21,11,1546,628,0.65625,918,0.7111315547378105
2011,1191,14,15,1018,876,0.4827586206896552,142,0.5374868004223865
2011,1192,5,24,369,1497,0.1724137931034483,-1128,0.1977491961414791
2011,1193,24,7,1598,422,0.7741935483870968,1176,0.7910891089108911
2011,1194,19,10,1329,618,0.6551724137931034,711,0.6825885978428351
2011,1195,10,20,747,1223,0.3333333333333333,-476,0.37918781725888323
2011,1196,26,7,1909,452,0.7878787878787878,1457,0.80855569673867
2011,1197,8,20,484,1239,0.2857142857142857,-755,0.2809053975623912
2011,1198,9,19,670,1322,0.32142857142857145,-652,0.33634538152610444
2011,1199,21,10,1575,574,0.6774193548387096,1001,0.7328990228013029
2011,1200,7,21,518,1277,0.25,-759,0.2885793871866295
2011,1201,13,17,989,1033,0.43333333333333335,-44,0.48911968348170126
2011,1202,20,10,1459,595,0.6666666666666666,864,0.7103213242453749
2011,1203,17,14,1210,801,0.5483870967741935,409,0.6016907011437096
2011,1204,2,27,139,1673,0.06896551724137931,-1534,0.07671081677704195
2011,1205,9,21,601,1230,0.3,-629,0.3282359366466412
2011,1206,26,6,1934,413,0.8125,1521,0.824030677460588
2011,1207,21,10,1632,570,0.6774193548387096,1062,0.7411444141689373
2011,1208,21,11,1496,706,0.65625,790,0.6793823796548593
2011,1209,12,19,849,1070,0.3870967741935484,-221,0.4424179260031266
2011,1210,13,18,933,1169,0.41935483870967744,-236,0.44386298763082777
2011,1211,23,9,1798,630,0.71875,1168,0.7405271828665568
2011,1212,12,21,822,1176,0.36363636363636365,-354,0.4114114114114114
2011,1214,23,8,1584,490,0.7419354838709677,1094,0.76374156219865
2011,1216,11,20,720,1137,0.3548387096774194,-417,0.3877221324717286
2011,1217,21,6,1578,359,0.7777777777777778,1219,0.8146618482188952
2011,1218,17,12,1235,759,0.5862068965517241,476,0.619358074222668
2011,1219,10,19,722,1152,0.3448275862068966,-430,0.3852721451440768
2011,1220,20,11,1488,675,0.6451612903225806,813,0.6879334257975035
2011,1221,8,21,607,1342,0.27586206896551724,-735,0.31144176500769627
2011,1222,10,18,732,1163,0.35714285714285715,-431,0.3862796833773087
2011,1223,5,24,408,1601,0.1724137931034483,-1193,0.203086112493778
2011,1224,6,24,394,1359,0.2,-965,0.22475755847119225
2011,1225,17,13,1192,821,0.5666666666666667,371,0.5921510183805265
2011,1226,7,20,531,1200,0.25925925925925924,-669,0.30675909878682844
2011,1227,6,24,397,1452,0.2,-1055,0.214710654407788
2011,1228,19,13,1452,829,0.59375,623,0.6365629110039457
2011,1229,12,19,808,1085,0.3870967741935484,-277,0.42683571051241415
2011,1231,12,20,926,1300,0.375,-374,0.4159928122192273
2011,1232,19,13,1280,827,0.59375,453,0.6074988134788799
2011,1233,22,11,1827,780,0.6666666666666666,1047,0.7008055235903338
2011,1234,11,20,785,1299,0.3548387096774194,-514,0.376679462571977
2011,1235,16,16,1288,1107,0.5,181,0.5377870563674322
2011,1236,17,12,1347,778,0.5862068965517241,569,0.6338823529411765
2011,1237,17,14,1293,885,0.5483870967741935,408,0.59366391184573
2011,1238,15,15,1064,871,0.5,193,0.5498708010335918
2011,1239,18,11,1254,702,0.6206896551724138,552,0.6411042944785276
2011,1240,4,25,261,1488,0.13793103448275862,-1227,0.14922813036020582
2011,1241,21,11,1554,736,0.65625,818,0.6786026200873363
2011,1242,32,2,2670,131,0.9411764705882353,2539,0.9532309889325241
2011,1243,21,10,1643,611,0.6774193548387096,1032,0.7289263531499557
2011,1244,7,23,516,1419,0.23333333333333334,-903,0.26666666666666666
2011,1245,22,11,1614,701,0.6666666666666666,913,0.6971922246220302
2011,1246,25,8,1956,566,0.7575757575757576,1390,0.7755749405233942
2011,1247,15,18,1212,1324,0.45454545454545453,-112,0.47791798107255523
2011,1248,12,19,925,1217,0.3870967741935484,-292,0.43183940242763774
2011,1249,9,17,784,1209,0.34615384615384615,-425,0.3933768188660311
2011,1250,16,15,1249,1033,0.5161290322580645,216,0.5473269062226117
2011,1251,16,13,1129,788,0.5517241379310345,341,0.5889410537297861
2011,1252,16,13,1341,843,0.5517241379310345,498,0.614010989010989
2011,1253,20,11,1479,764,0.6451612903225806,715,0.659384752563531
2011,1254,27,5,2294,349,0.84375,1945,0.8679530836171018
2011,1255,8,19,667,1270,0.2962962962962963,-603,0.3443469282395457
2011,1256,11,20,771,1190,0.3548387096774194,-419,0.3931667516573177
2011,1257,25,9,1984,578,0.7352941176470589,1406,0.7743950039032006
2011,1258,9,21,677,1410,0.3,-733,0.3243890752275994
2011,1259,15,15,1113,910,0.5,203,0.5501730103806228
2011,1260,16,15,1212,941,0.5161290322580645,271,0.5629354389224338
2011,1261,11,21,798,1193,0.34375,-395,0.4008036162732295
2011,1263,14,15,1008,986,0.4827586206896552,22,0.5055165496489469
2011,1264,6,25,393,1469,0.1935483870967742,-1076,0.21106337271750805
2011,1265,6,27,416,1563,0.18181818181818182,-1147,0.21020717534108135
2011,1266,20,14,1627,960,0.5882352941176471,667,0.6289137997680712
2011,1267,20,11,1540,710,0.6451612903225806,830,0.6844444444444444
2011,1268,19,14,1577,959,0.5757575757575758,618,0.6218454258675079
2011,1269,14,15,987,918,0.4827586206896552,69,0.5181102362204725
2011,1270,17,11,1293,717,0.6071428571428571,576,0.6432835820895523
2011,1271,7,22,566,1342,0.2413793103448276,-776,0.2966457023060797
2011,1272,25,9,1879,570,0.7352941176470589,1309,0.7672519395671703
2011,1273,14,18,962,1191,0.4375,-229,0.44681839294008363
2011,1274,19,14,1456,893,0.5757575757575758,563,0.6198382290336313
2011,1275,15,16,1133,922,0.4838709677419355,211,0.551338199513382
2011,1276,19,13,1356,740,0.59375,616,0.6469465648854962
2011,1277,18,14,1337,843,0.5625,494,0.613302752293578
2011,1278,17,14,1264,873,0.5483870967741935,391,0.5914833879270005
2011,1279,20,13,1558,881,0.6060606060606061,677,0.6387863878638786
2011,1280,17,14,1241,924,0.5483870967741935,317,0.5732101616628176
2011,1281,22,10,1841,746,0.6875,1095,0.7116350985697719
2011,1282,15,14,1096,933,0.5172413793103449,163,0.5401675702316412
2011,1283,25,8,1791,492,0.7575757575757576,1299,0.7844940867279895
2011,1284,9,21,602,1216,0.3,-614,0.3311331133113311
2011,1285,19,10,1352,560,0.6551724137931034,792,0.7071129707112971
2011,1286,11,18,805,1088,0.3793103448275862,-283,0.4252509244585314
2011,1287,22,9,1624,511,0.7096774193548387,1113,0.760655737704918
2011,1288,17,14,1186,875,0.5483870967741935,311,0.5754488112566715
2011,1290,13,19,1039,1147,0.40625,-108,0.47529734675205854
2011,1291,11,21,731,1209,0.34375,-478,0.3768041237113402
2011,1292,15,16,1084,1044,0.4838709677419355,40,0.5093984962406015
2011,1293,21,8,1470,470,0.7241379310344828,1000,0.7577319587628866
2011,1294,19,10,1398,662,0.6551724137931034,736,0.6786407766990291
2011,1295,12,15,939,1058,0.4444444444444444,-119,0.47020530796194293
2011,1296,8,21,611,1363,0.27586206896551724,-752,0.30952380952380953
2011,1298,10,20,766,1273,0.3333333333333333,-507,0.3756743501716528
2011,1299,12,17,935,1092,0.41379310344827586,-157,0.46127281697089295
2011,1300,11,15,809,906,0.4230769230769231,-97,0.4717201166180758
2011,1301,15,16,1175,1016,0.4838709677419355,159,0.5362848014605203
2011,1304,19,12,1322,753,0.6129032258064516,569,0.6371084337349397
2011,1305,12,19,960,1207,0.3870967741935484,-247,0.44300876788186433
2011,1306,11,18,700,970,0.3793103448275862,-270,0.41916167664670656
2011,1307,20,12,1540,808,0.625,732,0.65587734241908
2011,1308,14,17,1077,1114,0.45161290322580644,-37,0.49155636695572796
2011,1310,9,23,598,1368,0.28125,-770,0.3041709053916582
2011,1311,10,14,687,802,0.4166666666666667,-115,0.4613834788448623
2011,1312,11,15,805,946,0.4230769230769231,-141,0.4597372929754426
2011,1313,12,20,906,1332,0.375,-426,0.40482573726541554
2011,1314,26,7,2066,464,0.7878787878787878,1602,0.8166007905138339
2011,1315,15,14,1129,820,0.5172413793103449,309,0.5792714212416624
2011,1316,15,19,1052,1156,0.4411764705882353,-104,0.47644927536231885
2011,1317,20,11,1584,757,0.6451612903225806,827,0.6766339171294319
2011,1318,11,20,836,1228,0.3548387096774194,-392,0.4050387596899225
2011,1319,17,12,1236,812,0.5862068965517241,424,0.603515625
2011,1320,18,13,1201,748,0.5806451612903226,453,0.616213442791175
2011,1321,18,13,1434,786,0.5806451612903226,648,0.6459459459459459
2011,1322,16,13,1284,938,0.5517241379310345,346,0.5778577857785778
2011,1323,26,6,2070,362,0.8125,1708,0.8511513157894737
2011,1324,24,9,2148,660,0.7272727272727273,1488,0.7649572649572649
2011,1325,18,15,1408,1058,0.5454545454545454,350,0.5709651257096513
2011,1326,32,2,2491,130,0.9411764705882353,2361,0.9504006104540251
2011,1328,14,17,1042,1005,0.45161290322580644,37,0.509037616023449
2011,1329,19,13,1421,762,0.59375,659,0.6509390746678883
2011,1330,27,6,1837,336,0.8181818181818182,1501,0.8453750575241602
2011,1331,19,15,1509,1049,0.5588235294117647,460,0.589913995308835
2011,1332,15,17,1097,1098,0.46875,-1,0.4997722095671982
2011,1333,11,20,861,1286,0.3548387096774194,-425,0.4010246856078249
2011,1334,14,15,989,890,0.4827586206896552,99,0.5263437998935604
2011,1335,13,15,921,947,0.4642857142857143,-26,0.4930406852248394
2011,1336,19,14,1215,865,0.5757575757575758,350,0.5841346153846154
2011,1337,11,21,842,1358,0.34375,-516,0.38272727272727275
2011,1338,27,5,2051,319,0.84375,1732,0.8654008438818566
2011,1339,20,11,1488,720,0.6451612903225806,768,0.6739130434782609
2011,1340,13,16,1047,1030,0.4482758620689655,17,0.5040924410207029
2011,1341,7,22,494,1262,0.2413793103448276,-768,0.28132118451025057
2011,1342,13,18,897,1018,0.41935483870967744,-121,0.46840731070496083
2011,1343,24,6,1700,385,0.8,1315,0.815347721822542
2011,1344,15,17,1195,1231,0.46875,-36,0.4925803792250618
2011,1345,25,7,1896,429,0.78125,1467,0.8154838709677419
2011,1346,22,9,1602,625,0.7096774193548387,977,0.7193533902110463
2011,1347,2,24,131,1377,0.07692307692307693,-1246,0.08687002652519894
2011,1348,19,13,1375,811,0.59375,564,0.6290027447392498
2011,1349,12,18,840,1170,0.4,-330,0.417910447761194
2011,1350,27,7,1935,451,0.7941176470588235,1484,0.8109807208717519
2011,1351,23,10,1789,647,0.696969696969697,1142,0.7344006568144499
2011,1352,18,14,1267,886,0.5625,381,0.5884811890385508
2011,1353,15,17,1061,1061,0.46875,0,0.5
2011,1354,6,22,425,1367,0.21428571428571427,-942,0.23716517857142858
2011,1355,17,12,1439,916,0.5862068965517241,523,0.6110403397027601
2011,1356,13,19,865,1088,0.40625,-223,0.4429083461341526
2011,1357,11,18,810,1112,0.3793103448275862,-302,0.4214360041623309
2011,1358,14,13,1033,848,0.5185185185185185,185,0.5491759702286018
2011,1359,10,19,664,1079,0.3448275862068966,-415,0.38095238095238093
2011,1360,4,24,283,1378,0.14285714285714285,-1095,0.1703792895845876
2011,1361,30,2,2148,125,0.9375,2023,0.945006599208095
2011,1362,15,14,1119,859,0.5172413793103449,260,0.5657229524772498
2011,1363,16,15,1218,1004,0.5161290322580645,214,0.5481548154815482
2011,1364,16,13,1155,813,0.5517241379310345,342,0.586890243902439
2011,1365,17,14,1320,919,0.5483870967741935,401,0.5895489057615007
2011,1366,8,18,510,958,0.3076923076923077,-448,0.3474114441416894
2011,1367,5,25,354,1392,0.16666666666666666,-1038,0.2027491408934708
2011,1368,12,14,921,809,0.46153846153846156,112,0.5323699421965318
2011,1369,9,22,662,1354,0.2903225806451613,-692,0.32837301587301587
2011,1370,11,20,751,1387,0.3548387096774194,-636,0.35126286248830685
2011,1371,13,18,1045,1047,0.41935483870967744,-2,0.49952198852772467
2011,1372,14,11,974,590,0.56,384,0.6227621483375959
2011,1373,13,18,924,1179,0.41935483870967744,-255,0.43937232524964337
2011,1374,14,14,968,838,0.5,130,0.5359911406423035
2011,1375,10,16,779,1019,0.38461538461538464,-240,0.43325917686318133
2011,1376,14,16,1051,976,0.4666666666666667,75,0.5185002466699556
2011,1377,14,15,1184,1052,0.4827586206896552,132,0.5295169946332737
2011,1378,10,23,701,1343,0.30303030303030304,-642,0.3429549902152642
2011,1379,19,10,1445,668,0.6551724137931034,777,0.6838618078561287
2011,1380,3,24,180,1331,0.1111111111111111,-1151,0.11912640635340833
2011,1381,10,18,729,1211,0.35714285714285715,-482,0.37577319587628866
2011,1382,16,14,1215,887,0.5333333333333333,328,0.5780209324452902
2011,1383,15,15,1062,940,0.5,122,0.5304695304695305
2011,1384,9,21,686,1271,0.3,-585,0.35053653551354114
2011,1385,21,11,1536,706,0.65625,830,0.6851025869759143
2011,1386,11,22,786,1343,0.3333333333333333,-557,0.3691874119304838
2011,1387,11,19,762,1119,0.36666666666666664,-357,0.405103668261563
2011,1388,23,8,1880,547,0.7419354838709677,1333,0.7746188710341986
2011,1389,20,13,1320,706,0.6060606060606061,614,0.6515301085883515
2011,1390,15,16,1097,961,0.4838709677419355,136,0.533041788143829
2011,1391,8,22,586,1345,0.26666666666666666,-759,0.3034697048161574
2011,1392,14,17,916,955,0.45161290322580644,-39,0.48957776590058794
2011,1393,26,7,1957,472,0.7878787878787878,1485,0.8056813503499383
2011,1394,7,21,499,1202,0.25,-703,0.2933568489124045
2011,1395,11,22,906,1314,0.3333333333333333,-408,0.4081081081081081
2011,1396,25,7,1837,433,0.78125,1404,0.809251101321586
2011,1397,19,14,1413,918,0.5757575757575758,495,0.6061776061776062
2011,1398,12,16,822,1053,0.42857142857142855,-231,0.4384
2011,1399,17,12,1290,813,0.5862068965517241,477,0.6134094151212554
2011,1400,27,7,2045,502,0.7941176470588235,1543,0.8029053788771103
2011,1401,23,8,1671,456,0.7419354838709677,1215,0.7856135401974612
2011,1402,14,15,1096,1115,0.4827586206896552,-19,0.49570330167345095
2011,1403,13,19,1047,1295,0.40625,-248,0.4470538001707942
2011,1404,10,21,722,1385,0.3225806451612903,-663,0.34266729947793073
2011,1405,3,28,223,1550,0.0967741935483871,-1327,0.125775521714608
2011,1406,4,26,343,1710,0.13333333333333333,-1367,0.16707257671699952
2011,1407,7,21,552,1424,0.25,-872,0.2793522267206478
2011,1408,10,17,808,1010,0.37037037037037035,-202,0.4444444444444444
2011,1409,19,13,1415,840,0.59375,575,0.6274944567627494
2011,1410,3,25,218,1623,0.10714285714285714,-1405,0.11841390548614883
2011,1411,19,12,1278,704,0.6129032258064516,574,0.644803229061554
2011,1412,22,8,1539,528,0.7333333333333333,1011,0.7445573294629898
2011,1413,8,20,659,1327,0.2857142857142857,-668,0.33182275931520644
2011,1414,12,19,981,1331,0.3870967741935484,-350,0.42430795847750863
2011,1415,10,19,749,1120,0.3448275862068966,-371,0.40074906367041196
2011,1416,18,11,1265,692,0.6206896551724138,573,0.6463975472662238
2011,1417,22,10,1568,671,0.6875,897,0.7003126395712371
2011,1418,13,14,969,921,0.48148148148148145,48,0.5126984126984127
2011,1419,5,24,344,1358,0.1724137931034483,-1014,0.20211515863689777
2011,1420,5,25,380,1548,0.16666666666666666,-1168,0.1970954356846473
2011,1421,16,13,1189,893,0.5517241379310345,296,0.5710854947166186
2011,1422,7,24,544,1660,0.22580645161290322,-1116,0.24682395644283123
2011,1423,13,18,910,1065,0.41935483870967744,-155,0.4607594936708861
2011,1424,24,8,1788,513,0.75,1275,0.7770534550195567
2011,1425,19,14,1307,899,0.5757575757575758,408,0.5924750679963735
2011,1426,9,16,653,1063,0.36,-410,0.38053613053613056
2011,1427,16,13,1178,866,0.5517241379310345,312,0.576320939334638
2011,1428,12,18,884,1122,0.4,-238,0.4406779661016949
2011,1429,29,3,2102,179,0.90625,1923,0.9215256466462078
2011,1430,15,11,1200,718,0.5769230769230769,482,0.6256517205422315
2011,1431,24,9,1710,616,0.7272727272727273,1094,0.7351676698194325
2011,1433,23,11,1726,706,0.6764705882352942,1020,0.709703947368421
2011,1434,21,11,1577,701,0.65625,876,0.6922739244951712
2011,1435,23,10,1825,690,0.696969696969697,1135,0.7256461232604374
2011,1436,23,8,1593,494,0.7419354838709677,1099,0.7632965979875419
2011,1437,21,11,1613,714,0.65625,899,0.6931671680275032
2011,1438,16,15,1070,848,0.5161290322580645,222,0.5578727841501564
2011,1439,21,11,1598,637,0.65625,961,0.7149888143176734
2011,1440,14,13,1224,1031,0.5185185185185185,193,0.5427937915742794
2011,1441,17,15,1264,942,0.53125,322,0.5729827742520399
2011,1442,4,23,252,1257,0.14814814814814814,-1005,0.16699801192842942
2011,1443,16,16,1190,1052,0.5,138,0.5307760927743087
2011,1444,19,12,1386,823,0.6129032258064516,563,0.6274332277048438
2011,1447,13,17,952,1077,0.43333333333333335,-125,0.4691966485953672
2011,1448,8,24,608,1543,0.25,-935,0.2826592282659228
2011,1449,23,10,2073,683,0.696969696969697,1390,0.752177068214804
2011,1450,19,12,1496,782,0.6129032258064516,714,0.6567164179104478
2011,1451,15,13,1122,785,0.5357142857142857,337,0.5883586785527006
2011,1452,20,11,1453,703,0.6451612903225806,750,0.6739332096474954
2011,1453,13,18,945,1134,0.41935483870967744,-189,0.45454545454545453
2011,1454,19,13,1471,734,0.59375,737,0.6671201814058957
2011,1455,23,8,1717,516,0.7419354838709677,1201,0.7689207344379758
2011,1456,9,22,650,1329,0.2903225806451613,-679,0.32844871147043964
2011,1457,11,17,764,1074,0.39285714285714285,-310,0.41566920565832427
2011,1458,23,8,1664,450,0.7419354838709677,1214,0.7871333964049196
2011,1459,21,12,1644,792,0.6363636363636364,852,0.6748768472906403
2011,1460,17,14,1166,822,0.5483870967741935,344,0.5865191146881288
2011,1461,8,21,557,1315,0.27586206896551724,-758,0.29754273504273504
2011,1462,24,7,1833,418,0.7741935483870968,1415,0.8143047534429143
2011,1463,14,13,1045,778,0.5185185185185185,267,0.5732309380142622
2011,1464,7,21,508,1400,0.25,-892,0.2662473794549266
2011,3102,8,22,558,1257,0.26666666666666666,-699,0.3074380165289256
2011,3103,13,16,959,927,0.4482758620689655,32,0.5084835630965006
2011,3104,16,14,1211,757,0.5333333333333333,454,0.6153455284552846
2011,3105,13,14,783,808,0.48148148148148145,-25,0.49214330609679446
2011,3106,6,22,354,1100,0.21428571428571427,-746,0.24346629986244842
2011,3107,16,14,991,663,0.5333333333333333,328,0.5991535671100363
2011,3108,13,15,871,790,0.4642857142857143,81,0.5243829018663456
2011,3110,22,9,1452,445,0.7096774193548387,1007,0.7654190827622562
2011,3111,25,6,1903,381,0.8064516129032258,1522,0.8331873905429071
2011,3112,21,11,1631,707,0.65625,924,0.6976047904191617
2011,3113,20,10,1288,537,0.6666666666666666,751,0.7057534246575342
2011,3114,23,7,1407,349,0.7666666666666667,1058,0.80125284738041
2011,3115,1,28,65,1474,0.034482758620689655,-1409,0.04223521767381416
2011,3116,19,11,1265,648,0.6333333333333333,617,0.6612650287506534
2011,3117,17,14,1100,727,0.5483870967741935,373,0.60207991242474
2011,3119,12,16,691,790,0.42857142857142855,-99,0.4665766374071573
2011,3120,15,15,1036,798,0.5,238,0.5648854961832062
2011,3122,15,18,1015,1026,0.45454545454545453,-11,0.4973052425281725
2011,3123,9,21,623,1256,0.3,-633,0.3315593400745077
2011,3124,31,2,2533,109,0.9393939393939394,2424,0.9587433762301287
2011,3125,11,20,693,1102,0.3548387096774194,-409,0.3860724233983287
2011,3126,10,16,600,804,0.38461538461538464,-204,0.42735042735042733
2011,3127,19,12,1173,588,0.6129032258064516,585,0.666098807495741
2011,3129,11,19,824,1168,0.36666666666666664,-344,0.41365461847389556
2011,3130,18,12,1532,820,0.6,712,0.6513605442176871
2011,3131,17,14,1171,776,0.5483870967741935,395,0.6014381099126862
2011,3132,28,4,2088,225,0.875,1863,0.9027237354085603
2011,3133,15,16,1060,949,0.4838709677419355,111,0.5276256844201095
2011,3135,10,18,614,917,0.35714285714285715,-303,0.40104506858262573
2011,3136,10,19,639,1056,0.3448275862068966,-417,0.3769911504424779
2011,3137,11,17,649,868,0.39285714285714285,-219,0.4278180619644034
2011,3138,16,15,1133,915,0.5161290322580645,218,0.55322265625
2011,3139,19,13,1365,796,0.59375,569,0.6316520129569644
2011,3140,22,8,1587,440,0.7333333333333333,1147,0.7829304390725209
2011,3141,20,10,1704,731,0.6666666666666666,973,0.6997946611909651
2011,3142,18,12,1325,733,0.6,592,0.6438289601554907
2011,3143,17,15,1210,788,0.53125,422,0.6056056056056056
2011,3144,13,17,973,1006,0.43333333333333335,-33,0.49166245578575035
2011,3145,11,20,685,975,0.3548387096774194,-290,0.4126506024096386
2011,3146,17,11,1251,682,0.6071428571428571,569,0.6471805483704087
2011,3147,1,24,75,1322,0.04,-1247,0.05368647100930565
2011,3148,19,11,1148,560,0.6333333333333333,588,0.6721311475409836
2011,3149,11,16,796,917,0.4074074074074074,-121,0.46468184471687096
2011,3150,23,9,1650,583,0.71875,1067,0.7389162561576355
2011,3151,17,14,1249,822,0.5483870967741935,427,0.6030902945436987
2011,3152,20,9,1537,544,0.6896551724137931,993,0.7385872176838059
2011,3153,8,20,502,965,0.2857142857142857,-463,0.3421949556918882
2011,3155,10,20,727,1069,0.3333333333333333,-342,0.40478841870824056
2011,3156,19,11,1329,634,0.6333333333333333,695,0.6770249617931737
2011,3157,7,19,383,932,0.2692307692307692,-549,0.29125475285171104
2011,3158,9,19,484,979,0.32142857142857145,-495,0.3308270676691729
2011,3159,7,22,484,1237,0.2413793103448276,-753,0.2812318419523533
2011,3160,14,15,944,802,0.4827586206896552,142,0.5406643757159221
2011,3161,14,16,968,844,0.4666666666666667,124,0.5342163355408388
2011,3162,7,21,451,1102,0.25,-651,0.2904056664520283
2011,3163,32,1,2505,59,0.9696969696969697,2446,0.9769890795631825
2011,3164,12,17,817,941,0.41379310344827586,-124,0.46473265073947667
2011,3165,4,22,245,1079,0.15384615384615385,-834,0.18504531722054382
2011,3166,18,12,1188,679,0.6,509,0.6363149437600428
2011,3167,17,11,1317,770,0.6071428571428571,547,0.6310493531384763
2011,3168,9,21,654,1304,0.3,-650,0.33401430030643514
2011,3169,4,26,295,1424,0.13333333333333333,-1129,0.17161140197789412
2011,3170,4,25,323,1713,0.13793103448275862,-1390,0.15864440078585462
2011,3171,7,21,457,1052,0.25,-595,0.3028495692511597
2011,3172,14,17,966,947,0.45161290322580644,19,0.5049660219550445
2011,3173,21,11,1685,697,0.65625,988,0.7073887489504618
2011,3174,20,13,1309,722,0.6060606060606061,587,0.6445100935499753
2011,3175,8,20,536,914,0.2857142857142857,-378,0.3696551724137931
2011,3176,19,11,1345,607,0.6333333333333333,738,0.6890368852459017
2011,3177,27,6,2091,365,0.8181818181818182,1726,0.8513843648208469
2011,3178,12,18,790,1025,0.4,-235,0.43526170798898073
2011,3179,15,15,1071,878,0.5,193,0.5495125705489995
2011,3180,19,12,1206,678,0.6129032258064516,528,0.6401273885350318
2011,3181,29,3,2109,158,0.90625,1951,0.9303043670048522
2011,3182,22,8,1601,480,0.7333333333333333,1121,0.7693416626621816
2011,3183,18,12,1347,747,0.6,600,0.6432664756446992
2011,3184,4,21,309,1202,0.16,-893,0.20450033090668432
2011,3185,22,12,1617,690,0.6470588235294118,927,0.7009102730819246
2011,3186,11,18,816,1113,0.3793103448275862,-297,0.4230171073094868
2011,3187,15,15,1064,1014,0.5,50,0.5120307988450433
2011,3188,11,19,716,1113,0.36666666666666664,-397,0.391470749043193
2011,3189,17,12,1174,762,0.5862068965517241,412,0.606404958677686
2011,3190,19,12,1512,723,0.6129032258064516,789,0.676510067114094
2011,3191,8,22,532,1182,0.26666666666666666,-650,0.3103850641773629
2011,3192,14,16,879,831,0.4666666666666667,48,0.5140350877192983
2011,3193,17,13,1041,619,0.5666666666666667,422,0.6271084337349397
2011,3194,6,21,393,1167,0.2222222222222222,-774,0.2519230769230769
2011,3195,27,3,1961,178,0.9,1783,0.916783543712015
2011,3196,18,14,1267,854,0.5625,413,0.5973597359735974
2011,3197,15,15,1062,875,0.5,187,0.5482705214248839
2011,3198,16,16,1064,898,0.5,166,0.5423037716615698
2011,3199,23,7,1728,489,0.7666666666666667,1239,0.7794316644113667
2011,3200,12,19,781,973,0.3870967741935484,-192,0.4452679589509692
2011,3201,25,7,1947,489,0.78125,1458,0.7992610837438424
2011,3202,13,16,865,914,0.4482758620689655,-49,0.48622821810005623
2011,3203,8,21,479,1131,0.27586206896551724,-652,0.29751552795031055
2011,3204,12,18,795,958,0.4,-163,0.4535082715345123
2011,3205,20,10,1273,602,0.6666666666666666,671,0.6789333333333334
2011,3206,13,17,854,937,0.43333333333333335,-83,0.4768285873813512
2011,3207,21,10,1385,569,0.6774193548387096,816,0.7088024564994883
2011,3208,21,10,1451,557,0.6774193548387096,894,0.7226095617529881
2011,3209,12,19,828,958,0.3870967741935484,-130,0.46360582306830905
2011,3210,23,10,1627,558,0.696969696969697,1069,0.7446224256292906
2011,3211,27,4,2376,264,0.8709677419354839,2112,0.9
2011,3212,13,16,860,861,0.4482758620689655,-1,0.4997094712376525
2011,3214,25,6,1726,306,0.8064516129032258,1420,0.8494094488188977
2011,3216,17,15,1064,769,0.53125,295,0.5804691762138571
2011,3217,18,10,1354,646,0.6428571428571429,708,0.677
2011,3218,11,19,746,1068,0.36666666666666664,-322,0.41124586549062847
2011,3219,14,15,1030,926,0.4827586206896552,104,0.5265848670756647
2011,3220,19,12,1520,812,0.6129032258064516,708,0.6518010291595198
2011,3221,10,20,706,1109,0.3333333333333333,-403,0.38898071625344355
2011,3222,26,5,2027,284,0.8387096774193549,1743,0.8771094764171354
2011,3223,3,25,195,1310,0.10714285714285714,-1115,0.12956810631229235
2011,3224,16,18,950,876,0.47058823529411764,74,0.52026286966046
2011,3225,14,15,965,868,0.4827586206896552,97,0.5264593562465902
2011,3226,16,12,1098,708,0.5714285714285714,390,0.6079734219269103
2011,3227,14,16,950,968,0.4666666666666667,-18,0.49530761209593327
2011,3228,9,23,630,1384,0.28125,-754,0.3128103277060576
2011,3229,20,10,1458,610,0.6666666666666666,848,0.7050290135396519
2011,3231,9,20,603,1235,0.3103448275862069,-632,0.3280739934711643
2011,3232,16,16,1180,925,0.5,255,0.5605700712589073
2011,3233,11,20,749,1066,0.3548387096774194,-317,0.4126721763085399
2011,3234,22,8,1632,483,0.7333333333333333,1149,0.7716312056737589
2011,3235,22,10,1528,560,0.6875,968,0.7318007662835249
2011,3236,19,10,1446,682,0.6551724137931034,764,0.6795112781954887
2011,3237,3,24,214,1260,0.1111111111111111,-1046,0.1451831750339213
2011,3238,9,19,527,983,0.32142857142857145,-456,0.3490066225165563
2011,3239,15,17,1032,1015,0.46875,17,0.504152418172936
2011,3240,9,21,607,1192,0.3,-585,0.33740967204002226
2011,3241,26,7,1871,452,0.7878787878787878,1419,0.8054240206629358
2011,3242,20,12,1583,655,0.625,928,0.7073279714030384
2011,3243,21,10,1364,541,0.6774193548387096,823,0.7160104986876641
2011,3244,9,21,606,1180,0.3,-574,0.3393057110862262
2011,3245,19,9,1304,592,0.6785714285714286,712,0.6877637130801688
2011,3246,24,8,1802,470,0.75,1332,0.7931338028169014
2011,3247,10,20,752,1078,0.3333333333333333,-326,0.41092896174863386
2011,3248,11,19,676,966,0.36666666666666664,-290,0.41169305724725946
2011,3249,23,7,1780,416,0.7666666666666667,1364,0.8105646630236795
2011,3250,21,10,1454,569,0.6774193548387096,885,0.7187345526445873
2011,3251,20,10,1274,507,0.6666666666666666,767,0.7153284671532847
2011,3252,9,21,649,1229,0.3,-580,0.345580404685836
2011,3253,8,23,571,1344,0.25806451612903225,-773,0.29817232375979114
2011,3254,19,11,1265,595,0.6333333333333333,670,0.6801075268817204
2011,3255,7,23,504,1297,0.23333333333333334,-793,0.2798445308162132
2011,3256,24,7,1840,444,0.7741935483870968,1396,0.8056042031523643
2011,3257,20,12,1544,713,0.625,831,0.6840939299955694
2011,3258,11,18,835,927,0.3793103448275862,-92,0.4738933030646992
2011,3259,20,12,1279,605,0.625,674,0.6788747346072187
2011,3260,11,19,788,1077,0.36666666666666664,-289,0.4225201072386059
2011,3261,19,13,1282,699,0.59375,583,0.6471479050984351
2011,3263,4,25,265,1318,0.13793103448275862,-1053,0.16740366392924827
2011,3264,22,9,1324,440,0.7096774193548387,884,0.7505668934240363
2011,3265,30,2,2051,90,0.9375,1961,0.9579635684259692
2011,3266,23,8,1590,461,0.7419354838709677,1129,0.7752315943442223
2011,3267,9,21,576,1021,0.3,-445,0.3606762680025047
2011,3268,23,7,1726,440,0.7666666666666667,1286,0.7968605724838412
2011,3269,7,23,530,1360,0.23333333333333334,-830,0.2804232804232804
2011,3270,22,6,1529,350,0.7857142857142857,1179,0.8137307078233103
2011,3271,12,19,728,966,0.3870967741935484,-238,0.4297520661157025
2011,3272,21,12,1507,656,0.6363636363636364,851,0.6967175219602404
2011,3273,2,27,151,1557,0.06896551724137931,-1406,0.08840749414519906
2011,3274,27,4,2214,259,0.8709677419354839,1955,0.8952689041649818
2011,3275,11,19,853,1234,0.36666666666666664,-381,0.40872065165309057
2011,3276,17,12,1206,683,0.5862068965517241,523,0.6384330333509793
2011,3277,26,5,1816,279,0.8387096774193549,1537,0.8668257756563246
2011,3278,12,18,843,1076,0.4,-233,0.4392912975508077
2011,3279,10,19,680,1015,0.3448275862068966,-335,0.40117994100294985
2011,3280,13,17,825,921,0.43333333333333335,-96,0.4725085910652921
2011,3281,13,18,871,971,0.41935483870967744,-100,0.4728555917480999
2011,3282,13,16,935,927,0.4482758620689655,8,0.5021482277121375
2011,3283,23,10,1696,595,0.696969696969697,1101,0.7402880838061981
2011,3284,23,9,1479,462,0.71875,1017,0.7619783616692427
2011,3285,17,14,1100,793,0.5483870967741935,307,0.5810882197569994
2011,3286,17,14,1310,853,0.5483870967741935,457,0.6056403143781784
2011,3287,21,10,1563,628,0.6774193548387096,935,0.7133728890917389
2011,3288,17,14,1006,709,0.5483870967741935,297,0.5865889212827988
2011,3290,12,17,847,862,0.41379310344827586,-15,0.49561146869514333
2011,3291,8,21,554,1122,0.27586206896551724,-568,0.3305489260143198
2011,3292,23,7,1725,404,0.7666666666666667,1321,0.810239549084077
2011,3293,7,21,482,1250,0.25,-768,0.27829099307159355
2011,3294,16,13,1131,747,0.5517241379310345,384,0.6022364217252396
2011,3295,12,16,901,909,0.42857142857142855,-8,0.4977900552486188
2011,3296,13,17,820,913,0.43333333333333335,-93,0.47316791690709753
2011,3298,20,11,1228,573,0.6451612903225806,655,0.6818434203220433
2011,3299,15,14,1154,846,0.5172413793103449,308,0.577
2011,3300,5,25,275,1236,0.16666666666666666,-961,0.18199867637326275
2011,3301,13,17,1020,1256,0.43333333333333335,-236,0.44815465729349735
2011,3304,12,18,897,1005,0.4,-108,0.471608832807571
2011,3305,20,10,1454,568,0.6666666666666666,886,0.7190900098911969
2011,3306,9,20,622,1083,0.3103448275862069,-461,0.36480938416422287
2011,3307,13,18,882,1001,0.41935483870967744,-119,0.4684014869888476
2011,3308,13,18,925,1080,0.41935483870967744,-155,0.4613466334164589
2011,3310,1,29,52,1397,0.03333333333333333,-1345,0.035886818495514144
2011,3311,7,21,489,1244,0.25,-755,0.28216964800923255
2011,3312,7,21,461,1037,0.25,-576,0.30774365821094796
2011,3313,8,19,543,1029,0.2962962962962963,-486,0.34541984732824427
2011,3314,26,8,2138,511,0.7647058823529411,1627,0.8070970177425444
2011,3315,13,16,992,903,0.4482758620689655,89,0.5234828496042216
2011,3316,13,17,833,866,0.43333333333333335,-33,0.49028840494408477
2011,3317,5,25,362,1565,0.16666666666666666,-1203,0.18785677218474311
2011,3318,8,22,523,1230,0.26666666666666666,-707,0.29834569309754705
2011,3319,10,18,710,1059,0.35714285714285715,-349,0.4013566986998304
2011,3320,27,5,1924,310,0.84375,1614,0.8612354521038496
2011,3321,18,13,1291,747,0.5806451612903226,544,0.6334641805691855
2011,3322,11,16,813,943,0.4074074074074074,-130,0.4629840546697039
2011,3323,26,7,2077,490,0.7878787878787878,1587,0.8091156992598364
2011,3324,19,12,1312,689,0.6129032258064516,623,0.655672163918041
2011,3325,9,22,581,1168,0.2903225806451613,-587,0.3321898227558605
2011,3326,22,9,1728,568,0.7096774193548387,1160,0.7526132404181185
2011,3328,21,11,1679,747,0.65625,932,0.692085737840066
2011,3329,16,14,1211,799,0.5333333333333333,412,0.6024875621890547
2011,3330,20,10,1390,538,0.6666666666666666,852,0.720954356846473
2011,3331,20,10,1846,712,0.6666666666666666,1134,0.7216575449569976
2011,3332,12,17,1002,1178,0.41379310344827586,-176,0.4596330275229358
2011,3333,9,21,542,1076,0.3,-534,0.33498145859085293
2011,3334,9,22,624,1312,0.2903225806451613,-688,0.32231404958677684
2011,3335,11,17,647,857,0.39285714285714285,-210,0.43018617021276595
2011,3336,24,9,1927,617,0.7272727272727273,1310,0.7574685534591195
2011,3337,18,11,1311,699,0.6206896551724138,612,0.6522388059701493
2011,3338,14,17,1040,1015,0.45161290322580644,25,0.5060827250608273
2011,3339,16,15,1198,968,0.5161290322580645,230,0.5530932594644506
2011,3340,18,11,1322,637,0.6206896551724138,685,0.6748340990301174
2011,3341,21,11,1271,532,0.65625,739,0.7049362174154188
2011,3342,8,20,465,939,0.2857142857142857,-474,0.3311965811965812
2011,3343,24,4,1708,249,0.8571428571428571,1459,0.8727644353602453
2011,3344,13,16,819,822,0.4482758620689655,-3,0.4990859232175503
2011,3345,20,11,1391,641,0.6451612903225806,750,0.6845472440944882
2011,3346,14,16,1014,897,0.4666666666666667,117,0.5306122448979592
2011,3347,12,16,813,873,0.42857142857142855,-60,0.4822064056939502
2011,3348,7,20,434,1068,0.25925925925925924,-634,0.28894806924101196
2011,3349,18,13,1285,724,0.5806451612903226,561,0.6396217023394724
2011,3350,18,11,1273,669,0.6206896551724138,604,0.6555097837281153
2011,3351,5,25,372,1196,0.16666666666666666,-824,0.2372448979591837
2011,3352,16,14,1090,824,0.5333333333333333,266,0.5694879832810867
2011,3353,18,12,1173,640,0.6,533,0.6469939327082185
2011,3354,10,17,594,877,0.37037037037037035,-283,0.40380693405846363
2011,3355,19,13,1388,771,0.59375,617,0.6428902269569245
2011,3356,2,28,138,1389,0.06666666666666667,-1251,0.09037328094302555
2011,3357,18,12,1202,617,0.6,585,0.6608026388125343
2011,3358,17,14,1270,878,0.5483870967741935,392,0.5912476722532588
2011,3359,24,7,1570,387,0.7741935483870968,1183,0.8022483392948391
2011,3360,16,14,1198,777,0.5333333333333333,421,0.6065822784810126
2011,3361,12,17,776,944,0.41379310344827586,-168,0.4511627906976744
2011,3362,3,25,224,1430,0.10714285714285714,-1206,0.1354292623941959
2011,3363,2,26,116,1232,0.07142857142857142,-1116,0.08605341246290801
2011,3364,19,11,1319,606,0.6333333333333333,713,0.6851948051948052
2011,3365,11,19,705,1144,0.36666666666666664,-439,0.3812871822606814
2011,3366,10,11,587,507,0.47619047619047616,80,0.5365630712979891
2011,3367,17,12,1271,770,0.5862068965517241,501,0.622733953944145
2011,3368,9,16,605,907,0.36,-302,0.4001322751322751
2011,3369,6,21,352,1002,0.2222222222222222,-650,0.25997045790251105
2011,3370,8,22,577,1296,0.26666666666666666,-719,0.30806193272824345
2011,3371,8,22,510,1124,0.26666666666666666,-614,0.31211750305997554
2011,3372,12,18,957,1138,0.4,-181,0.4568019093078759
2011,3373,14,16,782,785,0.4666666666666667,-3,0.4990427568602425
2011,3374,14,16,1021,981,0.4666666666666667,40,0.50999000999001
2011,3375,15,13,1044,674,0.5357142857142857,370,0.6076833527357393
2011,3376,17,14,1095,718,0.5483870967741935,377,0.6039713182570325
2011,3377,16,11,1046,613,0.5925925925925926,433,0.6305003013863774
2011,3378,12,19,806,1066,0.3870967741935484,-260,0.4305555555555556
2011,3379,9,20,610,1131,0.3103448275862069,-521,0.35037334865020103
2011,3380,19,11,1213,524,0.6333333333333333,689,0.6983304548071387
2011,3381,16,14,1187,852,0.5333333333333333,335,0.5821481118195194
2011,3382,20,11,1263,593,0.6451612903225806,670,0.6804956896551724
2011,3383,2,27,120,1292,0.06896551724137931,-1172,0.08498583569405099
2011,3384,22,11,1626,644,0.6666666666666666,982,0.7162995594713656
2011,3385,21,10,1412,550,0.6774193548387096,862,0.7196738022426096
2011,3386,19,11,1261,571,0.6333333333333333,690,0.6883187772925764
2011,3387,7,22,450,1180,0.2413793103448276,-730,0.27607361963190186
2011,3388,19,12,1373,725,0.6129032258064516,648,0.6544327931363203
2011,3389,6,25,362,1276,0.1935483870967742,-914,0.221001221001221
2011,3390,29,2,2335,143,0.9354838709677419,2192,0.9422921711057304
2011,3391,19,12,1338,709,0.6129032258064516,629,0.6536394723986322
2011,3392,7,23,495,1318,0.23333333333333334,-823,0.2730281301709873
2011,3393,22,9,1675,496,0.7096774193548387,1179,0.7715338553661907
2011,3394,2,26,147,1625,0.07142857142857142,-1478,0.08295711060948081
2011,3395,22,10,1587,574,0.6875,1013,0.7343822304488663
2011,3396,23,8,1597,517,0.7419354838709677,1080,0.7554399243140965
2011,3397,31,2,2500,112,0.9393939393939394,2388,0.9571209800918836
2011,3398,9,20,571,1177,0.3103448275862069,-606,0.3266590389016018
2011,3399,22,7,1533,422,0.7586206896551724,1111,0.7841432225063939
2011,3400,19,13,1587,865,0.59375,722,0.6472267536704731
2011,3401,27,5,2215,301,0.84375,1914,0.8803656597774245
2011,3402,6,19,434,1137,0.24,-703,0.27625716104392106
2011,3403,22,10,1504,605,0.6875,899,0.7131341868183974
2011,3404,21,10,1653,618,0.6774193548387096,1035,0.7278731836195509
2011,3405,23,8,1538,496,0.7419354838709677,1042,0.7561455260570304
2011,3406,9,21,574,1110,0.3,-536,0.34085510688836107
2011,3407,3,25,192,1354,0.10714285714285714,-1162,0.12419146183699871
2011,3408,22,10,1604,729,0.6875,875,0.687526789541363
2011,3409,4,19,332,1066,0.17391304347826086,-734,0.2374821173104435
2011,3410,9,19,675,1160,0.32142857142857145,-485,0.3678474114441417
2011,3411,5,24,336,1240,0.1724137931034483,-904,0.2131979695431472
2011,3412,16,15,998,824,0.5161290322580645,174,0.5477497255762898
2011,3413,24,8,1760,442,0.75,1318,0.7992733878292462
2011,3414,15,15,1040,971,0.5,69,0.5171556439582298
2011,3415,19,12,1357,633,0.6129032258064516,724,0.6819095477386935
2011,3416,21,10,1484,630,0.6774193548387096,854,0.7019867549668874
2011,3417,27,4,1837,199,0.8709677419354839,1638,0.9022593320235757
2011,3418,8,19,593,1054,0.2962962962962963,-461,0.3600485731633273
2011,3419,14,15,938,846,0.4827586206896552,92,0.5257847533632287
2011,3420,20,11,1239,531,0.6451612903225806,708,0.7
2011,3421,11,17,814,1078,0.39285714285714285,-264,0.43023255813953487
2011,3422,13,16,840,929,0.4482758620689655,-89,0.47484454494064443
2011,3423,23,8,1642,483,0.7419354838709677,1159,0.7727058823529411
2011,3424,11,20,746,1150,0.3548387096774194,-404,0.39345991561181437
2011,3425,19,12,1415,721,0.6129032258064516,694,0.6624531835205992
2011,3426,8,20,557,1097,0.2857142857142857,-540,0.33675937122128174
2011,3427,14,15,1047,762,0.4827586206896552,285,0.5787728026533997
2011,3428,16,16,980,836,0.5,144,0.539647577092511
2011,3429,17,13,1219,835,0.5666666666666667,384,0.5934761441090555
2011,3430,7,21,536,1199,0.25,-663,0.3089337175792507
2011,3431,15,14,1124,885,0.5172413793103449,239,0.5594823295171727
2011,3433,19,11,1370,664,0.6333333333333333,706,0.6735496558505408
2011,3434,7,24,463,1346,0.22580645161290322,-883,0.25594250967385296
2011,3435,20,11,1508,711,0.6451612903225806,797,0.679585398828301
2011,3436,5,25,299,1135,0.16666666666666666,-836,0.20850767085076707
2011,3437,12,19,674,911,0.3870967741935484,-237,0.4252365930599369
2011,3438,16,15,1168,903,0.5161290322580645,265,0.5639787542250121
2011,3439,11,19,794,1030,0.36666666666666664,-236,0.43530701754385964
2011,3441,9,22,565,1134,0.2903225806451613,-569,0.3325485579752796
2011,3442,6,21,380,1139,0.2222222222222222,-759,0.250164581961817
2011,3443,15,17,1053,992,0.46875,61,0.5149144254278729
2011,3444,9,21,608,1199,0.3,-591,0.3364692861095739
2011,3447,12,17,814,998,0.41379310344827586,-184,0.4492273730684327
2011,3448,15,17,1173,954,0.46875,219,0.5514809590973202
2011,3449,11,17,681,893,0.39285714285714285,-212,0.4326556543837357
2011,3450,8,23,590,1362,0.25806451612903225,-772,0.30225409836065575
2011,3451,6,21,401,1188,0.2222222222222222,-787,0.2523599748269352
2011,3452,23,9,1615,489,0.71875,1126,0.7675855513307985
2011,3453,32,1,2406,60,0.9696969696969697,2346,0.975669099756691
2011,3454,12,18,867,1106,0.4,-239,0.439432336543335
2011,3455,17,14,1185,784,0.5483870967741935,401,0.6018283392585069
2011,3456,3,26,219,1602,0.10344827586206896,-1383,0.12026359143327842
2011,3457,12,16,717,732,0.42857142857142855,-15,0.494824016563147
2011,3458,15,14,963,764,0.5172413793103449,199,0.5576143601621308
2011,3459,6,22,452,1204,0.21428571428571427,-752,0.27294685990338163
2011,3460,19,12,1346,744,0.6129032258064516,602,0.6440191387559808
2011,3461,20,8,1404,424,0.7142857142857143,980,0.7680525164113785
2011,3462,28,2,2131,97,0.9333333333333333,2034,0.9564631956912029
2011,3463,14,14,975,753,0.5,222,0.5642361111111112
2011,3464,6,24,427,1327,0.2,-900,0.2434435575826682
2012,1102,11,16,711,927,0.4074074074074074,-216,0.4340659340659341
2012,1103,21,11,1577,710,0.65625,867,0.6895496283340621
2012,1104,21,11,1443,635,0.65625,808,0.6944177093358999
2012,1105,5,21,348,1241,0.19230769230769232,-893,0.21900566393958465
2012,1106,10,19,642,1032,0.3448275862068966,-390,0.3835125448028674
2012,1107,19,14,1477,897,0.5757575757575758,580,0.6221566975568661
2012,1108,7,21,467,1213,0.25,-746,0.2779761904761905
2012,1110,20,11,1381,617,0.6451612903225806,764,0.6911911911911912
2012,1111,11,18,839,1111,0.3793103448275862,-272,0.43025641025641026
2012,1112,23,11,1670,692,0.6764705882352942,978,0.7070279424216765
2012,1113,10,21,698,1193,0.3225806451612903,-495,0.36911686938127974
2012,1114,14,16,952,920,0.4666666666666667,32,0.5085470085470085
2012,1115,11,22,726,1287,0.3333333333333333,-561,0.36065573770491804
2012,1116,18,14,1398,901,0.5625,497,0.6080904741191823
2012,1117,13,20,943,1147,0.3939393939393939,-204,0.4511961722488038
2012,1119,11,18,830,1102,0.3793103448275862,-272,0.42960662525879917
2012,1120,15,16,1047,895,0.4838709677419355,152,0.53913491246138
2012,1122,11,20,841,1303,0.3548387096774194,-462,0.39225746268656714
2012,1123,14,15,994,833,0.4827586206896552,161,0.5440613026819924
2012,1124,26,7,1975,476,0.7878787878787878,1499,0.8057935536515708
2012,1125,26,7,2168,518,0.7878787878787878,1650,0.8071481757259866
2012,1126,16,17,1155,988,0.48484848484848486,167,0.5389640690620625
2012,1127,2,29,130,1632,0.06451612903225806,-1502,0.07377979568671963
2012,1129,12,17,960,995,0.41379310344827586,-35,0.49104859335038364
2012,1130,9,22,597,1236,0.2903225806451613,-639,0.32569558101472995
2012,1131,16,16,1115,930,0.5,185,0.5452322738386308
2012,1132,15,15,1010,959,0.5,51,0.5129507364144236
2012,1133,7,25,504,1451,0.21875,-947,0.2578005115089514
2012,1135,7,23,520,1301,0.23333333333333334,-781,0.28555738605162
2012,1136,2,28,129,1723,0.06666666666666667,-1594,0.06965442764578833
2012,1137,23,9,1646,545,0.71875,1101,0.7512551346417161
2012,1138,18,10,1331,666,0.6428571428571429,665,0.6664997496244367
2012,1139,19,14,1213,841,0.5757575757575758,372,0.5905550146056475
2012,1140,23,8,1891,538,0.7419354838709677,1353,0.778509674763277
2012,1141,10,21,688,1227,0.3225806451612903,-539,0.3592689295039164
2012,1142,16,15,1083,895,0.5161290322580645,188,0.5475227502527806
2012,1143,24,9,1761,604,0.7272727272727273,1157,0.7446088794926005
2012,1144,16,15,1210,1057,0.5161290322580645,153,0.5337450374944861
2012,1145,5,25,392,1573,0.16666666666666666,-1181,0.1994910941475827
2012,1146,6,20,510,1285,0.23076923076923078,-775,0.2841225626740947
2012,1148,13,16,968,1061,0.4482758620689655,-93,0.4770823065549532
2012,1149,16,12,1301,809,0.5714285714285714,492,0.6165876777251185
2012,1150,13,17,931,1079,0.43333333333333335,-148,0.46318407960199004
2012,1151,8,21,587,1392,0.27586206896551724,-805,0.2966144517433047
2012,1152,3,25,226,1512,0.10714285714285714,-1286,0.13003452243958574
2012,1153,24,10,1750,579,0.7058823529411765,1171,0.7513954486904251
2012,1154,4,24,266,1471,0.14285714285714285,-1205,0.15313759355210133
2012,1155,16,15,1084,917,0.5161290322580645,167,0.5417291354322838
2012,1156,21,10,1437,589,0.6774193548387096,848,0.709279368213228
2012,1157,15,11,1087,722,0.5769230769230769,365,0.6008844665561084
2012,1158,19,12,1375,816,0.6129032258064516,559,0.6275673208580557
2012,1159,8,22,552,1341,0.26666666666666666,-789,0.29160063391442154
2012,1160,21,11,1443,678,0.65625,765,0.6803394625176803
2012,1161,20,11,1510,692,0.6451612903225806,818,0.6857402361489555
2012,1162,13,15,856,917,0.4642857142857143,-61,0.48279751833051326
2012,1163,20,13,1486,786,0.6060606060606061,700,0.6540492957746479
2012,1164,11,16,882,1121,0.4074074074074074,-239,0.4403394907638542
2012,1165,11,16,809,946,0.4074074074074074,-137,0.46096866096866096
2012,1166,28,5,2318,323,0.8484848484848485,1995,0.8776978417266187
2012,1167,15,14,1090,887,0.5172413793103449,203,0.5513404147698533
2012,1168,19,9,1534,600,0.6785714285714286,934,0.7188378631677601
2012,1169,5,21,390,1324,0.19230769230769232,-934,0.22753792298716452
2012,1170,8,18,600,1139,0.3076923076923077,-539,0.3450258769407706
2012,1171,4,25,269,1394,0.13793103448275862,-1125,0.16175586289837643
2012,1172,24,7,1894,504,0.7741935483870968,1390,0.7898248540450375
2012,1173,20,12,1487,807,0.625,680,0.6482127288578902
2012,1174,18,13,1303,845,0.5806451612903226,458,0.6066108007448789
2012,1175,13,14,926,801,0.48148148148148145,125,0.5361899247249565
2012,1176,22,9,1505,607,0.7096774193548387,898,0.712594696969697
2012,1177,12,19,944,1354,0.3870967741935484,-410,0.41079199303742386
2012,1178,20,13,1497,842,0.6060606060606061,655,0.6400171013253527
2012,1179,16,15,1186,872,0.5161290322580645,314,0.576287657920311
2012,1180,27,6,1834,300,0.8181818181818182,1534,0.85941893158388
2012,1181,27,6,2146,412,0.8181818181818182,1734,0.8389366692728695
2012,1182,15,15,1224,931,0.5,293,0.5679814385150812
2012,1183,10,17,725,1001,0.37037037037037035,-276,0.4200463499420626
2012,1184,14,16,982,975,0.4666666666666667,7,0.5017884517118038
2012,1185,13,18,735,907,0.41935483870967744,-172,0.4476248477466504
2012,1186,13,17,999,1140,0.43333333333333335,-141,0.4670406732117812
2012,1187,11,16,787,1016,0.4074074074074074,-229,0.4364947310038824
2012,1188,8,17,567,1056,0.32,-489,0.34935304990757854
2012,1189,13,16,961,1018,0.4482758620689655,-57,0.48559878726629613
2012,1190,16,14,1159,856,0.5333333333333333,303,0.5751861042183622
2012,1191,15,15,1150,1035,0.5,115,0.5263157894736842
2012,1192,3,26,184,1578,0.10344827586206896,-1394,0.10442678774120318
2012,1193,19,14,1293,861,0.5757575757575758,432,0.6002785515320335
2012,1194,10,19,721,1158,0.3448275862068966,-437,0.38371474188398086
2012,1195,14,17,1102,1125,0.45161290322580644,-23,0.49483610237988324
2012,1196,23,10,1849,668,0.696969696969697,1181,0.7346046881207787
2012,1197,8,23,593,1406,0.25806451612903225,-813,0.29664832416208103
2012,1198,8,20,567,1201,0.2857142857142857,-634,0.3207013574660634
2012,1199,24,9,1771,550,0.7272727272727273,1221,0.7630331753554502
2012,1200,10,19,680,1117,0.3448275862068966,-437,0.3784084585420145
2012,1201,11,20,733,1286,0.3548387096774194,-553,0.3630510153541357
2012,1202,13,16,934,911,0.4482758620689655,23,0.5062330623306233
2012,1203,10,21,695,1226,0.3225806451612903,-531,0.3617907339927121
2012,1204,13,15,928,902,0.4642857142857143,26,0.507103825136612
2012,1205,10,20,717,1208,0.3333333333333333,-491,0.37246753246753245
2012,1206,24,9,1724,599,0.7272727272727273,1125,0.7421437795953508
2012,1207,22,8,1549,504,0.7333333333333333,1045,0.7545056015586946
2012,1208,15,17,1029,921,0.46875,108,0.5276923076923077
2012,1209,21,11,1464,701,0.65625,763,0.6762124711316397
2012,1210,11,20,770,1096,0.3548387096774194,-326,0.41264737406216506
2012,1211,25,6,1877,416,0.8064516129032258,1461,0.8185782817269952
2012,1212,4,24,267,1246,0.14285714285714285,-979,0.17647058823529413
2012,1214,12,21,849,1285,0.36363636363636365,-436,0.3978444236176195
2012,1216,9,22,584,1276,0.2903225806451613,-692,0.3139784946236559
2012,1217,25,4,1664,223,0.8620689655172413,1441,0.8818229994700583
2012,1218,14,16,1099,1096,0.4666666666666667,3,0.5006833712984055
2012,1219,11,18,822,1197,0.3793103448275862,-375,0.40713224368499257
2012,1220,10,22,781,1310,0.3125,-529,0.37350549976088
2012,1221,15,14,1079,807,0.5172413793103449,272,0.5721102863202545
2012,1222,14,15,1114,948,0.4827586206896552,166,0.5402521823472357
2012,1223,7,20,532,1348,0.25925925925925924,-816,0.28297872340425534
2012,1224,9,21,608,1190,0.3,-582,0.3381535038932147
2012,1225,16,13,1176,823,0.5517241379310345,353,0.5882941470735368
2012,1226,8,21,608,1278,0.27586206896551724,-670,0.32237539766702017
2012,1227,7,21,458,1248,0.25,-790,0.268464243845252
2012,1228,17,15,1163,935,0.53125,228,0.5543374642516683
2012,1229,20,13,1405,850,0.6060606060606061,555,0.623059866962306
2012,1231,25,8,2036,514,0.7575757575757576,1522,0.7984313725490196
2012,1232,17,14,1160,832,0.5483870967741935,328,0.5823293172690763
2012,1233,25,7,2146,518,0.78125,1628,0.8055555555555556
2012,1234,17,16,1326,1048,0.5151515151515151,278,0.5585509688289806
2012,1235,22,10,1684,658,0.6875,1026,0.7190435525192144
2012,1236,10,19,783,1232,0.3448275862068966,-449,0.38858560794044666
2012,1237,12,18,936,1207,0.4,-271,0.4367708819412039
2012,1238,6,24,373,1291,0.2,-918,0.22415865384615385
2012,1239,8,22,567,1384,0.26666666666666666,-817,0.29062019477191187
2012,1240,13,17,927,980,0.43333333333333335,-53,0.48610382800209756
2012,1241,12,20,815,1300,0.375,-485,0.38534278959810875
2012,1242,27,6,2069,407,0.8181818181818182,1662,0.8356219709208401
2012,1243,21,10,1557,657,0.6774193548387096,900,0.7032520325203252
2012,1244,2,28,134,1714,0.06666666666666667,-1580,0.07251082251082251
2012,1245,20,11,1461,713,0.6451612903225806,748,0.672033118675253
2012,1246,32,2,2471,136,0.9411764705882353,2335,0.9478327579593402
2012,1247,21,12,1619,798,0.6363636363636364,821,0.6698386429458005
2012,1248,13,18,974,1187,0.41935483870967744,-213,0.4507172605275335
2012,1249,21,11,1628,696,0.65625,932,0.7005163511187608
2012,1250,25,7,1909,511,0.78125,1398,0.7888429752066116
2012,1251,11,18,772,1179,0.3793103448275862,-407,0.3956945156330087
2012,1252,12,18,975,1171,0.4,-196,0.4543336439888164
2012,1253,23,8,1706,581,0.7419354838709677,1125,0.7459554000874508
2012,1254,25,8,2151,551,0.7575757575757576,1600,0.7960769800148039
2012,1255,6,21,523,1384,0.2222222222222222,-861,0.27425275301520713
2012,1256,16,16,1157,1040,0.5,117,0.5266272189349113
2012,1257,26,9,1885,524,0.7428571428571429,1361,0.7824823578248236
2012,1258,17,12,1263,711,0.5862068965517241,552,0.6398176291793313
2012,1259,24,8,1663,500,0.75,1163,0.7688395746648173
2012,1260,6,23,378,1270,0.20689655172413793,-892,0.22936893203883496
2012,1261,18,14,1230,851,0.5625,379,0.5910619894281596
2012,1263,11,17,820,1056,0.39285714285714285,-236,0.43710021321961623
2012,1264,20,12,1488,786,0.625,702,0.6543535620052771
2012,1265,14,18,1043,1133,0.4375,-90,0.47931985294117646
2012,1266,25,7,1987,443,0.78125,1544,0.8176954732510288
2012,1267,20,13,1474,821,0.6060606060606061,653,0.6422657952069717
2012,1268,17,15,1241,957,0.53125,284,0.564604185623294
2012,1269,22,11,1778,755,0.6666666666666666,1023,0.7019344650611923
2012,1270,14,15,980,927,0.4827586206896552,53,0.5138961719979025
2012,1271,6,23,390,1300,0.20689655172413793,-910,0.23076923076923078
2012,1272,26,8,1996,564,0.7647058823529411,1432,0.7796875
2012,1273,21,11,1458,720,0.65625,738,0.6694214876033058
2012,1274,19,12,1443,763,0.6129032258064516,680,0.6541251133272892
2012,1275,8,21,515,1235,0.27586206896551724,-720,0.29428571428571426
2012,1276,23,9,1590,546,0.71875,1044,0.7443820224719101
2012,1277,27,7,2030,423,0.7941176470588235,1607,0.8275580921320832
2012,1278,19,14,1380,844,0.5757575757575758,536,0.6205035971223022
2012,1279,20,13,1367,815,0.6060606060606061,552,0.6264894592117324
2012,1280,21,11,1593,688,0.65625,905,0.6983779044278825
2012,1281,30,4,2445,285,0.8823529411764706,2160,0.8956043956043956
2012,1282,10,20,747,1189,0.3333333333333333,-442,0.38584710743801653
2012,1283,15,16,1012,1027,0.4838709677419355,-15,0.49632172633643945
2012,1284,12,20,899,1241,0.375,-342,0.4200934579439252
2012,1285,23,6,1691,375,0.7931034482758621,1316,0.8184898354307841
2012,1286,10,17,756,1054,0.37037037037037035,-298,0.4176795580110497
2012,1287,15,15,960,866,0.5,94,0.5257393209200438
2012,1288,9,20,673,1261,0.3103448275862069,-588,0.34798345398138575
2012,1290,21,12,1532,742,0.6363636363636364,790,0.673702726473175
2012,1291,8,21,535,1213,0.27586206896551724,-678,0.3060640732265446
2012,1292,24,6,1737,405,0.8,1332,0.8109243697478992
2012,1293,27,1,2010,68,0.9642857142857143,1942,0.9672762271414822
2012,1294,8,18,585,1283,0.3076923076923077,-698,0.31316916488222696
2012,1295,16,13,1266,834,0.5517241379310345,432,0.6028571428571429
2012,1296,4,26,256,1388,0.13333333333333333,-1132,0.15571776155717762
2012,1298,2,26,142,1448,0.07142857142857142,-1306,0.08930817610062892
2012,1299,9,20,739,1216,0.3103448275862069,-477,0.37800511508951407
2012,1300,13,15,906,932,0.4642857142857143,-26,0.4929270946681175
2012,1301,22,12,1666,829,0.6470588235294118,837,0.6677354709418838
2012,1303,1,15,77,1026,0.0625,-949,0.06980961015412511
2012,1304,12,18,839,988,0.4,-149,0.45922276956759717
2012,1305,25,6,1798,393,0.8064516129032258,1405,0.820629849383843
2012,1306,12,16,775,914,0.42857142857142855,-139,0.45885139135583186
2012,1307,26,6,1933,389,0.8125,1544,0.8324720068906115
2012,1308,24,9,1936,618,0.7272727272727273,1318,0.7580266249021144
2012,1310,14,19,1050,1272,0.42424242424242425,-222,0.45219638242894056
2012,1311,8,20,608,1197,0.2857142857142857,-589,0.3368421052631579
2012,1312,11,17,791,1081,0.39285714285714285,-290,0.42254273504273504
2012,1313,24,8,1741,485,0.75,1256,0.7821203953279425
2012,1314,29,5,2412,375,0.8529411764705882,2037,0.8654467168998924
2012,1315,13,14,939,842,0.48148148148148145,97,0.5272318921953958
2012,1316,15,16,1141,942,0.4838709677419355,199,0.5477676428228516
2012,1317,15,14,1118,881,0.5172413793103449,237,0.5592796398199099
2012,1318,14,17,922,1019,0.45161290322580644,-97,0.4750128799587841
2012,1319,3,24,222,1399,0.1111111111111111,-1177,0.13695249845774213
2012,1320,18,13,1247,755,0.5806451612903226,492,0.6228771228771228
2012,1321,18,13,1357,798,0.5806451612903226,559,0.6296983758700696
2012,1322,13,16,998,1000,0.4482758620689655,-2,0.4994994994994995
2012,1323,22,11,1582,612,0.6666666666666666,970,0.7210574293527803
2012,1324,16,15,1367,1103,0.5161290322580645,264,0.5534412955465587
2012,1325,26,7,1887,430,0.7878787878787878,1457,0.8144151920586966
2012,1326,27,7,2108,434,0.7941176470588235,1674,0.8292682926829268
2012,1328,15,16,1158,984,0.4838709677419355,174,0.5406162464985994
2012,1329,14,18,1026,1103,0.4375,-77,0.48191639267261627
2012,1330,20,13,1408,754,0.6060606060606061,654,0.6512488436632747
2012,1331,27,6,2027,381,0.8181818181818182,1646,0.8417774086378738
2012,1332,22,9,1647,590,0.7096774193548387,1057,0.7362539114886008
2012,1333,18,14,1510,1002,0.5625,508,0.6011146496815286
2012,1334,9,19,593,1146,0.32142857142857145,-553,0.34100057504312825
2012,1335,19,12,1296,723,0.6129032258064516,573,0.6419019316493314
2012,1336,12,20,807,1170,0.375,-363,0.40819423368740515
2012,1337,9,19,601,1059,0.32142857142857145,-458,0.36204819277108435
2012,1338,17,16,1330,937,0.5151515151515151,393,0.5866784296426996
2012,1339,6,24,431,1511,0.2,-1080,0.22193614830072092
2012,1340,15,15,1169,1066,0.5,103,0.5230425055928412
2012,1341,11,18,731,1041,0.3793103448275862,-310,0.41252821670428896
2012,1342,13,15,894,892,0.4642857142857143,2,0.5005599104143337
2012,1343,17,11,1195,645,0.6071428571428571,550,0.6494565217391305
2012,1344,15,17,1132,1071,0.46875,61,0.5138447571493419
2012,1345,21,12,1617,765,0.6363636363636364,852,0.6788413098236776
2012,1346,18,13,1315,893,0.5806451612903226,422,0.5955615942028986
2012,1347,4,26,265,1537,0.13333333333333333,-1272,0.14705882352941177
2012,1348,7,24,551,1575,0.22580645161290322,-1024,0.2591721542803387
2012,1349,14,15,1013,940,0.4827586206896552,73,0.5186891961085509
2012,1350,16,16,1199,1008,0.5,191,0.543271409152696
2012,1351,13,19,1035,1256,0.40625,-221,0.45176778699257963
2012,1352,24,10,1691,644,0.7058823529411765,1047,0.7241970021413277
2012,1353,14,18,1016,1079,0.4375,-63,0.48496420047732697
2012,1354,3,26,251,1611,0.10344827586206896,-1360,0.1348012889366273
2012,1355,25,7,1964,480,0.78125,1484,0.8036006546644845
2012,1356,8,22,578,1303,0.26666666666666666,-725,0.3072833599149389
2012,1357,14,18,1028,1249,0.4375,-221,0.45147123407992973
2012,1358,9,19,600,968,0.32142857142857145,-368,0.3826530612244898
2012,1359,9,19,633,1179,0.32142857142857145,-546,0.34933774834437087
2012,1360,11,18,785,1141,0.3793103448275862,-356,0.4075804776739356
2012,1361,24,7,1719,455,0.7741935483870968,1264,0.7907083716651334
2012,1362,18,13,1408,924,0.5806451612903226,484,0.6037735849056604
2012,1363,8,22,603,1387,0.26666666666666666,-784,0.30301507537688444
2012,1364,18,10,1329,694,0.6428571428571429,635,0.6569451309935739
2012,1365,6,22,452,1469,0.21428571428571427,-1017,0.23529411764705882
2012,1366,19,11,1281,591,0.6333333333333333,690,0.6842948717948718
2012,1367,18,12,1312,806,0.6,506,0.619452313503305
2012,1368,9,17,604,895,0.34615384615384615,-291,0.4029352901934623
2012,1369,13,16,968,1047,0.4482758620689655,-79,0.4803970223325062
2012,1370,10,15,874,1024,0.4,-150,0.46048472075869334
2012,1371,20,12,1501,693,0.625,808,0.6841385597082954
2012,1372,16,12,1039,618,0.5714285714285714,421,0.6270368135184068
2012,1373,14,17,983,992,0.45161290322580644,-9,0.4977215189873418
2012,1374,11,19,726,1028,0.36666666666666664,-302,0.41391106043329534
2012,1375,16,12,1179,682,0.5714285714285714,497,0.6335303600214938
2012,1376,10,21,643,1260,0.3225806451612903,-617,0.3378875459800315
2012,1377,8,18,615,1195,0.3076923076923077,-580,0.3397790055248619
2012,1378,19,13,1245,637,0.59375,608,0.6615302869287991
2012,1379,23,8,1665,528,0.7419354838709677,1137,0.759233926128591
2012,1380,14,14,907,766,0.5,141,0.5421398684997011
2012,1381,12,17,863,1037,0.41379310344827586,-174,0.45421052631578945
2012,1382,20,11,1527,664,0.6451612903225806,863,0.6969420356001825
2012,1383,15,15,1107,977,0.5,130,0.531190019193858
2012,1384,6,23,429,1334,0.20689655172413793,-905,0.24333522404991492
2012,1385,13,19,938,1191,0.40625,-253,0.4405824330671677
2012,1386,20,13,1504,877,0.6060606060606061,627,0.631667366652667
2012,1387,24,7,1690,452,0.7741935483870968,1238,0.7889822595704948
2012,1388,25,5,1927,287,0.8333333333333334,1640,0.8703703703703703
2012,1389,5,26,319,1480,0.16129032258064516,-1161,0.1773207337409672
2012,1390,21,11,1573,683,0.65625,890,0.6972517730496454
2012,1391,8,20,584,1431,0.2857142857142857,-847,0.28982630272952853
2012,1392,21,9,1459,512,0.7,947,0.7402333840690005
2012,1393,31,2,2335,126,0.9393939393939394,2209,0.9488013002844372
2012,1394,6,24,348,1407,0.2,-1059,0.19829059829059828
2012,1395,16,14,1180,935,0.5333333333333333,245,0.557919621749409
2012,1396,24,7,1866,491,0.7741935483870968,1375,0.7916843445057277
2012,1397,17,14,1250,873,0.5483870967741935,377,0.5887894488930758
2012,1398,18,12,1253,764,0.6,489,0.6212196331184928
2012,1399,17,13,1352,792,0.5666666666666667,560,0.6305970149253731
2012,1400,20,13,1472,939,0.6060606060606061,533,0.6105350476980506
2012,1401,13,18,853,1027,0.41935483870967744,-174,0.45372340425531915
2012,1402,9,17,754,1168,0.34615384615384615,-414,0.3922996878251821
2012,1403,8,23,574,1270,0.25806451612903225,-696,0.31127982646420826
2012,1404,2,27,135,1646,0.06896551724137931,-1511,0.07580011229646266
2012,1405,16,16,1154,1024,0.5,130,0.5298438934802571
2012,1406,1,31,66,1581,0.03125,-1515,0.04007285974499089
2012,1407,9,18,711,1169,0.3333333333333333,-458,0.3781914893617021
2012,1408,13,16,914,927,0.4482758620689655,-13,0.4964693101575231
2012,1409,17,14,1160,933,0.5483870967741935,227,0.5542283803153368
2012,1410,7,21,524,1185,0.25,-661,0.30661205383265067
2012,1411,15,18,1058,963,0.45454545454545453,95,0.5235032162295893
2012,1412,15,16,1013,862,0.4838709677419355,151,0.5402666666666667
2012,1413,4,26,300,1540,0.13333333333333333,-1240,0.16304347826086957
2012,1414,10,19,761,1204,0.3448275862068966,-443,0.38727735368956745
2012,1415,12,17,789,889,0.41379310344827586,-100,0.47020262216924913
2012,1416,20,10,1348,604,0.6666666666666666,744,0.6905737704918032
2012,1417,18,14,1273,898,0.5625,375,0.586365730078305
2012,1418,15,15,1084,940,0.5,144,0.5355731225296443
2012,1419,3,25,218,1464,0.10714285714285714,-1246,0.12960760998810938
2012,1420,4,26,278,1619,0.13333333333333333,-1341,0.14654717975751186
2012,1421,21,9,1723,633,0.7,1090,0.7313242784380306
2012,1422,12,19,893,1267,0.3870967741935484,-374,0.4134259259259259
2012,1423,10,21,734,1279,0.3225806451612903,-545,0.36462990561351216
2012,1424,24,8,1908,522,0.75,1386,0.7851851851851852
2012,1425,6,26,395,1288,0.1875,-893,0.23469994058229351
2012,1426,23,8,1796,570,0.7419354838709677,1226,0.7590870667793744
2012,1427,16,14,1235,913,0.5333333333333333,322,0.5749534450651769
2012,1428,5,25,327,1335,0.16666666666666666,-1008,0.1967509025270758
2012,1429,16,15,1152,929,0.5161290322580645,223,0.553580009610764
2012,1430,16,12,1153,751,0.5714285714285714,402,0.6055672268907563
2012,1431,15,17,1035,986,0.46875,49,0.5121227115289461
2012,1433,28,6,1975,350,0.8235294117647058,1625,0.8494623655913979
2012,1434,20,11,1425,681,0.6451612903225806,744,0.6766381766381766
2012,1435,24,10,1822,657,0.7058823529411765,1165,0.7349737797498992
2012,1436,23,11,1652,634,0.6764705882352942,1018,0.7226596675415573
2012,1437,13,19,1017,1249,0.40625,-232,0.44880847308031774
2012,1438,22,9,1467,488,0.7096774193548387,979,0.7503836317135549
2012,1439,16,17,1145,1002,0.48484848484848486,143,0.5333022822543083
2012,1440,14,16,1109,1190,0.4666666666666667,-81,0.4823836450630709
2012,1441,15,18,1135,1118,0.45454545454545453,17,0.5037727474478473
2012,1442,16,14,1020,795,0.5333333333333333,225,0.5619834710743802
2012,1443,15,18,1015,1132,0.45454545454545453,-117,0.47275267815556593
2012,1444,13,20,946,1306,0.3939393939393939,-360,0.4200710479573712
2012,1447,25,6,1876,399,0.8064516129032258,1477,0.8246153846153846
2012,1448,13,18,960,1069,0.41935483870967744,-109,0.47313947757516017
2012,1449,21,10,1619,712,0.6774193548387096,907,0.6945516945516945
2012,1450,14,16,1029,1019,0.4666666666666667,10,0.50244140625
2012,1451,22,6,1736,372,0.7857142857142857,1364,0.8235294117647058
2012,1452,19,13,1499,793,0.59375,706,0.6540139616055847
2012,1453,13,15,848,924,0.4642857142857143,-76,0.4785553047404063
2012,1454,19,13,1326,713,0.59375,613,0.6503187837175086
2012,1455,26,5,2039,345,0.8387096774193549,1694,0.8552852348993288
2012,1456,5,26,353,1508,0.16129032258064516,-1155,0.18968296614723268
2012,1457,10,20,679,1170,0.3333333333333333,-491,0.3672255273120606
2012,1458,24,9,1606,502,0.7272727272727273,1104,0.7618595825426945
2012,1459,17,13,1188,720,0.5666666666666667,468,0.6226415094339622
2012,1460,12,19,783,994,0.3870967741935484,-211,0.44063027574563873
2012,1461,18,11,1257,552,0.6206896551724138,705,0.6948590381426202
2012,1462,21,12,1551,785,0.6363636363636364,766,0.6639554794520548
2012,1463,17,9,1194,539,0.6538461538461539,655,0.6889786497403346
2012,1464,14,15,972,974,0.4827586206896552,-2,0.499486125385406
2012,3102,6,24,390,1229,0.2,-839,0.24088943792464484
2012,3103,14,18,1159,1202,0.4375,-43,0.4908936891147819
2012,3104,12,19,833,1007,0.3870967741935484,-174,0.45271739130434785
2012,3105,16,12,1038,646,0.5714285714285714,392,0.6163895486935868
2012,3106,13,14,776,665,0.48148148148148145,111,0.5385149201943095
2012,3107,23,9,1388,490,0.71875,898,0.739084132055378
2012,3108,14,20,852,1029,0.4117647058823529,-177,0.4529505582137161
2012,3110,23,7,1383,365,0.7666666666666667,1018,0.7911899313501144
2012,3111,25,6,1758,305,0.8064516129032258,1453,0.8521570528356762
2012,3112,14,17,1011,1034,0.45161290322580644,-23,0.49437652811735944
2012,3113,20,11,1244,545,0.6451612903225806,699,0.6953605366126328
2012,3114,20,12,1202,657,0.625,545,0.6465841850457235
2012,3115,1,29,69,1383,0.03333333333333333,-1314,0.047520661157024795
2012,3116,23,8,1508,410,0.7419354838709677,1098,0.786235662148071
2012,3117,12,18,814,925,0.4,-111,0.46808510638297873
2012,3119,13,16,780,841,0.4482758620689655,-61,0.4811844540407156
2012,3120,13,17,852,903,0.43333333333333335,-51,0.48547008547008547
2012,3122,9,22,677,1387,0.2903225806451613,-710,0.3280038759689923
2012,3123,8,21,536,1158,0.27586206896551724,-622,0.31641086186540734
2012,3124,34,0,2680,0,1.0,2680,1.0
2012,3125,12,18,763,915,0.4,-152,0.4547079856972586
2012,3126,9,18,560,929,0.3333333333333333,-369,0.3760913364674278
2012,3127,13,18,768,861,0.41935483870967744,-93,0.4714548802946593
2012,3129,13,16,933,973,0.4482758620689655,-40,0.4895068205666317
2012,3130,7,23,460,1243,0.23333333333333334,-783,0.2701115678214915
2012,3131,23,8,1447,403,0.7419354838709677,1044,0.7821621621621622
2012,3132,23,6,1593,310,0.7931034482758621,1283,0.837099316868103
2012,3133,17,15,1261,928,0.53125,333,0.5760621288259479
2012,3135,15,12,950,696,0.5555555555555556,254,0.5771567436208992
2012,3136,14,15,909,876,0.4827586206896552,33,0.5092436974789916
2012,3137,5,25,289,1250,0.16666666666666666,-961,0.18778427550357374
2012,3138,9,22,594,1331,0.2903225806451613,-737,0.30857142857142855
2012,3139,12,17,795,889,0.41379310344827586,-94,0.47209026128266035
2012,3140,25,6,1880,322,0.8064516129032258,1558,0.8537693006357856
2012,3141,19,15,1405,997,0.5588235294117647,408,0.5849292256452956
2012,3142,17,14,1271,954,0.5483870967741935,317,0.5712359550561797
2012,3143,24,9,1720,583,0.7272727272727273,1137,0.7468519322622666
2012,3144,16,12,1035,764,0.5714285714285714,271,0.575319622012229
2012,3145,12,18,758,968,0.4,-210,0.4391657010428737
2012,3146,20,6,1326,321,0.7692307692307693,1005,0.8051001821493625
2012,3148,13,16,844,885,0.4482758620689655,-41,0.48814343551185657
2012,3149,14,14,1052,893,0.5,159,0.5408740359897172
2012,3150,16,13,1148,836,0.5517241379310345,312,0.5786290322580645
2012,3151,22,9,1475,454,0.7096774193548387,1021,0.7646448937273198
2012,3152,5,23,367,1125,0.17857142857142858,-758,0.24597855227882037
2012,3153,15,14,936,729,0.5172413793103449,207,0.5621621621621622
2012,3155,6,22,398,1121,0.21428571428571427,-723,0.26201448321263987
2012,3156,11,19,755,1026,0.36666666666666664,-271,0.4239191465468838
2012,3157,9,15,541,796,0.375,-255,0.40463724756918473
2012,3158,7,22,384,977,0.2413793103448276,-593,0.28214548126377664
2012,3159,8,22,555,1198,0.26666666666666666,-643,0.3166001140901312
2012,3160,18,13,1195,693,0.5806451612903226,502,0.6329449152542372
2012,3161,12,17,813,926,0.41379310344827586,-113,0.4675100632547441
2012,3162,3,25,196,1265,0.10714285714285714,-1069,0.13415468856947296
2012,3163,29,4,2273,243,0.8787878787878788,2030,0.9034181240063593
2012,3164,19,12,1293,630,0.6129032258064516,663,0.672386895475819
2012,3165,10,16,586,845,0.38461538461538464,-259,0.40950384346610763
2012,3166,20,12,1294,642,0.625,652,0.6683884297520661
2012,3167,6,22,486,1443,0.21428571428571427,-957,0.25194401244167963
2012,3168,11,19,760,1070,0.36666666666666664,-310,0.41530054644808745
2012,3169,17,13,1122,812,0.5666666666666667,310,0.5801447776628749
2012,3170,12,18,958,1166,0.4,-208,0.4510357815442561
2012,3171,6,22,386,1121,0.21428571428571427,-735,0.25613802256138024
2012,3172,22,9,1445,517,0.7096774193548387,928,0.736493374108053
2012,3173,23,6,1708,341,0.7931034482758621,1367,0.8335773548072231
2012,3174,30,1,2150,76,0.967741935483871,2074,0.9658580413297394
2012,3175,5,23,328,1202,0.17857142857142858,-874,0.21437908496732025
2012,3176,19,12,1237,638,0.6129032258064516,599,0.6597333333333333
2012,3177,22,10,1733,609,0.6875,1124,0.7399658411614005
2012,3178,20,13,1403,747,0.6060606060606061,656,0.6525581395348837
2012,3179,18,15,1127,832,0.5454545454545454,295,0.5752935171005615
2012,3180,18,13,1162,699,0.5806451612903226,463,0.6243954862976894
2012,3181,24,5,1861,298,0.8275862068965517,1563,0.8619731357109773
2012,3182,20,11,1476,623,0.6451612903225806,853,0.7031919961886612
2012,3183,21,8,1552,508,0.7241379310344828,1044,0.7533980582524272
2012,3184,12,16,833,939,0.42857142857142855,-106,0.4700902934537246
2012,3185,22,8,1569,472,0.7333333333333333,1097,0.7687408133268006
2012,3186,14,14,1055,808,0.5,247,0.5662909286097692
2012,3187,10,19,660,976,0.3448275862068966,-316,0.4034229828850856
2012,3188,18,11,1200,653,0.6206896551724138,547,0.6475984889368591
2012,3189,14,14,948,764,0.5,184,0.5537383177570093
2012,3190,8,22,581,1402,0.26666666666666666,-821,0.2929904185577408
2012,3191,5,25,319,1287,0.16666666666666666,-968,0.19863013698630136
2012,3192,13,18,864,937,0.41935483870967744,-73,0.47973348139922267
2012,3193,24,8,1389,370,0.75,1019,0.7896532120523024
2012,3194,15,12,904,614,0.5555555555555556,290,0.5955204216073782
2012,3195,28,2,2096,115,0.9333333333333333,1981,0.9479873360470376
2012,3196,19,12,1381,720,0.6129032258064516,661,0.6573060447405997
2012,3197,22,8,1650,461,0.7333333333333333,1189,0.7816200852676457
2012,3198,21,10,1416,548,0.6774193548387096,868,0.7209775967413442
2012,3199,14,17,1037,1049,0.45161290322580644,-12,0.4971236816874401
2012,3200,12,18,695,864,0.4,-169,0.44579858883899937
2012,3201,28,5,2165,326,0.8484848484848485,1839,0.8691288639100763
2012,3202,15,16,1000,893,0.4838709677419355,107,0.5282620179609087
2012,3203,11,18,711,985,0.3793103448275862,-274,0.41922169811320753
2012,3204,7,22,372,1106,0.2413793103448276,-734,0.2516914749661705
2012,3205,4,25,257,1217,0.13793103448275862,-960,0.17435549525101765
2012,3206,15,16,1050,909,0.4838709677419355,141,0.5359877488514548
2012,3207,22,8,1428,379,0.7333333333333333,1049,0.7902600996126176
2012,3208,22,8,1603,449,0.7333333333333333,1154,0.7811890838206628
2012,3209,8,22,567,1286,0.26666666666666666,-719,0.3059902860226659
2012,3210,24,8,1771,492,0.75,1279,0.7825894829871851
2012,3211,26,5,2061,281,0.8387096774193549,1780,0.8800170794192997
2012,3212,14,15,940,795,0.4827586206896552,145,0.5417867435158501
2012,3214,26,4,1767,203,0.8666666666666667,1564,0.8969543147208122
2012,3216,19,12,1172,575,0.6129032258064516,597,0.6708643388666286
2012,3217,17,11,1157,666,0.6071428571428571,491,0.6346681294569391
2012,3218,10,19,663,1043,0.3448275862068966,-380,0.3886283704572098
2012,3219,20,12,1493,723,0.625,770,0.6737364620938628
2012,3220,19,11,1477,773,0.6333333333333333,704,0.6564444444444445
2012,3221,18,14,1233,785,0.5625,448,0.6110009910802775
2012,3222,3,26,205,1330,0.10344827586206896,-1125,0.13355048859934854
2012,3224,24,8,1504,377,0.75,1127,0.7995746943115364
2012,3225,10,20,680,1162,0.3333333333333333,-482,0.3691639522258415
2012,3226,22,7,1391,376,0.7586206896551724,1015,0.787209960384833
2012,3227,16,13,1032,778,0.5517241379310345,254,0.5701657458563536
2012,3228,11,19,751,1152,0.36666666666666664,-401,0.394640042038886
2012,3229,18,12,1304,737,0.6,567,0.6389024987751103
2012,3231,6,24,387,1341,0.2,-954,0.22395833333333334
2012,3232,15,16,1004,871,0.4838709677419355,133,0.5354666666666666
2012,3233,13,18,923,1028,0.41935483870967744,-105,0.4730907227063045
2012,3234,19,11,1430,708,0.6333333333333333,722,0.6688493919550982
2012,3235,18,12,1239,648,0.6,591,0.6565977742448331
2012,3236,8,21,542,1233,0.27586206896551724,-691,0.30535211267605633
2012,3237,11,19,727,1025,0.36666666666666664,-298,0.4149543378995434
2012,3238,10,16,622,839,0.38461538461538464,-217,0.42573579739904177
2012,3239,11,20,827,1126,0.3548387096774194,-299,0.42345110087045573
2012,3240,3,25,220,1348,0.10714285714285714,-1128,0.14030612244897958
2012,3241,24,7,1563,385,0.7741935483870968,1178,0.8023613963039015
2012,3242,19,12,1445,689,0.6129032258064516,756,0.6771321462043112
2012,3243,19,13,1204,645,0.59375,559,0.6511627906976745
2012,3244,14,17,979,966,0.45161290322580644,13,0.5033419023136246
2012,3245,6,21,429,1119,0.2222222222222222,-690,0.2771317829457364
2012,3246,24,6,1849,382,0.8,1467,0.8287763334827432
2012,3247,14,17,863,954,0.45161290322580644,-91,0.47495872317006055
2012,3248,8,22,451,1143,0.26666666666666666,-692,0.28293601003764113
2012,3249,14,15,929,752,0.4827586206896552,177,0.552647233789411
2012,3250,17,13,1073,707,0.5666666666666667,366,0.602808988764045
2012,3251,21,8,1546,454,0.7241379310344828,1092,0.773
2012,3252,6,23,435,1264,0.20689655172413793,-829,0.25603296056503827
2012,3253,14,18,913,997,0.4375,-84,0.4780104712041885
2012,3254,21,10,1397,546,0.6774193548387096,851,0.718991250643335
2012,3255,7,22,503,1095,0.2413793103448276,-592,0.31476846057571967
2012,3256,17,15,1228,903,0.53125,325,0.5762552792116378
2012,3257,22,9,1622,514,0.7096774193548387,1108,0.7593632958801498
2012,3258,8,22,533,1208,0.26666666666666666,-675,0.3061458931648478
2012,3259,13,17,814,936,0.43333333333333335,-122,0.46514285714285714
2012,3260,12,17,906,997,0.41379310344827586,-91,0.47609038360483447
2012,3261,22,10,1392,579,0.6875,813,0.7062404870624048
2012,3263,7,23,397,1147,0.23333333333333334,-750,0.25712435233160624
2012,3264,16,15,1014,716,0.5161290322580645,298,0.5861271676300578
2012,3265,25,7,1707,365,0.78125,1342,0.8238416988416989
2012,3266,13,17,879,846,0.43333333333333335,33,0.5095652173913043
2012,3267,15,14,980,750,0.5172413793103449,230,0.5664739884393064
2012,3268,28,4,2242,278,0.875,1964,0.8896825396825396
2012,3269,8,21,486,1183,0.27586206896551724,-697,0.29119233073696826
2012,3270,23,7,1538,395,0.7666666666666667,1143,0.7956544231764098
2012,3271,11,17,641,804,0.39285714285714285,-163,0.44359861591695504
2012,3272,24,7,1767,374,0.7741935483870968,1393,0.8253152732368052
2012,3273,6,23,435,1295,0.20689655172413793,-860,0.2514450867052023
2012,3274,24,5,1911,323,0.8275862068965517,1588,0.8554162936436884
2012,3275,21,9,1530,528,0.7,1002,0.7434402332361516
2012,3276,20,11,1311,651,0.6451612903225806,660,0.6681957186544343
2012,3277,20,11,1448,642,0.6451612903225806,806,0.692822966507177
2012,3278,15,17,1088,1015,0.46875,73,0.5173561578697099
2012,3279,12,18,817,913,0.4,-96,0.4722543352601156
2012,3280,14,16,910,795,0.4666666666666667,115,0.533724340175953
2012,3281,13,18,898,996,0.41935483870967744,-98,0.47412882787750793
2012,3282,20,11,1472,729,0.6451612903225806,743,0.6687869150386188
2012,3283,22,8,1704,477,0.7333333333333333,1227,0.781292984869326
2012,3284,19,13,1230,730,0.59375,500,0.6275510204081632
2012,3285,14,14,968,751,0.5,217,0.5631180919139034
2012,3286,17,11,1245,634,0.6071428571428571,611,0.6625864821713677
2012,3287,10,19,697,1192,0.3448275862068966,-495,0.3689782953943886
2012,3288,6,24,421,1438,0.2,-1017,0.22646584185045723
2012,3290,15,13,1059,727,0.5357142857142857,332,0.5929451287793953
2012,3291,14,16,873,876,0.4666666666666667,-3,0.49914236706689535
2012,3292,26,6,1832,308,0.8125,1524,0.8560747663551402
2012,3293,12,18,923,1118,0.4,-195,0.45222929936305734
2012,3294,18,11,1157,552,0.6206896551724138,605,0.6770040959625512
2012,3295,9,20,635,1084,0.3103448275862069,-449,0.36940081442699246
2012,3296,14,17,880,878,0.45161290322580644,2,0.5005688282138794
2012,3298,18,13,1134,595,0.5806451612903226,539,0.6558704453441295
2012,3299,13,16,940,1026,0.4482758620689655,-86,0.47812817904374366
2012,3300,1,27,50,1305,0.03571428571428571,-1255,0.03690036900369004
2012,3301,18,15,1330,894,0.5454545454545454,436,0.5980215827338129
2012,3304,24,8,1825,482,0.75,1343,0.7910706545296923
2012,3305,6,23,452,1482,0.20689655172413793,-1030,0.23371251292657705
2012,3306,16,13,1026,668,0.5517241379310345,358,0.6056670602125147
2012,3307,10,20,609,1019,0.3333333333333333,-410,0.3740786240786241
2012,3308,5,24,302,1250,0.1724137931034483,-948,0.19458762886597938
2012,3310,13,19,842,937,0.40625,-95,0.47329960652051717
2012,3311,14,15,1067,846,0.4827586206896552,221,0.5577626764244642
2012,3312,13,17,812,917,0.43333333333333335,-105,0.46963562753036436
2012,3313,10,17,692,985,0.37037037037037035,-293,0.41264162194394755
2012,3314,20,11,1538,613,0.6451612903225806,925,0.7150162715016272
2012,3315,18,10,1323,532,0.6428571428571429,791,0.7132075471698113
2012,3316,13,17,824,872,0.43333333333333335,-48,0.4858490566037736
2012,3317,15,16,955,923,0.4838709677419355,32,0.5085197018104366
2012,3318,8,22,586,1293,0.26666666666666666,-707,0.31186801490154337
2012,3319,8,20,600,1248,0.2857142857142857,-648,0.3246753246753247
2012,3320,16,14,1098,824,0.5333333333333333,274,0.5712799167533819
2012,3321,14,16,968,955,0.4666666666666667,13,0.5033801352054083
2012,3322,3,22,226,1353,0.12,-1127,0.14312856238125396
2012,3323,30,3,2428,198,0.9090909090909091,2230,0.9246001523229246
2012,3324,10,17,637,885,0.37037037037037035,-248,0.4185282522996058
2012,3325,14,18,928,969,0.4375,-41,0.48919346336320507
2012,3326,25,6,1951,377,0.8064516129032258,1574,0.8380584192439863
2012,3328,20,12,1491,759,0.625,732,0.6626666666666666
2012,3329,16,12,1150,671,0.5714285714285714,479,0.6315211422295443
2012,3330,11,21,778,1226,0.34375,-448,0.38822355289421157
2012,3331,19,10,1487,627,0.6551724137931034,860,0.7034058656575213
2012,3332,15,16,1221,980,0.4838709677419355,241,0.55474784189005
2012,3333,16,12,1113,682,0.5714285714285714,431,0.6200557103064067
2012,3334,17,13,1280,783,0.5666666666666667,497,0.6204556471158507
2012,3335,13,15,829,686,0.4642857142857143,143,0.5471947194719472
2012,3336,24,6,1856,408,0.8,1448,0.8197879858657244
2012,3337,14,15,952,785,0.4827586206896552,167,0.5480713874496258
2012,3338,8,22,558,1146,0.26666666666666666,-588,0.3274647887323944
2012,3339,12,20,861,1187,0.375,-326,0.42041015625
2012,3340,13,14,930,916,0.48148148148148145,14,0.5037919826652221
2012,3341,16,15,1045,808,0.5161290322580645,237,0.5639503507825149
2012,3342,11,15,674,700,0.4230769230769231,-26,0.49053857350800584
2012,3343,24,4,1770,255,0.8571428571428571,1515,0.8740740740740741
2012,3344,13,17,831,812,0.43333333333333335,19,0.5057821059038344
2012,3345,24,8,1622,470,0.75,1152,0.7753346080305927
2012,3346,22,9,1523,590,0.7096774193548387,933,0.7207761476573592
2012,3347,14,15,970,914,0.4827586206896552,56,0.5148619957537155
2012,3348,1,28,52,1374,0.034482758620689655,-1322,0.0364656381486676
2012,3349,16,15,1051,802,0.5161290322580645,249,0.5671883432271991
2012,3350,22,8,1541,494,0.7333333333333333,1047,0.7572481572481572
2012,3351,11,19,703,967,0.36666666666666664,-264,0.42095808383233535
2012,3352,18,13,1309,810,0.5806451612903226,499,0.6177442189712128
2012,3353,22,9,1429,446,0.7096774193548387,983,0.7621333333333333
2012,3354,11,16,795,826,0.4074074074074074,-31,0.4904380012338063
2012,3355,23,8,1701,406,0.7419354838709677,1295,0.8073089700996677
2012,3356,8,22,603,1283,0.26666666666666666,-680,0.3197242841993637
2012,3357,25,7,1702,373,0.78125,1329,0.8202409638554217
2012,3358,15,11,999,605,0.5769230769230769,394,0.6228179551122195
2012,3359,20,12,1291,640,0.625,651,0.6685655100983946
2012,3360,21,8,1499,407,0.7241379310344828,1092,0.7864637985309548
2012,3361,25,6,1705,328,0.8064516129032258,1377,0.838662075750123
2012,3362,5,25,372,1480,0.16666666666666666,-1108,0.20086393088552915
2012,3363,11,19,778,1155,0.36666666666666664,-377,0.4024831867563373
2012,3364,17,15,1001,713,0.53125,288,0.5840140023337222
2012,3365,12,18,921,1064,0.4,-143,0.46397984886649873
2012,3366,7,20,429,897,0.25925925925925924,-468,0.3235294117647059
2012,3367,9,20,618,1133,0.3103448275862069,-515,0.35294117647058826
2012,3368,8,18,563,1034,0.3076923076923077,-471,0.3525360050093926
2012,3369,6,22,351,1106,0.21428571428571427,-755,0.24090597117364448
2012,3370,18,11,1360,721,0.6206896551724138,639,0.6535319557904854
2012,3371,8,23,508,1183,0.25806451612903225,-675,0.3004139562389119
2012,3372,21,9,1392,531,0.7,861,0.7238689547581904
2012,3373,12,17,778,896,0.41379310344827586,-118,0.4647550776583035
2012,3374,14,17,905,932,0.45161290322580644,-27,0.492651061513337
2012,3375,15,13,961,657,0.5357142857142857,304,0.5939431396786156
2012,3376,23,9,1459,472,0.71875,987,0.755567063697566
2012,3377,19,7,1245,351,0.7307692307692307,894,0.7800751879699248
2012,3378,17,15,1133,894,0.53125,239,0.5589541193882586
2012,3379,12,18,800,1040,0.4,-240,0.43478260869565216
2012,3380,12,13,738,679,0.48,59,0.5208186309103741
2012,3381,5,23,336,1299,0.17857142857142858,-963,0.20550458715596331
2012,3382,29,3,1916,146,0.90625,1770,0.9291949563530553
2012,3383,4,25,228,1176,0.13793103448275862,-948,0.1623931623931624
2012,3384,14,16,1006,951,0.4666666666666667,55,0.514052120592744
2012,3385,22,9,1389,513,0.7096774193548387,876,0.7302839116719243
2012,3386,21,10,1416,604,0.6774193548387096,812,0.700990099009901
2012,3387,9,20,572,1105,0.3103448275862069,-533,0.34108527131782945
2012,3388,20,10,1351,620,0.6666666666666666,731,0.6854388635210553
2012,3389,5,26,326,1336,0.16129032258064516,-1010,0.19614921780986763
2012,3390,31,1,2404,58,0.96875,2346,0.9764419171405362
2012,3391,22,10,1566,596,0.6875,970,0.7243293246993524
2012,3392,4,26,215,1085,0.13333333333333333,-870,0.16538461538461538
2012,3393,18,14,1379,807,0.5625,572,0.630832570905764
2012,3394,9,20,641,1125,0.3103448275862069,-484,0.36296715741789354
2012,3395,16,14,1047,756,0.5333333333333333,291,0.5806988352745425
2012,3396,21,9,1452,509,0.7,943,0.7404385517593065
2012,3397,24,8,1862,525,0.75,1337,0.7800586510263929
2012,3398,8,20,606,1289,0.2857142857142857,-683,0.31978891820580474
2012,3399,16,16,1160,931,0.5,229,0.5547584887613582
2012,3400,18,13,1335,765,0.5806451612903226,570,0.6357142857142857
2012,3401,22,10,1596,574,0.6875,1022,0.7354838709677419
2012,3402,13,14,991,774,0.48148148148148145,217,0.5614730878186969
2012,3403,19,13,1422,719,0.59375,703,0.664175618869687
2012,3404,23,8,2014,500,0.7419354838709677,1514,0.8011137629276054
2012,3405,21,9,1365,529,0.7,836,0.7206969376979937
2012,3406,16,14,1007,721,0.5333333333333333,286,0.5827546296296297
2012,3407,2,25,118,1225,0.07407407407407407,-1107,0.08786299329858525
2012,3408,20,10,1262,564,0.6666666666666666,698,0.6911281489594743
2012,3409,12,15,799,807,0.4444444444444444,-8,0.4975093399750934
2012,3410,10,17,583,840,0.37037037037037035,-257,0.4096978215038651
2012,3411,5,26,279,1186,0.16129032258064516,-907,0.19044368600682593
2012,3412,19,11,1097,553,0.6333333333333333,544,0.6648484848484848
2012,3413,17,12,1098,687,0.5862068965517241,411,0.6151260504201681
2012,3414,13,17,912,1025,0.43333333333333335,-113,0.47083118224057824
2012,3415,5,24,360,1239,0.1724137931034483,-879,0.225140712945591
2012,3416,12,17,721,861,0.41379310344827586,-140,0.4557522123893805
2012,3417,14,16,968,895,0.4666666666666667,73,0.5195920558239399
2012,3418,6,22,405,1046,0.21428571428571427,-641,0.27911784975878706
2012,3419,9,21,596,1202,0.3,-606,0.3314794215795328
2012,3420,17,15,1137,794,0.53125,343,0.5888140859658209
2012,3421,4,23,294,1394,0.14814814814814814,-1100,0.17417061611374407
2012,3422,4,25,246,1192,0.13793103448275862,-946,0.17107093184979139
2012,3423,20,12,1400,618,0.625,782,0.6937561942517344
2012,3424,22,9,1447,493,0.7096774193548387,954,0.7458762886597938
2012,3425,18,12,1222,698,0.6,524,0.6364583333333333
2012,3426,5,21,334,1111,0.19230769230769232,-777,0.23114186851211072
2012,3427,8,21,505,1143,0.27586206896551724,-638,0.30643203883495146
2012,3428,15,15,995,767,0.5,228,0.5646992054483542
2012,3429,20,9,1506,596,0.6896551724137931,910,0.7164605137963844
2012,3430,14,15,919,791,0.4827586206896552,128,0.5374269005847954
2012,3431,29,3,2011,141,0.90625,1870,0.9344795539033457
2012,3433,17,14,1213,820,0.5483870967741935,393,0.5966551893753075
2012,3434,9,21,566,980,0.3,-414,0.36610608020698576
2012,3435,22,9,1697,532,0.7096774193548387,1165,0.7613279497532526
2012,3436,10,20,661,1113,0.3333333333333333,-452,0.37260428410372043
2012,3437,16,14,1006,715,0.5333333333333333,291,0.5845438698431145
2012,3438,22,10,1442,579,0.6875,863,0.7135081642751113
2012,3439,7,23,427,1124,0.23333333333333334,-697,0.2753062540296583
2012,3441,14,17,833,796,0.45161290322580644,37,0.5113566605279313
2012,3442,9,18,674,1088,0.3333333333333333,-414,0.38251986379114644
2012,3443,9,21,572,1117,0.3,-545,0.33866193013617524
2012,3444,8,22,584,1284,0.26666666666666666,-700,0.31263383297644537
2012,3447,2,27,115,1431,0.06896551724137931,-1316,0.07438551099611902
2012,3448,19,13,1449,756,0.59375,693,0.6571428571428571
2012,3449,17,13,1165,742,0.5666666666666667,423,0.610907184058731
2012,3450,13,20,919,1070,0.3939393939393939,-151,0.4620412267471091
2012,3451,2,27,154,1641,0.06896551724137931,-1487,0.08579387186629527
2012,3452,23,9,1572,474,0.71875,1098,0.7683284457478006
2012,3453,30,1,2261,58,0.967741935483871,2203,0.97498921949116
2012,3454,9,21,600,1137,0.3,-537,0.3454231433506045
2012,3455,19,12,1333,642,0.6129032258064516,691,0.6749367088607595
2012,3456,9,20,678,1299,0.3103448275862069,-621,0.34294385432473445
2012,3457,18,13,1387,772,0.5806451612903226,615,0.6424270495599814
2012,3458,9,20,606,1113,0.3103448275862069,-507,0.3525305410122164
2012,3459,11,18,712,977,0.3793103448275862,-265,0.4215512137359384
2012,3460,20,12,1462,752,0.625,710,0.6603432700993677
2012,3461,10,17,674,891,0.37037037037037035,-217,0.4306709265175719
2012,3462,8,20,554,1096,0.2857142857142857,-542,0.33575757575757575
2012,3463,15,12,1097,659,0.5555555555555556,438,0.6247152619589977
2012,3464,10,20,694,1244,0.3333333333333333,-550,0.35810113519091846
2013,1102,15,13,1121,809,0.5357142857142857,312,0.5808290155440414
2013,1103,25,6,1830,400,0.8064516129032258,1430,0.820627802690583
2013,1104,20,12,1270,733,0.625,537,0.6340489266100848
2013,1105,9,20,618,1168,0.3103448275862069,-550,0.3460246360582307
2013,1106,9,22,613,1293,0.2903225806451613,-680,0.3216159496327387
2013,1107,24,10,1601,589,0.7058823529411765,1012,0.7310502283105023
2013,1108,9,23,629,1263,0.28125,-634,0.3324524312896406
2013,1110,10,20,666,1069,0.3333333333333333,-403,0.38386167146974065
2013,1111,13,16,979,1075,0.4482758620689655,-96,0.47663096397273613
2013,1112,25,7,1868,477,0.78125,1391,0.796588486140725
2013,1113,21,12,1562,781,0.6363636363636364,781,0.6666666666666666
2013,1114,16,15,1144,892,0.5161290322580645,252,0.5618860510805501
2013,1115,16,14,1133,747,0.5333333333333333,386,0.6026595744680852
2013,1116,19,13,1548,810,0.59375,738,0.6564885496183206
2013,1117,18,12,1317,734,0.6,583,0.6421257922964407
2013,1119,15,15,1172,983,0.5,189,0.5438515081206496
2013,1120,9,23,622,1452,0.28125,-830,0.29990356798457085
2013,1122,6,23,476,1546,0.20689655172413793,-1070,0.2354104846686449
2013,1123,14,15,1019,862,0.4827586206896552,157,0.5417331206804891
2013,1124,17,14,1325,949,0.5483870967741935,376,0.5826737027264732
2013,1125,24,6,1905,402,0.8,1503,0.8257477243172952
2013,1126,12,20,887,1209,0.375,-322,0.4231870229007634
2013,1127,2,27,119,1481,0.06896551724137931,-1362,0.074375
2013,1129,19,10,1423,638,0.6551724137931034,785,0.6904415332362931
2013,1130,16,17,1135,1080,0.48484848484848486,55,0.5124153498871332
2013,1131,17,12,1245,727,0.5862068965517241,518,0.6313387423935092
2013,1132,11,19,709,1170,0.36666666666666664,-461,0.3773283661522086
2013,1133,16,16,1179,963,0.5,216,0.5504201680672269
2013,1135,12,15,810,867,0.4444444444444444,-57,0.48300536672629696
2013,1136,19,11,1498,725,0.6333333333333333,773,0.6738641475483581
2013,1137,27,5,1840,312,0.84375,1528,0.8550185873605948
2013,1138,12,20,874,1241,0.375,-367,0.4132387706855792
2013,1139,25,8,1803,455,0.7575757575757576,1348,0.7984942426926483
2013,1140,20,11,1611,742,0.6451612903225806,869,0.6846578835529111
2013,1141,10,20,687,1329,0.3333333333333333,-642,0.34077380952380953
2013,1142,16,13,1110,772,0.5517241379310345,338,0.589798087141339
2013,1143,20,11,1394,700,0.6451612903225806,694,0.6657115568290354
2013,1144,11,19,869,1185,0.36666666666666664,-316,0.4230769230769231
2013,1145,18,13,1381,882,0.5806451612903226,499,0.6102518780380026
2013,1146,11,17,935,1144,0.39285714285714285,-209,0.4497354497354497
2013,1148,13,17,1032,1154,0.43333333333333335,-122,0.47209515096065874
2013,1149,16,12,1242,737,0.5714285714285714,505,0.627589691763517
2013,1150,21,11,1463,700,0.65625,763,0.6763754045307443
2013,1151,11,19,831,1191,0.36666666666666664,-360,0.41097922848664686
2013,1152,7,21,477,1278,0.25,-801,0.2717948717948718
2013,1153,22,11,1620,579,0.6666666666666666,1041,0.7366984993178718
2013,1154,6,22,455,1322,0.21428571428571427,-867,0.25604952166572875
2013,1155,13,18,905,1002,0.41935483870967744,-97,0.4745673833245936
2013,1156,11,18,810,1014,0.3793103448275862,-204,0.4440789473684211
2013,1157,11,15,762,925,0.4230769230769231,-163,0.45168938944872555
2013,1158,24,9,1691,480,0.7272727272727273,1211,0.7789037309995394
2013,1159,11,21,813,1220,0.34375,-407,0.3999016232169208
2013,1160,21,11,1500,681,0.65625,819,0.687757909215956
2013,1161,23,8,1720,520,0.7419354838709677,1200,0.7678571428571429
2013,1162,10,16,658,939,0.38461538461538464,-281,0.41202254226675017
2013,1163,20,10,1465,631,0.6666666666666666,834,0.6989503816793893
2013,1164,7,24,485,1452,0.22580645161290322,-967,0.2503871966959215
2013,1165,12,18,885,1052,0.4,-167,0.4568921011874032
2013,1166,27,7,2111,452,0.7941176470588235,1659,0.8236441669918064
2013,1167,10,16,733,966,0.38461538461538464,-233,0.43143025309005295
2013,1168,12,18,1014,1244,0.4,-230,0.44906997342781224
2013,1169,12,17,950,1170,0.41379310344827586,-220,0.4481132075471698
2013,1170,12,15,804,899,0.4444444444444444,-95,0.4721080446271286
2013,1171,8,19,543,1096,0.2962962962962963,-553,0.33129957291031115
2013,1172,25,7,1889,450,0.78125,1439,0.8076100897819581
2013,1173,17,14,1299,926,0.5483870967741935,373,0.5838202247191011
2013,1174,19,14,1392,884,0.5757575757575758,508,0.6115992970123023
2013,1175,13,18,817,1011,0.41935483870967744,-194,0.44693654266958427
2013,1176,21,9,1452,511,0.7,941,0.7396841569027
2013,1177,11,21,886,1398,0.34375,-512,0.38791593695271454
2013,1178,18,12,1498,812,0.6,686,0.6484848484848484
2013,1179,14,17,1058,1142,0.45161290322580644,-84,0.4809090909090909
2013,1180,13,18,832,1121,0.41935483870967744,-289,0.42601126472094214
2013,1181,27,5,2143,362,0.84375,1781,0.8554890219560878
2013,1182,8,22,637,1391,0.26666666666666666,-754,0.3141025641025641
2013,1183,11,20,769,1108,0.3548387096774194,-339,0.4096963239211508
2013,1184,22,9,1643,616,0.7096774193548387,1027,0.7273129703408587
2013,1185,13,18,716,982,0.41935483870967744,-266,0.4216725559481743
2013,1186,10,21,772,1374,0.3225806451612903,-602,0.3597390493942218
2013,1187,14,12,1095,854,0.5384615384615384,241,0.5618265777321704
2013,1188,7,18,451,1090,0.28,-639,0.2926670992861778
2013,1189,19,11,1345,696,0.6333333333333333,649,0.6589906908378246
2013,1190,9,22,644,1256,0.2903225806451613,-612,0.3389473684210526
2013,1191,17,14,1199,876,0.5483870967741935,323,0.5778313253012048
2013,1192,7,24,525,1509,0.22580645161290322,-984,0.2581120943952802
2013,1193,19,15,1214,837,0.5588235294117647,377,0.5919063871282302
2013,1194,13,18,934,1075,0.41935483870967744,-141,0.4649079143852663
2013,1195,22,10,1605,710,0.6875,895,0.693304535637149
2013,1196,26,7,1932,432,0.7878787878787878,1500,0.817258883248731
2013,1197,6,23,409,1410,0.20689655172413793,-1001,0.22484881803188564
2013,1198,18,14,1320,890,0.5625,430,0.5972850678733032
2013,1199,18,15,1313,899,0.5454545454545454,414,0.5935804701627486
2013,1200,7,24,520,1477,0.22580645161290322,-957,0.26039058587881825
2013,1201,9,19,544,1081,0.32142857142857145,-537,0.33476923076923076
2013,1202,5,24,355,1348,0.1724137931034483,-993,0.20845566647093364
2013,1203,13,17,959,1029,0.43333333333333335,-70,0.4823943661971831
2013,1204,12,19,805,1079,0.3870967741935484,-274,0.4272823779193206
2013,1205,18,12,1229,708,0.6,521,0.6344863190500775
2013,1206,18,14,1205,931,0.5625,274,0.5641385767790262
2013,1207,25,6,1667,335,0.8064516129032258,1332,0.8326673326673326
2013,1208,15,17,960,986,0.46875,-26,0.4933196300102775
2013,1209,14,16,992,1036,0.4666666666666667,-44,0.4891518737672584
2013,1210,16,15,1098,895,0.5161290322580645,203,0.5509282488710486
2013,1211,30,2,2321,137,0.9375,2184,0.9442636289666395
2013,1214,14,17,935,1001,0.45161290322580644,-66,0.48295454545454547
2013,1216,17,13,1080,729,0.5666666666666667,351,0.5970149253731343
2013,1217,18,9,1307,554,0.6666666666666666,753,0.7023105857066093
2013,1218,16,14,1238,929,0.5333333333333333,309,0.5712967235809875
2013,1219,15,13,1154,804,0.5357142857142857,350,0.5893769152196119
2013,1220,6,25,426,1373,0.1935483870967742,-947,0.2367982212340189
2013,1221,12,18,819,1015,0.4,-196,0.44656488549618323
2013,1222,18,12,1456,859,0.6,597,0.6289416846652268
2013,1223,11,17,741,965,0.39285714285714285,-224,0.4343493552168816
2013,1224,6,23,354,1133,0.20689655172413793,-779,0.23806321452589105
2013,1225,11,18,819,1140,0.3793103448275862,-321,0.41807044410413474
2013,1226,5,24,359,1281,0.1724137931034483,-922,0.21890243902439024
2013,1227,16,15,1040,884,0.5161290322580645,156,0.5405405405405406
2013,1228,21,12,1524,741,0.6363636363636364,783,0.6728476821192053
2013,1229,18,15,1457,1003,0.5454545454545454,454,0.5922764227642277
2013,1231,27,6,2236,404,0.8181818181818182,1832,0.8469696969696969
2013,1232,17,14,1164,873,0.5483870967741935,291,0.5714285714285714
2013,1233,20,13,1659,1004,0.6060606060606061,655,0.6229815996995869
2013,1234,21,12,1559,763,0.6363636363636364,796,0.6714039621016366
2013,1235,22,11,1807,821,0.6666666666666666,986,0.6875951293759512
2013,1236,14,17,1059,989,0.45161290322580644,70,0.51708984375
2013,1237,4,26,312,1632,0.13333333333333333,-1320,0.16049382716049382
2013,1238,11,18,802,1118,0.3793103448275862,-316,0.41770833333333335
2013,1239,12,18,855,1159,0.4,-304,0.42452830188679247
2013,1240,15,11,1003,682,0.5769230769230769,321,0.5952522255192878
2013,1241,20,14,1363,853,0.5882352941176471,510,0.615072202166065
2013,1242,29,5,2240,323,0.8529411764705882,1917,0.8739758095981272
2013,1243,26,7,1849,417,0.7878787878787878,1432,0.8159752868490733
2013,1244,3,27,225,1606,0.1,-1381,0.12288367012561442
2013,1245,19,13,1438,837,0.59375,601,0.632087912087912
2013,1246,21,11,1683,656,0.65625,1027,0.7195382642154767
2013,1247,21,9,1600,573,0.7,1027,0.7363092498849517
2013,1248,18,15,1346,917,0.5454545454545454,429,0.5947856827220503
2013,1249,3,28,234,1628,0.0967741935483871,-1394,0.12567132116004295
2013,1250,20,9,1543,576,0.6896551724137931,967,0.7281736668239736
2013,1251,12,20,890,1266,0.375,-376,0.41280148423005564
2013,1252,11,18,852,1154,0.3793103448275862,-302,0.4247258225324028
2013,1253,17,13,1266,802,0.5666666666666667,464,0.6121856866537717
2013,1254,20,13,1658,964,0.6060606060606061,694,0.6323417238749046
2013,1255,6,25,492,1604,0.1935483870967742,-1112,0.23473282442748092
2013,1256,25,6,1834,395,0.8064516129032258,1439,0.822790489008524
2013,1257,29,5,2146,355,0.8529411764705882,1791,0.8580567772890844
2013,1258,10,22,734,1283,0.3125,-549,0.3639067922657412
2013,1259,21,11,1447,693,0.65625,754,0.6761682242990654
2013,1260,14,16,945,986,0.4666666666666667,-41,0.4893837389953392
2013,1261,19,12,1398,796,0.6129032258064516,602,0.6371923427529627
2013,1263,10,19,719,1172,0.3448275862068966,-453,0.38022210470650447
2013,1264,14,18,863,1002,0.4375,-139,0.46273458445040216
2013,1265,10,21,767,1278,0.3225806451612903,-511,0.3750611246943765
2013,1266,23,8,1676,463,0.7419354838709677,1213,0.7835437120149603
2013,1267,12,19,906,1222,0.3870967741935484,-316,0.4257518796992481
2013,1268,22,12,1660,762,0.6470588235294118,898,0.685383980181668
2013,1269,21,11,1572,778,0.65625,794,0.668936170212766
2013,1270,11,17,788,1029,0.39285714285714285,-241,0.4336818932305999
2013,1271,2,26,122,1413,0.07142857142857142,-1291,0.07947882736156352
2013,1272,30,4,2299,280,0.8823529411764706,2019,0.8914307871267934
2013,1273,21,11,1487,603,0.65625,884,0.7114832535885167
2013,1274,27,6,1941,366,0.8181818181818182,1575,0.8413524057217165
2013,1275,8,22,564,1306,0.26666666666666666,-742,0.3016042780748663
2013,1276,25,7,1932,448,0.78125,1484,0.8117647058823529
2013,1277,24,8,1663,497,0.75,1166,0.7699074074074074
2013,1278,20,12,1499,691,0.625,808,0.6844748858447488
2013,1279,26,8,2088,560,0.7647058823529411,1528,0.7885196374622356
2013,1280,10,22,712,1228,0.3125,-516,0.3670103092783505
2013,1281,23,10,1844,672,0.696969696969697,1172,0.7329093799682035
2013,1282,7,24,496,1355,0.22580645161290322,-859,0.26796326310102647
2013,1283,9,22,598,1197,0.2903225806451613,-599,0.3331476323119777
2013,1284,10,21,749,1260,0.3225806451612903,-511,0.37282229965156793
2013,1285,23,6,1634,410,0.7931034482758621,1224,0.799412915851272
2013,1286,11,17,786,1153,0.39285714285714285,-367,0.40536358947911294
2013,1287,13,18,1007,1174,0.41935483870967744,-167,0.46171480972031176
2013,1288,17,15,1220,942,0.53125,278,0.5642923219241444
2013,1290,5,23,387,1378,0.17857142857142858,-991,0.21926345609065157
2013,1291,18,14,1377,856,0.5625,521,0.6166592028660994
2013,1292,28,5,2063,288,0.8484848484848485,1775,0.8774989366227137
2013,1293,19,10,1424,669,0.6551724137931034,755,0.6803631151457239
2013,1294,11,18,839,1128,0.3793103448275862,-289,0.42653787493645146
2013,1295,22,9,1554,491,0.7096774193548387,1063,0.7599022004889976
2013,1296,4,25,278,1269,0.13793103448275862,-991,0.17970265029088558
2013,1297,11,16,710,872,0.4074074074074074,-162,0.44879898862199746
2013,1298,7,23,455,1179,0.23333333333333334,-724,0.2784577723378213
2013,1299,18,16,1226,869,0.5294117647058824,357,0.5852028639618139
2013,1300,19,9,1287,492,0.6785714285714286,795,0.7234401349072512
2013,1301,24,10,1953,683,0.7058823529411765,1270,0.7408952959028832
2013,1303,10,19,807,1248,0.3448275862068966,-441,0.3927007299270073
2013,1304,15,18,983,940,0.45454545454545453,43,0.5111804472178887
2013,1305,11,19,820,1188,0.36666666666666664,-368,0.40836653386454186
2013,1306,8,20,558,1096,0.2857142857142857,-538,0.3373639661426844
2013,1307,29,5,2005,288,0.8529411764705882,1717,0.8744003488879197
2013,1308,23,10,1627,617,0.696969696969697,1010,0.7250445632798574
2013,1309,4,18,322,1089,0.18181818181818182,-767,0.22820694542877393
2013,1310,19,13,1435,931,0.59375,504,0.606508875739645
2013,1311,9,21,691,1329,0.3,-638,0.3420792079207921
2013,1312,12,13,836,853,0.48,-17,0.49496743635287155
2013,1313,21,11,1470,662,0.65625,808,0.6894934333958724
2013,1314,23,10,1864,650,0.696969696969697,1214,0.741447891805887
2013,1315,14,16,992,1003,0.4666666666666667,-11,0.49724310776942354
2013,1316,12,19,915,1127,0.3870967741935484,-212,0.44809010773751223
2013,1317,11,19,765,1199,0.36666666666666664,-434,0.3895112016293279
2013,1318,20,12,1432,798,0.625,634,0.6421524663677131
2013,1319,11,21,785,1355,0.34375,-570,0.36682242990654207
2013,1320,17,14,1219,792,0.5483870967741935,427,0.6061660865241174
2013,1321,13,19,915,1028,0.40625,-113,0.4709212557900154
2013,1322,19,8,1528,577,0.7037037037037037,951,0.7258907363420427
2013,1323,25,9,1875,517,0.7352941176470589,1358,0.7838628762541806
2013,1324,14,16,1106,1067,0.4666666666666667,39,0.5089737689829729
2013,1325,24,9,1824,583,0.7272727272727273,1241,0.7577897798088907
2013,1326,26,7,1851,436,0.7878787878787878,1415,0.8093572365544381
2013,1328,20,11,1499,706,0.6451612903225806,793,0.6798185941043083
2013,1329,24,8,1788,528,0.75,1260,0.772020725388601
2013,1330,5,25,378,1569,0.16666666666666666,-1191,0.1941448382126348
2013,1331,17,14,1286,874,0.5483870967741935,412,0.5953703703703703
2013,1332,26,8,1975,464,0.7647058823529411,1511,0.8097580975809758
2013,1333,14,18,1094,1210,0.4375,-116,0.4748263888888889
2013,1334,20,12,1418,721,0.625,697,0.6629266012155213
2013,1335,9,22,619,1328,0.2903225806451613,-709,0.3179250128402671
2013,1336,10,21,702,1208,0.3225806451612903,-506,0.3675392670157068
2013,1337,11,18,692,1131,0.3793103448275862,-439,0.37959407569939657
2013,1338,24,8,1744,483,0.75,1261,0.7831162999550966
2013,1339,9,21,617,1161,0.3,-544,0.34701912260967377
2013,1340,6,20,474,1293,0.23076923076923078,-819,0.26825127334465193
2013,1341,12,19,819,1085,0.3870967741935484,-266,0.43014705882352944
2013,1342,5,24,339,1383,0.1724137931034483,-1044,0.19686411149825783
2013,1343,16,11,1089,643,0.5925925925925926,446,0.6287528868360277
2013,1344,17,14,1174,905,0.5483870967741935,269,0.5646945646945647
2013,1345,15,17,1060,1028,0.46875,32,0.5076628352490421
2013,1346,15,16,1104,1121,0.4838709677419355,-17,0.49617977528089885
2013,1347,10,19,686,1198,0.3448275862068966,-512,0.3641188959660297
2013,1348,8,21,574,1212,0.27586206896551724,-638,0.3213885778275476
2013,1349,4,25,298,1443,0.13793103448275862,-1145,0.17116599655370476
2013,1350,18,14,1406,847,0.5625,559,0.6240568131380382
2013,1351,18,14,1248,801,0.5625,447,0.6090775988286969
2013,1352,23,10,1725,628,0.696969696969697,1097,0.7331066723331917
2013,1353,15,16,1082,945,0.4838709677419355,137,0.5337937839171188
2013,1354,4,24,285,1356,0.14285714285714285,-1071,0.1736745886654479
2013,1355,22,9,1653,599,0.7096774193548387,1054,0.7340142095914742
2013,1356,13,17,881,983,0.43333333333333335,-102,0.47263948497854075
2013,1357,9,20,693,1343,0.3103448275862069,-650,0.34037328094302555
2013,1358,14,17,929,978,0.45161290322580644,-49,0.4871525957000524
2013,1359,10,21,657,1241,0.3225806451612903,-584,0.34615384615384615
2013,1360,14,18,977,1059,0.4375,-82,0.47986247544204325
2013,1361,20,10,1440,608,0.6666666666666666,832,0.703125
2013,1362,13,16,975,1020,0.4482758620689655,-45,0.48872180451127817
2013,1363,8,20,584,1124,0.2857142857142857,-540,0.34192037470725994
2013,1364,9,20,634,1202,0.3103448275862069,-568,0.3453159041394335
2013,1365,19,11,1411,762,0.6333333333333333,649,0.6493327197422918
2013,1366,17,14,979,719,0.5483870967741935,260,0.5765606595995288
2013,1367,14,17,1084,1056,0.45161290322580644,28,0.5065420560747663
2013,1368,11,18,792,1011,0.3793103448275862,-219,0.43926788685524126
2013,1369,15,16,1189,1072,0.4838709677419355,117,0.5258735072976559
2013,1370,7,22,479,1429,0.2413793103448276,-950,0.2510482180293501
2013,1371,15,18,1049,1087,0.45454545454545453,-38,0.4911048689138577
2013,1372,23,4,1478,227,0.8518518518518519,1251,0.8668621700879765
2013,1373,8,24,513,1408,0.25,-895,0.2670484122852681
2013,1374,14,17,960,1023,0.45161290322580644,-63,0.48411497730711045
2013,1375,16,12,1164,741,0.5714285714285714,423,0.6110236220472441
2013,1376,14,18,1088,1027,0.4375,61,0.5144208037825059
2013,1377,8,20,692,1256,0.2857142857142857,-564,0.35523613963039014
2013,1378,12,19,849,973,0.3870967741935484,-124,0.4659714599341383
2013,1379,23,9,1715,591,0.71875,1124,0.7437120555073721
2013,1380,20,9,1405,526,0.6896551724137931,879,0.7276022786121181
2013,1381,9,20,676,1227,0.3103448275862069,-551,0.35522858644245925
2013,1382,14,15,1111,998,0.4827586206896552,113,0.5267899478425794
2013,1383,12,18,912,1196,0.4,-284,0.43263757115749524
2013,1384,5,24,334,1470,0.1724137931034483,-1136,0.18514412416851442
2013,1385,16,15,1119,906,0.5161290322580645,213,0.5525925925925926
2013,1386,18,13,1286,803,0.5806451612903226,483,0.6156055528961225
2013,1387,27,6,1885,382,0.8181818181818182,1503,0.831495368328187
2013,1388,26,6,2010,386,0.8125,1624,0.83889816360601
2013,1389,9,21,611,1177,0.3,-566,0.3417225950782998
2013,1390,18,14,1341,944,0.5625,397,0.586870897155361
2013,1391,14,16,1051,1048,0.4666666666666667,3,0.5007146260123868
2013,1392,23,7,1579,439,0.7666666666666667,1140,0.7824578790882062
2013,1393,26,9,1964,533,0.7428571428571429,1431,0.7865438526231477
2013,1394,5,23,344,1342,0.17857142857142858,-998,0.2040332147093713
2013,1395,10,21,613,1073,0.3225806451612903,-460,0.363582443653618
2013,1396,23,9,1710,618,0.71875,1092,0.7345360824742269
2013,1397,20,12,1425,697,0.625,728,0.6715362865221489
2013,1398,16,14,1234,883,0.5333333333333333,351,0.5829003306565895
2013,1399,10,17,727,975,0.37037037037037035,-248,0.427144535840188
2013,1400,16,16,1147,937,0.5,210,0.550383877159309
2013,1401,18,15,1250,853,0.5454545454545454,397,0.5943889681407513
2013,1402,11,22,856,1456,0.3333333333333333,-600,0.370242214532872
2013,1403,11,20,846,1180,0.3548387096774194,-334,0.4175715695952616
2013,1404,7,21,513,1319,0.25,-806,0.28002183406113534
2013,1405,15,13,1103,825,0.5357142857142857,278,0.5720954356846473
2013,1406,17,13,1273,773,0.5666666666666667,500,0.6221896383186706
2013,1407,12,21,803,1243,0.36363636363636365,-440,0.3924731182795699
2013,1408,18,14,1307,904,0.5625,403,0.5911352329262777
2013,1409,16,15,1124,955,0.5161290322580645,169,0.5406445406445406
2013,1410,12,16,845,919,0.42857142857142855,-74,0.4790249433106576
2013,1411,17,14,1300,879,0.5483870967741935,421,0.596603946764571
2013,1412,15,17,1107,1145,0.46875,-38,0.49156305506216696
2013,1413,14,17,1084,1126,0.45161290322580644,-42,0.49049773755656106
2013,1414,18,15,1264,942,0.5454545454545454,322,0.5729827742520399
2013,1415,4,24,256,1328,0.14285714285714285,-1072,0.16161616161616163
2013,1416,18,11,1322,717,0.6206896551724138,605,0.6483570377636096
2013,1417,25,9,1943,598,0.7352941176470589,1345,0.764659582841401
2013,1418,12,20,952,1309,0.375,-357,0.42105263157894735
2013,1419,4,23,299,1322,0.14814814814814814,-1023,0.18445404071560764
2013,1420,7,23,461,1439,0.23333333333333334,-978,0.24263157894736842
2013,1421,13,16,972,1078,0.4482758620689655,-106,0.4741463414634146
2013,1422,7,22,567,1488,0.2413793103448276,-921,0.2759124087591241
2013,1423,9,20,617,1220,0.3103448275862069,-603,0.33587370713119213
2013,1424,24,9,1782,564,0.7272727272727273,1218,0.7595907928388747
2013,1425,14,18,986,1115,0.4375,-129,0.46930033317467873
2013,1426,19,13,1350,695,0.59375,655,0.6601466992665037
2013,1427,10,22,722,1326,0.3125,-604,0.3525390625
2013,1428,13,18,886,1055,0.41935483870967744,-169,0.4564657393096342
2013,1429,20,10,1453,595,0.6666666666666666,858,0.70947265625
2013,1430,10,18,757,1061,0.35714285714285715,-304,0.4163916391639164
2013,1431,18,14,1259,783,0.5625,476,0.6165523996082273
2013,1433,26,8,2126,503,0.7647058823529411,1623,0.8086724990490681
2013,1434,25,7,1874,413,0.78125,1461,0.8194140795802362
2013,1435,16,17,1091,900,0.48484848484848486,191,0.5479658463083877
2013,1436,21,11,1408,622,0.65625,786,0.6935960591133005
2013,1437,19,13,1395,763,0.59375,632,0.6464318813716404
2013,1438,21,11,1430,619,0.65625,811,0.6979014153245485
2013,1439,13,19,1024,1224,0.40625,-200,0.4555160142348754
2013,1440,11,17,912,1183,0.39285714285714285,-271,0.4353221957040573
2013,1441,12,19,852,1263,0.3870967741935484,-411,0.40283687943262414
2013,1442,20,8,1215,397,0.7142857142857143,818,0.7537220843672456
2013,1443,19,15,1365,913,0.5588235294117647,452,0.5992098331870062
2013,1444,19,12,1347,714,0.6129032258064516,633,0.653566229985444
2013,1447,19,12,1358,778,0.6129032258064516,580,0.6357677902621723
2013,1448,13,18,973,1120,0.41935483870967744,-147,0.46488294314381273
2013,1449,18,15,1309,921,0.5454545454545454,388,0.5869955156950672
2013,1450,13,19,907,1154,0.40625,-247,0.44007763221737023
2013,1451,24,6,1799,402,0.8,1397,0.8173557473875511
2013,1452,13,19,934,1182,0.40625,-248,0.44139886578449905
2013,1453,17,15,1144,950,0.53125,194,0.5463228271251194
2013,1454,6,24,452,1384,0.2,-932,0.24618736383442266
2013,1455,26,8,1865,496,0.7647058823529411,1369,0.7899195256247353
2013,1456,12,17,881,1101,0.41379310344827586,-220,0.4445005045408678
2013,1457,11,17,690,953,0.39285714285714285,-263,0.41996348143639683
2013,1458,23,11,1637,591,0.6764705882352942,1046,0.7347396768402155
2013,1459,12,19,783,988,0.3870967741935484,-205,0.44212309429700736
2013,1460,20,12,1292,685,0.625,607,0.6535154274152757
2013,1461,17,13,1140,664,0.5666666666666667,476,0.6319290465631929
2013,1462,17,14,1186,835,0.5483870967741935,351,0.58683819891143
2013,1463,12,17,869,994,0.41379310344827586,-125,0.4664519592055824
2013,1464,14,15,1014,974,0.4827586206896552,40,0.5100603621730382
2013,3102,4,26,303,1394,0.13333333333333333,-1091,0.1785503830288745
2013,3103,22,9,1725,614,0.7096774193548387,1111,0.7374946558358273
2013,3104,13,18,969,1044,0.41935483870967744,-75,0.481371087928465
2013,3105,8,20,526,1085,0.2857142857142857,-559,0.3265052762259466
2013,3106,7,21,466,1063,0.25,-597,0.30477436232831917
2013,3107,27,3,1874,146,0.9,1728,0.9277227722772278
2013,3108,2,26,136,1235,0.07142857142857142,-1099,0.09919766593727207
2013,3110,15,14,934,715,0.5172413793103449,219,0.5664038811400849
2013,3111,19,10,1397,582,0.6551724137931034,815,0.705912076806468
2013,3112,12,18,862,1013,0.4,-151,0.4597333333333333
2013,3113,13,18,855,970,0.41935483870967744,-115,0.4684931506849315
2013,3114,24,8,1537,474,0.75,1063,0.7642963699651915
2013,3115,11,18,668,1001,0.3793103448275862,-333,0.40023966446974235
2013,3116,19,12,1432,642,0.6129032258064516,790,0.6904532304725168
2013,3117,15,15,1026,816,0.5,210,0.5570032573289903
2013,3119,21,8,1270,383,0.7241379310344828,887,0.7683000604960678
2013,3120,16,14,1149,818,0.5333333333333333,331,0.5841382816471784
2013,3122,6,21,431,1185,0.2222222222222222,-754,0.2667079207920792
2013,3123,15,15,955,832,0.5,123,0.5344152210408506
2013,3124,32,1,2604,69,0.9696969696969697,2535,0.9741863075196409
2013,3125,18,13,1217,675,0.5806451612903226,542,0.6432346723044398
2013,3126,10,17,610,785,0.37037037037037035,-175,0.43727598566308246
2013,3127,6,24,361,1171,0.2,-810,0.23563968668407312
2013,3129,9,19,636,1088,0.32142857142857145,-452,0.3689095127610209
2013,3130,12,19,804,1116,0.3870967741935484,-312,0.41875
2013,3131,23,5,1452,299,0.8214285714285714,1153,0.8292404340376928
2013,3132,21,10,1409,517,0.6774193548387096,892,0.7315680166147456
2013,3133,14,16,1094,1045,0.4666666666666667,49,0.5114539504441328
2013,3135,9,19,530,951,0.32142857142857145,-421,0.35786630654962864
2013,3136,12,18,803,1074,0.4,-271,0.4278103356419819
2013,3137,15,16,920,816,0.4838709677419355,104,0.5299539170506913
2013,3138,12,20,823,1134,0.375,-311,0.42054164537557487
2013,3139,17,13,1112,669,0.5666666666666667,443,0.6243683323975294
2013,3140,20,10,1355,555,0.6666666666666666,800,0.7094240837696335
2013,3141,21,11,1660,721,0.65625,939,0.6971860562788744
2013,3142,21,10,1510,602,0.6774193548387096,908,0.7149621212121212
2013,3143,28,3,2045,174,0.9032258064516129,1871,0.921586300135196
2013,3144,18,11,1236,644,0.6206896551724138,592,0.6574468085106383
2013,3145,12,19,744,1024,0.3870967741935484,-280,0.42081447963800905
2013,3146,11,15,703,825,0.4230769230769231,-122,0.46007853403141363
2013,3148,16,14,1067,767,0.5333333333333333,300,0.5817884405670665
2013,3149,5,20,311,1153,0.2,-842,0.21243169398907105
2013,3150,24,5,1624,286,0.8275862068965517,1338,0.8502617801047121
2013,3151,29,3,2036,167,0.90625,1869,0.9241942805265547
2013,3152,3,25,187,1156,0.10714285714285714,-969,0.13924050632911392
2013,3153,12,18,705,887,0.4,-182,0.4428391959798995
2013,3155,9,21,586,1045,0.3,-459,0.35928877988963825
2013,3156,12,17,826,1109,0.41379310344827586,-283,0.4268733850129199
2013,3157,10,16,631,795,0.38461538461538464,-164,0.4424964936886395
2013,3158,15,15,1036,820,0.5,216,0.5581896551724138
2013,3159,10,21,629,1007,0.3225806451612903,-378,0.38447432762836187
2013,3160,25,6,1735,294,0.8064516129032258,1441,0.8551010349926071
2013,3161,10,19,602,989,0.3448275862068966,-387,0.3783783783783784
2013,3162,5,23,271,1072,0.17857142857142858,-801,0.20178704393149666
2013,3163,29,4,2413,288,0.8787878787878788,2125,0.8933728248796742
2013,3164,14,16,868,937,0.4666666666666667,-69,0.4808864265927978
2013,3165,12,15,792,734,0.4444444444444444,58,0.5190039318479686
2013,3166,24,7,1671,384,0.7741935483870968,1287,0.8131386861313868
2013,3167,12,17,911,1061,0.41379310344827586,-150,0.4619675456389452
2013,3168,11,22,703,1076,0.3333333333333333,-373,0.39516582349634627
2013,3169,16,16,1047,855,0.5,192,0.5504731861198738
2013,3170,19,12,1496,747,0.6129032258064516,749,0.6669638876504681
2013,3171,6,22,353,1103,0.21428571428571427,-750,0.24244505494505494
2013,3172,21,12,1407,646,0.6363636363636364,761,0.6853385289819776
2013,3173,27,2,2093,94,0.9310344827586207,1999,0.9570187471422039
2013,3174,30,3,2049,156,0.9090909090909091,1893,0.9292517006802721
2013,3175,8,21,513,1065,0.27586206896551724,-552,0.32509505703422054
2013,3176,14,17,979,1067,0.45161290322580644,-88,0.478494623655914
2013,3177,21,11,1630,651,0.65625,979,0.7145988601490574
2013,3178,15,13,1112,789,0.5357142857142857,323,0.5849552866912151
2013,3179,11,20,788,1259,0.3548387096774194,-471,0.3849535906204201
2013,3180,22,10,1387,526,0.6875,861,0.7250392054364871
2013,3181,30,2,2305,114,0.9375,2191,0.9528730880529144
2013,3182,23,7,1439,391,0.7666666666666667,1048,0.7863387978142077
2013,3183,18,11,1370,612,0.6206896551724138,758,0.6912209889001009
2013,3184,17,11,1092,617,0.6071428571428571,475,0.638970157987127
2013,3185,8,22,502,1186,0.26666666666666666,-684,0.29739336492890994
2013,3186,18,12,1248,706,0.6,542,0.638689866939611
2013,3187,20,9,1311,542,0.6896551724137931,769,0.7075013491635186
2013,3188,16,15,1097,834,0.5161290322580645,263,0.5680994303469705
2013,3189,18,13,1249,793,0.5806451612903226,456,0.6116552399608227
2013,3190,8,18,575,1075,0.3076923076923077,-500,0.3484848484848485
2013,3191,9,21,592,1157,0.3,-565,0.33847913093196114
2013,3192,12,17,744,921,0.41379310344827586,-177,0.44684684684684683
2013,3193,17,13,1013,594,0.5666666666666667,419,0.6303671437461108
2013,3194,12,17,929,1044,0.41379310344827586,-115,0.4708565636087177
2013,3195,26,6,1906,327,0.8125,1579,0.8535602328705777
2013,3196,18,14,1365,877,0.5625,488,0.6088314005352364
2013,3197,11,19,740,1091,0.36666666666666664,-351,0.4041507373020208
2013,3198,19,12,1220,672,0.6129032258064516,548,0.6448202959830867
2013,3199,22,9,1790,572,0.7096774193548387,1218,0.7578323454699407
2013,3200,24,8,1489,390,0.75,1099,0.7924427887174029
2013,3201,23,8,1617,477,0.7419354838709677,1140,0.7722063037249284
2013,3202,11,18,731,991,0.3793103448275862,-260,0.4245063879210221
2013,3203,14,16,910,857,0.4666666666666667,53,0.5149971703452179
2013,3204,8,23,502,1150,0.25806451612903225,-648,0.30387409200968524
2013,3205,10,18,622,990,0.35714285714285715,-368,0.3858560794044665
2013,3206,9,21,566,1069,0.3,-503,0.346177370030581
2013,3207,15,16,1057,883,0.4838709677419355,174,0.5448453608247422
2013,3208,25,6,1761,301,0.8064516129032258,1460,0.8540252182347235
2013,3209,13,16,867,913,0.4482758620689655,-46,0.48707865168539327
2013,3210,14,16,1027,1001,0.4666666666666667,26,0.5064102564102564
2013,3211,27,5,1978,245,0.84375,1733,0.8897885739991003
2013,3212,9,23,636,1284,0.28125,-648,0.33125
2013,3214,28,5,1882,247,0.8484848484848485,1635,0.8839830906528887
2013,3216,21,11,1339,511,0.65625,828,0.7237837837837838
2013,3217,20,8,1398,497,0.7142857142857143,901,0.7377308707124011
2013,3218,17,13,1095,688,0.5666666666666667,407,0.6141334828939988
2013,3219,16,13,1115,763,0.5517241379310345,352,0.593716719914803
2013,3220,14,17,963,1000,0.45161290322580644,-37,0.4905756495160469
2013,3221,18,14,1174,742,0.5625,432,0.6127348643006263
2013,3222,13,17,892,1011,0.43333333333333335,-119,0.4687335785601682
2013,3223,4,24,307,1338,0.14285714285714285,-1031,0.18662613981762918
2013,3224,19,11,1077,578,0.6333333333333333,499,0.6507552870090635
2013,3225,17,15,1202,900,0.53125,302,0.5718363463368221
2013,3226,17,12,1136,642,0.5862068965517241,494,0.6389201349831272
2013,3227,8,20,596,1157,0.2857142857142857,-561,0.3399885909868796
2013,3228,16,13,1211,818,0.5517241379310345,393,0.5968457368161656
2013,3229,23,10,1626,599,0.696969696969697,1027,0.7307865168539326
2013,3231,11,19,706,949,0.36666666666666664,-243,0.42658610271903324
2013,3232,18,12,1127,643,0.6,484,0.6367231638418079
2013,3233,20,12,1468,630,0.625,838,0.6997140133460439
2013,3234,20,12,1416,754,0.625,662,0.6525345622119816
2013,3235,23,8,1671,420,0.7419354838709677,1251,0.7991391678622669
2013,3236,11,17,765,975,0.39285714285714285,-210,0.4396551724137931
2013,3237,18,11,1125,642,0.6206896551724138,483,0.6366723259762309
2013,3238,12,16,772,914,0.42857142857142855,-142,0.4578884934756821
2013,3239,11,19,764,1125,0.36666666666666664,-361,0.40444679724722077
2013,3240,1,26,60,1458,0.037037037037037035,-1398,0.039525691699604744
2013,3241,22,10,1597,554,0.6875,1043,0.7424453742445374
2013,3242,17,13,1245,830,0.5666666666666667,415,0.6
2013,3243,15,17,979,984,0.46875,-5,0.4987264391237901
2013,3244,7,24,409,1184,0.22580645161290322,-775,0.25674827369742625
2013,3245,3,27,201,1303,0.1,-1102,0.13364361702127658
2013,3246,27,5,2135,311,0.84375,1824,0.8728536385936222
2013,3247,8,21,511,1051,0.27586206896551724,-540,0.32714468629961585
2013,3248,11,19,655,909,0.36666666666666664,-254,0.4187979539641944
2013,3249,17,10,1106,548,0.6296296296296297,558,0.6686819830713422
2013,3250,14,16,875,809,0.4666666666666667,66,0.5195961995249406
2013,3251,25,6,1869,329,0.8064516129032258,1540,0.8503184713375797
2013,3252,3,26,179,1288,0.10344827586206896,-1109,0.12201772324471712
2013,3253,16,15,1069,802,0.5161290322580645,267,0.5713522180652058
2013,3254,7,22,446,1139,0.2413793103448276,-693,0.28138801261829655
2013,3255,14,19,991,1117,0.42424242424242425,-126,0.47011385199240985
2013,3256,14,17,989,958,0.45161290322580644,31,0.5079609655880842
2013,3257,24,8,1791,493,0.75,1298,0.7841506129597198
2013,3258,13,18,918,1104,0.41935483870967744,-186,0.4540059347181009
2013,3259,12,18,699,893,0.4,-194,0.439070351758794
2013,3260,17,15,1265,844,0.53125,421,0.5998103366524419
2013,3261,20,11,1459,678,0.6451612903225806,781,0.6827328029948526
2013,3263,4,24,288,1258,0.14285714285714285,-970,0.18628719275549807
2013,3264,8,23,473,1117,0.25806451612903225,-644,0.29748427672955974
2013,3265,26,6,1753,309,0.8125,1444,0.8501454898157129
2013,3266,16,15,1096,884,0.5161290322580645,212,0.5535353535353535
2013,3267,9,21,559,1102,0.3,-543,0.33654425045153524
2013,3268,24,7,1948,405,0.7741935483870968,1543,0.8278793030174245
2013,3269,3,26,210,1426,0.10344827586206896,-1216,0.12836185819070906
2013,3270,16,14,1158,851,0.5333333333333333,307,0.5764061722249876
2013,3271,7,20,432,979,0.25925925925925924,-547,0.30616583982990786
2013,3272,17,14,1261,870,0.5483870967741935,391,0.5917409666823088
2013,3273,19,11,1233,553,0.6333333333333333,680,0.6903695408734603
2013,3274,21,10,1443,585,0.6774193548387096,858,0.7115384615384616
2013,3275,19,12,1283,754,0.6129032258064516,529,0.6298478154148257
2013,3276,21,10,1374,510,0.6774193548387096,864,0.7292993630573248
2013,3277,24,8,1537,456,0.75,1081,0.7711991971901656
2013,3278,18,13,1382,788,0.5806451612903226,594,0.6368663594470046
2013,3279,9,20,640,1237,0.3103448275862069,-597,0.3409696323921151
2013,3280,13,17,846,810,0.43333333333333335,36,0.5108695652173914
2013,3281,17,14,1335,707,0.5483870967741935,628,0.6537708129285015
2013,3282,9,20,570,973,0.3103448275862069,-403,0.3694102397926118
2013,3283,14,17,1100,1076,0.45161290322580644,24,0.5055147058823529
2013,3284,15,15,987,799,0.5,188,0.5526315789473685
2013,3285,23,7,1582,363,0.7666666666666667,1219,0.8133676092544987
2013,3286,16,12,1060,691,0.5714285714285714,369,0.6053683609366076
2013,3287,8,21,518,1091,0.27586206896551724,-573,0.3219390926041019
2013,3288,13,18,843,1058,0.41935483870967744,-215,0.44345081536033665
2013,3290,14,15,900,874,0.4827586206896552,26,0.5073280721533259
2013,3291,15,16,936,879,0.4838709677419355,57,0.515702479338843
2013,3292,25,7,1755,410,0.78125,1345,0.8106235565819861
2013,3293,15,13,1048,751,0.5357142857142857,297,0.5825458588104503
2013,3294,19,12,1245,560,0.6129032258064516,685,0.6897506925207756
2013,3295,9,18,585,997,0.3333333333333333,-412,0.3697850821744627
2013,3296,7,23,449,1181,0.23333333333333334,-732,0.2754601226993865
2013,3297,15,12,1038,648,0.5555555555555556,390,0.6156583629893239
2013,3298,21,11,1309,563,0.65625,746,0.6992521367521367
2013,3299,21,9,1409,448,0.7,961,0.7587506731287023
2013,3300,2,28,76,1074,0.06666666666666667,-998,0.06608695652173913
2013,3301,16,16,1213,1004,0.5,209,0.5471357690572847
2013,3303,14,11,922,550,0.56,372,0.626358695652174
2013,3304,23,8,1597,490,0.7419354838709677,1107,0.7652132247244849
2013,3305,7,23,518,1290,0.23333333333333334,-772,0.28650442477876104
2013,3306,12,18,752,882,0.4,-130,0.4602203182374541
2013,3307,17,14,1131,696,0.5483870967741935,435,0.6190476190476191
2013,3308,15,16,1094,834,0.4838709677419355,260,0.5674273858921162
2013,3309,2,23,120,1223,0.08,-1103,0.08935219657483247
2013,3310,15,16,938,840,0.4838709677419355,98,0.5275590551181102
2013,3311,19,11,1324,646,0.6333333333333333,678,0.6720812182741117
2013,3312,14,15,839,674,0.4827586206896552,165,0.5545274289491078
2013,3313,6,22,395,1133,0.21428571428571427,-738,0.25850785340314136
2013,3314,28,6,1968,383,0.8235294117647058,1585,0.8370905997447895
2013,3315,10,18,674,986,0.35714285714285715,-312,0.40602409638554215
2013,3316,12,19,724,882,0.3870967741935484,-158,0.45080946450809467
2013,3317,11,19,771,1229,0.36666666666666664,-458,0.3855
2013,3318,17,13,1215,795,0.5666666666666667,420,0.6044776119402985
2013,3319,8,21,552,1228,0.27586206896551724,-676,0.3101123595505618
2013,3320,16,16,1158,881,0.5,277,0.5679254536537518
2013,3321,13,17,913,928,0.43333333333333335,-15,0.4959261271048343
2013,3322,11,18,672,872,0.3793103448275862,-200,0.43523316062176165
2013,3323,31,1,2526,61,0.96875,2465,0.9764205643602628
2013,3324,7,20,439,1041,0.25925925925925924,-602,0.29662162162162165
2013,3325,6,23,395,1194,0.20689655172413793,-799,0.2485840151038389
2013,3326,18,13,1286,772,0.5806451612903226,514,0.6248785228377065
2013,3328,22,10,1663,657,0.6875,1006,0.7168103448275862
2013,3329,21,10,1674,617,0.6774193548387096,1057,0.7306852902662593
2013,3330,19,11,1311,632,0.6333333333333333,679,0.6747297992794647
2013,3331,17,12,1252,750,0.5862068965517241,502,0.6253746253746254
2013,3332,4,27,272,1613,0.12903225806451613,-1341,0.1442970822281167
2013,3333,8,21,484,1137,0.27586206896551724,-653,0.2985811227637261
2013,3334,25,7,1761,446,0.78125,1315,0.7979157227004984
2013,3335,16,12,1000,633,0.5714285714285714,367,0.612369871402327
2013,3336,25,5,1900,305,0.8333333333333334,1595,0.8616780045351474
2013,3337,5,23,374,1163,0.17857142857142858,-789,0.24333116460637605
2013,3338,9,21,630,1131,0.3,-501,0.3577512776831346
2013,3339,11,20,748,1112,0.3548387096774194,-364,0.4021505376344086
2013,3340,10,17,713,986,0.37037037037037035,-273,0.41965862271924664
2013,3341,17,14,1109,746,0.5483870967741935,363,0.597843665768194
2013,3342,17,11,1043,461,0.6071428571428571,582,0.6934840425531915
2013,3343,22,6,1682,339,0.7857142857142857,1343,0.8322612568035626
2013,3344,7,23,527,1257,0.23333333333333334,-730,0.2954035874439462
2013,3345,24,8,1727,441,0.75,1286,0.7965867158671587
2013,3346,30,2,2157,118,0.9375,2039,0.9481318681318681
2013,3347,15,14,987,784,0.5172413793103449,203,0.5573122529644269
2013,3348,5,23,267,1051,0.17857142857142858,-784,0.20257966616084977
2013,3349,14,16,872,841,0.4666666666666667,31,0.5090484530064214
2013,3350,16,15,1077,841,0.5161290322580645,236,0.5615224191866528
2013,3351,15,15,979,834,0.5,145,0.5399889685603971
2013,3352,7,22,428,1195,0.2413793103448276,-767,0.26370918052988296
2013,3353,16,14,999,680,0.5333333333333333,319,0.5949970220369267
2013,3354,18,9,1165,465,0.6666666666666666,700,0.7147239263803681
2013,3355,25,7,1743,410,0.78125,1333,0.8095680445889457
2013,3356,5,26,355,1529,0.16129032258064516,-1174,0.18842887473460723
2013,3357,22,10,1428,588,0.6875,840,0.7083333333333334
2013,3358,17,14,1163,771,0.5483870967741935,392,0.6013443640124095
2013,3359,14,16,792,816,0.4666666666666667,-24,0.4925373134328358
2013,3360,19,9,1392,475,0.6785714285714286,917,0.7455811462238886
2013,3361,24,6,1664,377,0.8,1287,0.8152866242038217
2013,3362,11,19,811,1048,0.36666666666666664,-237,0.43625605164066705
2013,3363,10,19,757,1195,0.3448275862068966,-438,0.38780737704918034
2013,3364,16,16,902,745,0.5,157,0.5476624165148756
2013,3365,14,16,923,873,0.4666666666666667,50,0.5139198218262806
2013,3366,4,23,220,1065,0.14814814814814814,-845,0.17120622568093385
2013,3367,11,18,719,970,0.3793103448275862,-251,0.4256956779159266
2013,3368,9,18,606,1077,0.3333333333333333,-471,0.3600713012477718
2013,3369,11,18,705,1017,0.3793103448275862,-312,0.4094076655052265
2013,3370,20,10,1407,632,0.6666666666666666,775,0.6900441392839627
2013,3371,11,20,695,953,0.3548387096774194,-258,0.4217233009708738
2013,3372,13,16,874,914,0.4482758620689655,-40,0.4888143176733781
2013,3373,13,18,816,938,0.41935483870967744,-122,0.4652223489167617
2013,3374,21,9,1521,529,0.7,992,0.7419512195121951
2013,3375,16,13,1010,619,0.5517241379310345,391,0.620012277470841
2013,3376,24,7,1507,374,0.7741935483870968,1133,0.8011695906432749
2013,3377,15,15,1036,801,0.5,235,0.5639629831246598
2013,3378,21,10,1519,628,0.6774193548387096,891,0.7074988355845365
2013,3379,13,16,840,970,0.4482758620689655,-130,0.46408839779005523
2013,3380,13,17,849,866,0.43333333333333335,-17,0.49504373177842564
2013,3381,14,16,1062,999,0.4666666666666667,63,0.5152838427947598
2013,3382,10,19,611,977,0.3448275862068966,-366,0.38476070528967254
2013,3383,11,19,708,973,0.36666666666666664,-265,0.4211778703152885
2013,3384,17,15,1280,797,0.53125,483,0.6162734713529129
2013,3385,18,12,1155,666,0.6,489,0.6342668863261944
2013,3386,23,8,1518,493,0.7419354838709677,1025,0.7548483341621084
2013,3387,12,19,690,985,0.3870967741935484,-295,0.41194029850746267
2013,3388,20,10,1341,595,0.6666666666666666,746,0.6926652892561983
2013,3389,2,28,134,1455,0.06666666666666667,-1321,0.08432976714915041
2013,3390,31,2,2244,90,0.9393939393939394,2154,0.961439588688946
2013,3391,23,8,1682,470,0.7419354838709677,1212,0.7815985130111525
2013,3392,14,16,814,776,0.4666666666666667,38,0.5119496855345912
2013,3393,24,7,1800,448,0.7741935483870968,1352,0.800711743772242
2013,3394,4,25,223,1219,0.13793103448275862,-996,0.15464632454923716
2013,3395,9,21,604,1188,0.3,-584,0.33705357142857145
2013,3396,14,18,847,896,0.4375,-49,0.4859437751004016
2013,3397,24,7,1973,441,0.7741935483870968,1532,0.8173156586578293
2013,3398,12,15,838,845,0.4444444444444444,-7,0.4979203802733215
2013,3399,18,12,1261,721,0.6,540,0.636226034308779
2013,3400,12,18,855,993,0.4,-138,0.46266233766233766
2013,3401,24,9,1781,530,0.7272727272727273,1251,0.7706620510601471
2013,3402,9,20,694,1297,0.3103448275862069,-603,0.34856855851330987
2013,3403,21,10,1453,566,0.6774193548387096,887,0.7196631996037642
2013,3404,19,14,1495,923,0.5757575757575758,572,0.6182795698924731
2013,3405,27,3,1783,203,0.9,1580,0.8977844914400805
2013,3406,12,18,777,924,0.4,-147,0.4567901234567901
2013,3407,7,24,586,1590,0.22580645161290322,-1004,0.2693014705882353
2013,3408,21,8,1433,491,0.7241379310344828,942,0.7448024948024948
2013,3409,16,16,1087,915,0.5,172,0.542957042957043
2013,3410,10,15,661,777,0.4,-116,0.45966620305980527
2013,3411,20,11,1332,577,0.6451612903225806,755,0.6977475117862756
2013,3412,18,12,1153,687,0.6,466,0.6266304347826087
2013,3413,12,18,836,985,0.4,-149,0.45908841295991215
2013,3414,9,21,567,1050,0.3,-483,0.35064935064935066
2013,3415,11,18,754,996,0.3793103448275862,-242,0.4308571428571429
2013,3416,16,18,1102,985,0.47058823529411764,117,0.5280306660277911
2013,3417,25,7,1749,407,0.78125,1342,0.8112244897959183
2013,3418,8,21,543,1074,0.27586206896551724,-531,0.3358070500927644
2013,3419,10,21,713,1182,0.3225806451612903,-469,0.3762532981530343
2013,3420,9,20,594,970,0.3103448275862069,-376,0.3797953964194373
2013,3422,8,23,515,1257,0.25806451612903225,-742,0.29063205417607224
2013,3423,5,26,332,1327,0.16129032258064516,-995,0.2001205545509343
2013,3424,12,19,803,1149,0.3870967741935484,-346,0.4113729508196721
2013,3425,11,20,743,1162,0.3548387096774194,-419,0.3900262467191601
2013,3426,7,23,479,1286,0.23333333333333334,-807,0.27138810198300284
2013,3427,15,14,971,766,0.5172413793103449,205,0.5590097869890616
2013,3428,18,13,1202,649,0.5806451612903226,553,0.6493787142085359
2013,3429,17,13,1337,975,0.5666666666666667,362,0.5782871972318339
2013,3430,13,15,871,865,0.4642857142857143,6,0.5017281105990783
2013,3431,21,10,1416,641,0.6774193548387096,775,0.6883811375789985
2013,3433,11,19,753,1021,0.36666666666666664,-268,0.42446448703494927
2013,3434,10,20,729,1121,0.3333333333333333,-392,0.3940540540540541
2013,3435,20,11,1415,649,0.6451612903225806,766,0.685562015503876
2013,3436,10,21,573,1008,0.3225806451612903,-435,0.36242884250474383
2013,3437,21,10,1326,520,0.6774193548387096,806,0.7183098591549296
2013,3438,16,14,1058,799,0.5333333333333333,259,0.5697361335487345
2013,3439,10,20,623,857,0.3333333333333333,-234,0.4209459459459459
2013,3441,7,23,437,1080,0.23333333333333334,-643,0.2880685563612393
2013,3442,12,16,875,905,0.42857142857142855,-30,0.49157303370786515
2013,3443,21,10,1524,590,0.6774193548387096,934,0.7209082308420057
2013,3444,11,20,736,1083,0.3548387096774194,-347,0.4046179219351292
2013,3447,3,26,187,1297,0.10344827586206896,-1110,0.12601078167115903
2013,3448,13,19,985,1179,0.40625,-194,0.4551756007393715
2013,3449,20,11,1406,607,0.6451612903225806,799,0.6984600099354198
2013,3450,11,20,688,1153,0.3548387096774194,-465,0.3737099402498642
2013,3452,17,13,1156,769,0.5666666666666667,387,0.6005194805194806
2013,3453,28,2,1901,136,0.9333333333333333,1765,0.9332351497299951
2013,3454,9,20,711,1191,0.3103448275862069,-480,0.37381703470031546
2013,3455,24,9,1573,460,0.7272727272727273,1113,0.7737333989178554
2013,3456,7,22,503,1252,0.2413793103448276,-749,0.2866096866096866
2013,3457,19,11,1397,673,0.6333333333333333,724,0.6748792270531401
2013,3458,12,19,834,965,0.3870967741935484,-131,0.4635908838243469
2013,3459,8,21,496,1131,0.27586206896551724,-635,0.3048555623847572
2013,3460,11,18,741,1124,0.3793103448275862,-383,0.39731903485254694
2013,3461,23,7,1696,399,0.7666666666666667,1297,0.809546539379475
2013,3462,13,16,844,902,0.4482758620689655,-58,0.4833906071019473
2013,3463,13,15,903,897,0.4642857142857143,6,0.5016666666666667
2013,3464,21,9,1436,465,0.7,971,0.7553918990005261
2014,1101,2,19,160,1166,0.09523809523809523,-1006,0.12066365007541478
2014,1102,10,18,697,1111,0.35714285714285715,-414,0.3855088495575221
2014,1103,21,12,1508,733,0.6363636363636364,775,0.6729138777331548
2014,1104,12,19,883,1185,0.3870967741935484,-302,0.4269825918762089
2014,1105,12,16,854,933,0.42857142857142855,-79,0.4778959149412423
2014,1106,16,12,1196,761,0.5714285714285714,435,0.6111394992335207
2014,1107,18,14,1299,814,0.5625,485,0.6147657359204922
2014,1108,9,19,586,1148,0.32142857142857145,-562,0.33794694348327564
2014,1110,20,12,1350,696,0.625,654,0.6598240469208211
2014,1111,5,21,352,1316,0.19230769230769232,-964,0.21103117505995203
2014,1112,30,4,2232,252,0.8823529411764706,1980,0.8985507246376812
2014,1113,21,11,1682,719,0.65625,963,0.7005414410662224
2014,1114,13,17,956,1154,0.43333333333333335,-198,0.45308056872037916
2014,1115,11,18,776,1048,0.3793103448275862,-272,0.42543859649122806
2014,1116,21,11,1783,785,0.65625,998,0.6943146417445483
2014,1117,17,13,1381,895,0.5666666666666667,486,0.6067662565905096
2014,1119,14,16,1076,1100,0.4666666666666667,-24,0.4944852941176471
2014,1120,14,16,1093,1051,0.4666666666666667,42,0.5097947761194029
2014,1122,10,18,810,1300,0.35714285714285715,-490,0.38388625592417064
2014,1123,3,25,232,1568,0.10714285714285714,-1336,0.1288888888888889
2014,1124,22,11,1710,725,0.6666666666666666,985,0.702258726899384
2014,1125,23,9,1916,628,0.71875,1288,0.7531446540880503
2014,1126,5,25,360,1483,0.16666666666666666,-1123,0.19533369506239825
2014,1127,7,23,514,1326,0.23333333333333334,-812,0.2793478260869565
2014,1129,19,13,1546,855,0.59375,691,0.6438983756768013
2014,1130,7,24,526,1604,0.22580645161290322,-1078,0.24694835680751173
2014,1131,24,10,1800,630,0.7058823529411765,1170,0.7407407407407407
2014,1132,11,20,758,1147,0.3548387096774194,-389,0.3979002624671916
2014,1133,12,20,856,1180,0.375,-324,0.4204322200392927
2014,1135,14,13,1052,857,0.5185185185185185,195,0.5510738606600314
2014,1136,17,14,1345,924,0.5483870967741935,421,0.5927721463199648
2014,1137,16,14,1126,851,0.5333333333333333,275,0.569549822964087
2014,1138,18,10,1371,681,0.6428571428571429,690,0.6681286549707602
2014,1139,13,17,951,1074,0.43333333333333335,-123,0.4696296296296296
2014,1140,22,11,1898,881,0.6666666666666666,1017,0.6829794890248291
2014,1141,8,21,628,1390,0.27586206896551724,-762,0.311199207135778
2014,1142,11,19,725,1135,0.36666666666666664,-410,0.3897849462365591
2014,1143,19,13,1472,844,0.59375,628,0.6355785837651122
2014,1144,9,19,670,1185,0.32142857142857145,-515,0.3611859838274933
2014,1145,21,11,1721,771,0.65625,950,0.6906099518459069
2014,1146,6,21,463,1472,0.2222222222222222,-1009,0.2392764857881137
2014,1148,10,19,770,1262,0.3448275862068966,-492,0.37893700787401574
2014,1149,9,18,766,1295,0.3333333333333333,-529,0.37166424065987386
2014,1150,17,14,1305,910,0.5483870967741935,395,0.5891647855530474
2014,1151,15,14,1164,946,0.5172413793103449,218,0.5516587677725119
2014,1152,11,19,835,1230,0.36666666666666664,-395,0.4043583535108959
2014,1153,27,6,1954,314,0.8181818181818182,1640,0.8615520282186949
2014,1154,4,25,329,1534,0.13793103448275862,-1205,0.17659688674181429
2014,1155,20,12,1331,696,0.625,635,0.6566354218056241
2014,1156,19,11,1456,706,0.6333333333333333,750,0.6734505087881592
2014,1157,18,12,1312,804,0.6,508,0.6200378071833649
2014,1158,13,18,901,1047,0.41935483870967744,-146,0.4625256673511294
2014,1159,12,18,921,1158,0.4,-237,0.443001443001443
2014,1160,23,11,1751,658,0.6764705882352942,1093,0.7268576172685761
2014,1161,14,16,1085,1054,0.4666666666666667,31,0.5072463768115942
2014,1162,18,12,1292,721,0.6,571,0.6418281172379533
2014,1163,26,8,1970,473,0.7647058823529411,1497,0.8063855914858781
2014,1164,11,20,814,1321,0.3548387096774194,-507,0.3812646370023419
2014,1165,1,26,70,1648,0.037037037037037035,-1578,0.04074505238649592
2014,1166,26,7,2169,456,0.7878787878787878,1713,0.8262857142857143
2014,1167,12,19,865,1253,0.3870967741935484,-388,0.40840415486307835
2014,1168,11,20,853,1239,0.3548387096774194,-386,0.4077437858508604
2014,1169,15,18,1244,1262,0.45454545454545453,-18,0.49640861931364727
2014,1170,12,16,917,995,0.42857142857142855,-78,0.47960251046025104
2014,1171,10,16,756,958,0.38461538461538464,-202,0.441073512252042
2014,1172,19,12,1555,854,0.6129032258064516,701,0.6454960564549606
2014,1173,23,10,1763,659,0.696969696969697,1104,0.7279108175061932
2014,1174,25,9,2056,648,0.7352941176470589,1408,0.7603550295857988
2014,1175,7,21,498,1170,0.25,-672,0.29856115107913667
2014,1176,15,15,1099,867,0.5,232,0.559003051881994
2014,1177,12,21,944,1346,0.36363636363636365,-402,0.41222707423580784
2014,1178,11,19,768,1308,0.36666666666666664,-540,0.3699421965317919
2014,1179,14,16,1037,975,0.4666666666666667,62,0.5154075546719682
2014,1180,16,14,1182,882,0.5333333333333333,300,0.5726744186046512
2014,1181,26,8,2099,575,0.7647058823529411,1524,0.7849663425579656
2014,1182,13,17,1074,1126,0.43333333333333335,-52,0.48818181818181816
2014,1183,9,19,685,1189,0.32142857142857145,-504,0.3655282817502668
2014,1184,22,9,1778,621,0.7096774193548387,1157,0.7411421425593997
2014,1185,18,14,1219,826,0.5625,393,0.5960880195599022
2014,1186,13,16,1084,1109,0.4482758620689655,-25,0.4943000455996352
2014,1187,13,16,1050,1003,0.4482758620689655,47,0.5114466634193863
2014,1188,9,20,725,1360,0.3103448275862069,-635,0.34772182254196643
2014,1189,16,13,1223,855,0.5517241379310345,368,0.5885466794995188
2014,1190,17,15,1405,1020,0.53125,385,0.5793814432989691
2014,1191,12,19,950,1162,0.3870967741935484,-212,0.4498106060606061
2014,1192,9,20,699,1293,0.3103448275862069,-594,0.3509036144578313
2014,1193,7,25,485,1545,0.21875,-1060,0.23891625615763548
2014,1194,8,22,595,1358,0.26666666666666666,-763,0.3046594982078853
2014,1195,20,12,1532,768,0.625,764,0.6660869565217391
2014,1196,32,2,2288,117,0.9411764705882353,2171,0.9513513513513514
2014,1197,12,18,875,1202,0.4,-327,0.4212806933076553
2014,1198,13,15,936,955,0.4642857142857143,-19,0.4949762030671602
2014,1199,19,13,1427,826,0.59375,601,0.6333777185974256
2014,1200,10,21,795,1429,0.3225806451612903,-634,0.3574640287769784
2014,1201,15,16,1131,1092,0.4838709677419355,39,0.5087719298245614
2014,1202,7,20,530,1177,0.25925925925925924,-647,0.3104862331575864
2014,1203,24,8,1847,502,0.75,1345,0.7862920391656024
2014,1204,12,19,895,1222,0.3870967741935484,-327,0.42276806802078415
2014,1205,15,15,1116,1021,0.5,95,0.5222274216190922
2014,1206,11,20,764,1390,0.3548387096774194,-626,0.35468895078922935
2014,1207,17,14,1296,881,0.5483870967741935,415,0.5953146531924667
2014,1208,19,13,1379,830,0.59375,549,0.6242643730194658
2014,1209,23,8,1826,581,0.7419354838709677,1245,0.7586206896551724
2014,1210,16,17,1173,1027,0.48484848484848486,146,0.5331818181818182
2014,1211,27,6,2103,399,0.8181818181818182,1704,0.8405275779376499
2014,1212,4,23,334,1432,0.14814814814814814,-1098,0.18912797281993204
2014,1213,12,14,928,904,0.46153846153846156,24,0.5065502183406113
2014,1214,18,12,1405,792,0.6,613,0.6395084205735093
2014,1216,17,16,1229,933,0.5151515151515151,296,0.5684551341350601
2014,1217,25,4,1892,238,0.8620689655172413,1654,0.888262910798122
2014,1218,18,11,1474,797,0.6206896551724138,677,0.6490532804931748
2014,1219,14,14,1032,911,0.5,121,0.5311374163664436
2014,1220,10,23,750,1510,0.30303030303030304,-760,0.33185840707964603
2014,1221,19,13,1328,815,0.59375,513,0.6196920205319645
2014,1222,17,16,1316,1029,0.5151515151515151,287,0.5611940298507463
2014,1223,4,25,344,1565,0.13793103448275862,-1221,0.18019905709795705
2014,1224,6,25,397,1471,0.1935483870967742,-1074,0.21252676659528907
2014,1225,15,18,1164,1219,0.45454545454545453,-55,0.4884599244649601
2014,1226,9,18,698,1180,0.3333333333333333,-482,0.37167199148029817
2014,1227,4,25,323,1573,0.13793103448275862,-1250,0.17035864978902954
2014,1228,19,14,1321,812,0.5757575757575758,509,0.6193155180496953
2014,1229,15,15,1093,967,0.5,126,0.5305825242718447
2014,1230,9,6,704,448,0.6,256,0.6111111111111112
2014,1231,17,15,1385,927,0.53125,458,0.5990484429065744
2014,1232,21,10,1516,652,0.6774193548387096,864,0.6992619926199262
2014,1233,22,10,1912,760,0.6875,1152,0.7155688622754491
2014,1234,20,12,1733,891,0.625,842,0.6604420731707317
2014,1235,26,7,2215,520,0.7878787878787878,1695,0.8098720292504571
2014,1236,21,10,1626,650,0.6774193548387096,976,0.7144112478031635
2014,1237,3,26,202,1630,0.10344827586206896,-1428,0.11026200873362445
2014,1238,11,20,819,1222,0.3548387096774194,-403,0.4012738853503185
2014,1239,10,18,820,1222,0.35714285714285715,-402,0.4015670910871694
2014,1240,8,21,565,1286,0.27586206896551724,-721,0.30524041058887086
2014,1241,11,20,704,1257,0.3548387096774194,-553,0.35900050994390614
2014,1242,24,9,1993,634,0.7272727272727273,1359,0.7586600685192234
2014,1243,20,12,1413,818,0.625,595,0.63334827431645
2014,1244,4,25,277,1574,0.13793103448275862,-1297,0.1496488384656942
2014,1245,15,16,1132,1012,0.4838709677419355,120,0.5279850746268657
2014,1246,24,10,1883,698,0.7058823529411765,1185,0.7295621851995351
2014,1247,15,16,1103,997,0.4838709677419355,106,0.5252380952380953
2014,1248,10,20,752,1381,0.3333333333333333,-629,0.3525550867323019
2014,1249,4,26,288,1713,0.13333333333333333,-1425,0.14392803598200898
2014,1250,14,18,1020,1101,0.4375,-81,0.4809052333804809
2014,1251,8,21,599,1401,0.27586206896551724,-802,0.2995
2014,1252,14,15,1136,1052,0.4827586206896552,84,0.5191956124314442
2014,1253,13,17,1001,1082,0.43333333333333335,-81,0.48055688910225636
2014,1254,9,20,698,1382,0.3103448275862069,-684,0.33557692307692305
2014,1255,4,24,315,1558,0.14285714285714285,-1243,0.16817939135077417
2014,1256,26,7,2166,483,0.7878787878787878,1683,0.8176670441676104
2014,1257,29,5,2443,349,0.8529411764705882,2094,0.875
2014,1258,12,19,954,1291,0.3870967741935484,-337,0.4249443207126949
2014,1259,10,19,728,1142,0.3448275862068966,-414,0.3893048128342246
2014,1260,9,22,707,1315,0.2903225806451613,-608,0.3496538081107814
2014,1261,19,13,1483,919,0.59375,564,0.6174021648626145
2014,1262,9,18,622,1023,0.3333333333333333,-401,0.3781155015197568
2014,1263,5,23,395,1585,0.17857142857142858,-1190,0.1994949494949495
2014,1264,25,7,1962,514,0.78125,1448,0.7924071082390953
2014,1265,12,19,909,1210,0.3870967741935484,-301,0.4289759320434167
2014,1266,17,15,1317,993,0.53125,324,0.5701298701298702
2014,1267,9,22,671,1474,0.2903225806451613,-803,0.3128205128205128
2014,1268,17,15,1267,1003,0.53125,264,0.5581497797356828
2014,1269,24,8,1894,541,0.75,1353,0.7778234086242299
2014,1270,9,20,707,1231,0.3103448275862069,-524,0.36480908152734776
2014,1271,5,23,384,1455,0.17857142857142858,-1071,0.20880913539967375
2014,1272,22,9,1743,639,0.7096774193548387,1104,0.7317380352644837
2014,1273,23,8,1814,579,0.7419354838709677,1235,0.7580442958629335
2014,1274,17,16,1164,865,0.5151515151515151,299,0.5736816165598817
2014,1275,13,17,925,1035,0.43333333333333335,-110,0.4719387755102041
2014,1276,25,8,1949,506,0.7575757575757576,1443,0.7938900203665987
2014,1277,26,8,2090,492,0.7647058823529411,1598,0.8094500387296669
2014,1278,19,13,1436,832,0.59375,604,0.6331569664902998
2014,1279,19,14,1479,1003,0.5757575757575758,476,0.5958904109589042
2014,1280,14,19,1047,1187,0.42424242424242425,-140,0.4686660698299015
2014,1281,22,11,1683,722,0.6666666666666666,961,0.6997920997920998
2014,1282,10,19,790,1219,0.3448275862068966,-429,0.3932304629168741
2014,1283,19,12,1389,729,0.6129032258064516,660,0.6558073654390935
2014,1284,11,21,848,1360,0.34375,-512,0.38405797101449274
2014,1285,15,13,1081,878,0.5357142857142857,203,0.5518121490556407
2014,1286,12,17,839,1052,0.41379310344827586,-213,0.44368059227921736
2014,1287,18,13,1454,873,0.5806451612903226,581,0.6248388483025354
2014,1288,15,16,1198,1017,0.4838709677419355,181,0.5408577878103837
2014,1290,6,23,462,1535,0.20689655172413793,-1073,0.2313470205307962
2014,1291,16,16,1316,1124,0.5,192,0.5393442622950819
2014,1292,22,9,1594,528,0.7096774193548387,1066,0.7511781338360037
2014,1293,16,11,1263,796,0.5925925925925926,467,0.6134045653229723
2014,1294,16,13,1230,869,0.5517241379310345,361,0.5859933301572178
2014,1295,22,6,1686,407,0.7857142857142857,1279,0.8055422838031534
2014,1296,14,17,877,1004,0.45161290322580644,-127,0.46624136097820307
2014,1297,9,21,707,1337,0.3,-630,0.3458904109589041
2014,1298,8,21,578,1144,0.27586206896551724,-566,0.3356562137049942
2014,1299,8,23,585,1413,0.25806451612903225,-828,0.2927927927927928
2014,1300,26,5,1931,308,0.8387096774193549,1623,0.8624385886556498
2014,1301,21,13,1576,831,0.6176470588235294,745,0.6547569588699627
2014,1303,13,14,1113,1020,0.48148148148148145,93,0.5218002812939522
2014,1304,19,12,1323,754,0.6129032258064516,569,0.6369764082811747
2014,1305,15,17,1136,1180,0.46875,-44,0.4905008635578584
2014,1306,5,24,334,1307,0.1724137931034483,-973,0.20353443022547227
2014,1307,27,6,2083,380,0.8181818181818182,1703,0.8457166057653268
2014,1308,25,9,1998,608,0.7352941176470589,1390,0.7666922486569455
2014,1309,9,15,699,977,0.375,-278,0.4170644391408115
2014,1310,7,26,529,1955,0.21212121212121213,-1426,0.21296296296296297
2014,1311,13,15,954,945,0.4642857142857143,9,0.5023696682464455
2014,1312,9,16,681,1036,0.36,-355,0.39662201514269074
2014,1313,16,14,1139,923,0.5333333333333333,216,0.5523763336566441
2014,1314,23,9,1834,608,0.71875,1226,0.7510237510237511
2014,1315,15,16,1170,1093,0.4838709677419355,77,0.5170128148475475
2014,1316,14,16,1049,1070,0.4666666666666667,-21,0.49504483246814535
2014,1317,14,16,1015,1060,0.4666666666666667,-45,0.4891566265060241
2014,1318,11,21,755,1354,0.34375,-599,0.3579895685158843
2014,1319,14,17,979,1082,0.45161290322580644,-103,0.4750121300339641
2014,1320,15,15,1158,1012,0.5,146,0.5336405529953917
2014,1321,14,19,922,1042,0.42424242424242425,-120,0.4694501018329939
2014,1322,15,14,1389,1089,0.5172413793103449,300,0.5605326876513317
2014,1323,15,17,1179,1124,0.46875,55,0.5119409465914025
2014,1324,11,20,929,1353,0.3548387096774194,-424,0.40709903593339175
2014,1325,22,11,1605,747,0.6666666666666666,858,0.6823979591836735
2014,1326,25,9,1790,583,0.7352941176470589,1207,0.7543194268857986
2014,1328,23,9,1937,692,0.71875,1245,0.7367820464054774
2014,1329,21,12,1773,878,0.6363636363636364,895,0.6688042248208224
2014,1330,16,17,1117,976,0.48484848484848486,141,0.5336837075967511
2014,1331,15,16,1142,1072,0.4838709677419355,70,0.5158084914182475
2014,1332,23,9,1949,670,0.71875,1279,0.7441771668575792
2014,1333,16,15,1251,1082,0.5161290322580645,169,0.5362194599228461
2014,1334,14,15,1110,982,0.4827586206896552,128,0.5305927342256214
2014,1335,8,20,631,1280,0.2857142857142857,-649,0.33019361590790164
2014,1336,15,17,1150,1138,0.46875,12,0.5026223776223776
2014,1337,14,16,1036,1089,0.4666666666666667,-53,0.4875294117647059
2014,1338,25,9,1949,515,0.7352941176470589,1434,0.7909902597402597
2014,1339,15,16,1248,1079,0.4838709677419355,169,0.5363128491620112
2014,1340,15,14,1145,933,0.5172413793103449,212,0.5510105871029837
2014,1341,10,23,734,1528,0.30303030303030304,-794,0.3244916003536693
2014,1342,4,26,310,1605,0.13333333333333333,-1295,0.1618798955613577
2014,1343,19,8,1393,529,0.7037037037037037,864,0.7247658688865765
2014,1344,23,11,1762,727,0.6764705882352942,1035,0.7079148252310165
2014,1345,15,17,1168,1144,0.46875,24,0.5051903114186851
2014,1346,20,11,1692,761,0.6451612903225806,931,0.6897676314716673
2014,1347,18,12,1472,806,0.6,666,0.646180860403863
2014,1348,13,18,997,1106,0.41935483870967744,-109,0.4740846409890632
2014,1349,5,23,372,1343,0.17857142857142858,-971,0.21690962099125363
2014,1350,19,14,1356,840,0.5757575757575758,516,0.6174863387978142
2014,1351,14,17,1137,1155,0.45161290322580644,-18,0.49607329842931935
2014,1352,21,13,1552,881,0.6176470588235294,671,0.637895602137279
2014,1353,11,21,868,1363,0.34375,-495,0.3890632003585836
2014,1354,7,21,509,1227,0.25,-718,0.2932027649769585
2014,1355,16,12,1197,807,0.5714285714285714,390,0.5973053892215568
2014,1356,13,19,917,1195,0.40625,-278,0.4341856060606061
2014,1357,5,26,367,1795,0.16129032258064516,-1428,0.16975023126734506
2014,1358,21,10,1673,617,0.6774193548387096,1056,0.7305676855895197
2014,1359,10,20,769,1324,0.3333333333333333,-555,0.36741519350215
2014,1360,14,16,965,1007,0.4666666666666667,-42,0.4893509127789047
2014,1361,27,4,1895,224,0.8709677419354839,1671,0.8942897593204342
2014,1362,19,11,1425,790,0.6333333333333333,635,0.6433408577878104
2014,1363,5,24,391,1387,0.1724137931034483,-996,0.21991001124859394
2014,1364,19,9,1389,591,0.6785714285714286,798,0.7015151515151515
2014,1365,12,19,885,1274,0.3870967741935484,-389,0.4099119962945808
2014,1366,11,19,745,1063,0.36666666666666664,-318,0.4120575221238938
2014,1367,17,14,1275,969,0.5483870967741935,306,0.5681818181818182
2014,1368,10,18,721,1181,0.35714285714285715,-460,0.37907465825446895
2014,1369,16,14,1372,1055,0.5333333333333333,317,0.565306963329213
2014,1370,11,17,785,1188,0.39285714285714285,-403,0.39787126203750633
2014,1371,17,17,1303,1139,0.5,164,0.5335790335790336
2014,1372,29,2,2231,120,0.9354838709677419,2111,0.9489578902594641
2014,1373,15,17,1051,1186,0.46875,-135,0.4698256593652213
2014,1374,23,9,1685,599,0.71875,1086,0.7377408056042032
2014,1375,8,20,604,1283,0.2857142857142857,-679,0.320084790673026
2014,1376,14,20,1068,1255,0.4117647058823529,-187,0.4597503228583728
2014,1377,9,18,629,1177,0.3333333333333333,-548,0.34828349944629017
2014,1378,12,20,885,1215,0.375,-330,0.42142857142857143
2014,1379,25,6,1823,368,0.8064516129032258,1455,0.8320401643085349
2014,1380,16,13,1185,794,0.5517241379310345,391,0.5987872662961091
2014,1381,1,27,77,1548,0.03571428571428571,-1471,0.047384615384615386
2014,1382,18,15,1399,1022,0.5454545454545454,377,0.5778603882693102
2014,1383,17,14,1208,916,0.5483870967741935,292,0.568738229755179
2014,1384,10,21,728,1188,0.3225806451612903,-460,0.37995824634655534
2014,1385,20,12,1519,806,0.625,713,0.6533333333333333
2014,1386,24,9,1764,588,0.7272727272727273,1176,0.75
2014,1387,25,6,1795,377,0.8064516129032258,1418,0.826427255985267
2014,1388,21,11,1645,648,0.65625,997,0.7174007849978195
2014,1389,14,17,939,1022,0.45161290322580644,-83,0.4788373278939317
2014,1390,21,12,1621,805,0.6363636363636364,816,0.6681780708985985
2014,1391,7,24,467,1449,0.22580645161290322,-982,0.24373695198329853
2014,1392,22,10,1617,673,0.6875,944,0.7061135371179039
2014,1393,27,5,1881,300,0.84375,1581,0.8624484181568088
2014,1394,16,14,1161,891,0.5333333333333333,270,0.5657894736842105
2014,1395,8,22,580,1320,0.26666666666666666,-740,0.30526315789473685
2014,1396,9,22,737,1554,0.2903225806451613,-817,0.32169358358795286
2014,1397,20,12,1539,717,0.625,822,0.6821808510638298
2014,1398,4,25,287,1666,0.13793103448275862,-1379,0.14695340501792115
2014,1399,15,16,1139,1033,0.4838709677419355,106,0.5244014732965009
2014,1400,23,10,1753,693,0.696969696969697,1060,0.7166802943581357
2014,1401,17,15,1251,834,0.53125,417,0.6
2014,1402,6,23,406,1345,0.20689655172413793,-939,0.23186750428326672
2014,1403,14,18,1055,1135,0.4375,-80,0.4817351598173516
2014,1404,6,23,504,1626,0.20689655172413793,-1122,0.23661971830985915
2014,1405,26,6,2097,436,0.8125,1661,0.8278720884326886
2014,1406,22,10,1683,629,0.6875,1054,0.7279411764705882
2014,1407,9,20,705,1240,0.3103448275862069,-535,0.36246786632390743
2014,1408,16,16,1113,928,0.5,185,0.5453209211170995
2014,1409,21,12,1568,844,0.6363636363636364,724,0.6500829187396352
2014,1410,8,23,581,1426,0.25806451612903225,-845,0.2894867962132536
2014,1411,18,14,1409,993,0.5625,416,0.5865945045795171
2014,1412,16,13,1189,905,0.5517241379310345,284,0.5678127984718243
2014,1413,7,22,530,1471,0.2413793103448276,-941,0.26486756621689156
2014,1414,21,11,1441,772,0.65625,669,0.6511522819701763
2014,1415,8,21,601,1339,0.27586206896551724,-738,0.3097938144329897
2014,1416,11,18,914,1156,0.3793103448275862,-242,0.44154589371980674
2014,1417,26,8,2225,557,0.7647058823529411,1668,0.799784327821711
2014,1418,20,11,1671,804,0.6451612903225806,867,0.6751515151515152
2014,1419,9,17,686,968,0.34615384615384615,-282,0.4147521160822249
2014,1420,8,21,568,1316,0.27586206896551724,-748,0.30148619957537154
2014,1421,14,15,1130,1101,0.4827586206896552,29,0.5064993276557598
2014,1422,11,18,810,1193,0.3793103448275862,-383,0.40439340988517225
2014,1423,7,23,484,1382,0.23333333333333334,-898,0.25937834941050375
2014,1424,20,13,1512,843,0.6060606060606061,669,0.6420382165605095
2014,1425,10,21,780,1405,0.3225806451612903,-625,0.35697940503432496
2014,1426,13,17,982,1269,0.43333333333333335,-287,0.4362505553087517
2014,1427,6,21,489,1352,0.2222222222222222,-863,0.26561651276480175
2014,1428,19,11,1497,672,0.6333333333333333,825,0.690179806362379
2014,1429,17,14,1276,855,0.5483870967741935,421,0.5987799155326138
2014,1430,18,11,1259,646,0.6206896551724138,613,0.6608923884514436
2014,1431,21,10,1493,647,0.6774193548387096,846,0.6976635514018692
2014,1433,26,8,2008,541,0.7647058823529411,1467,0.7877599058454295
2014,1434,15,15,1132,955,0.5,177,0.5424053665548635
2014,1435,15,16,1046,956,0.4838709677419355,90,0.5224775224775224
2014,1436,20,10,1471,646,0.6666666666666666,825,0.6948512045347189
2014,1437,28,4,2240,273,0.875,1967,0.8913649025069638
2014,1438,28,6,1890,352,0.8235294117647058,1538,0.8429973238180196
2014,1439,9,22,703,1247,0.2903225806451613,-544,0.3605128205128205
2014,1440,15,12,1366,881,0.5555555555555556,485,0.6079216733422341
2014,1441,16,15,1249,1014,0.5161290322580645,235,0.5519222271321255
2014,1442,7,20,487,1119,0.25925925925925924,-632,0.30323785803237857
2014,1443,19,12,1324,769,0.6129032258064516,555,0.63258480649785
2014,1444,22,9,1683,554,0.7096774193548387,1129,0.7523468931604828
2014,1447,18,12,1326,816,0.6,510,0.6190476190476191
2014,1448,17,16,1305,995,0.5151515151515151,310,0.5673913043478261
2014,1449,17,15,1358,1026,0.53125,332,0.5696308724832215
2014,1450,9,21,639,1215,0.3,-576,0.3446601941747573
2014,1451,17,11,1296,717,0.6071428571428571,579,0.6438152011922503
2014,1452,17,15,1455,1026,0.53125,429,0.5864570737605804
2014,1453,21,6,1608,377,0.7777777777777778,1231,0.8100755667506297
2014,1454,20,13,1508,815,0.6060606060606061,693,0.6491605682307361
2014,1455,33,0,2473,0,1.0,2473,1.0
2014,1456,19,12,1472,774,0.6129032258064516,698,0.655387355298308
2014,1457,17,13,1314,847,0.5666666666666667,467,0.6080518278574734
2014,1458,26,7,1960,467,0.7878787878787878,1493,0.80758137618459
2014,1459,17,12,1199,698,0.5862068965517241,501,0.6320506062203479
2014,1460,18,14,1218,909,0.5625,309,0.5726375176304654
2014,1461,16,14,1116,823,0.5333333333333333,293,0.5755544094894275
2014,1462,21,12,1569,814,0.6363636363636364,755,0.6584137641628199
2014,1463,14,13,1009,768,0.5185185185185185,241,0.5678109172763084
2014,1464,12,17,896,1271,0.41379310344827586,-375,0.4134748500230734
2014,3101,11,12,863,747,0.4782608695652174,116,0.5360248447204969
2014,3102,1,28,82,1473,0.034482758620689655,-1391,0.052733118971061095
2014,3103,22,9,1903,662,0.7096774193548387,1241,0.7419103313840156
2014,3104,14,16,1014,930,0.4666666666666667,84,0.5216049382716049
2014,3105,6,24,438,1537,0.2,-1099,0.22177215189873417
2014,3106,13,14,924,781,0.48148148148148145,143,0.5419354838709678
2014,3107,28,4,2081,216,0.875,1865,0.9059643012625164
2014,3108,8,22,477,1114,0.26666666666666666,-637,0.2998114393463231
2014,3110,22,9,1457,535,0.7096774193548387,922,0.731425702811245
2014,3111,12,16,828,920,0.42857142857142855,-92,0.47368421052631576
2014,3112,5,25,326,1410,0.16666666666666666,-1084,0.18778801843317972
2014,3113,22,9,1644,524,0.7096774193548387,1120,0.7583025830258303
2014,3114,18,12,1202,617,0.6,585,0.6608026388125343
2014,3115,2,25,143,1419,0.07407407407407407,-1276,0.09154929577464789
2014,3116,19,11,1405,592,0.6333333333333333,813,0.7035553329994992
2014,3117,22,11,1738,685,0.6666666666666666,1053,0.7172926124638878
2014,3119,24,7,1606,430,0.7741935483870968,1176,0.7888015717092338
2014,3120,17,14,1157,868,0.5483870967741935,289,0.571358024691358
2014,3122,8,20,628,1296,0.2857142857142857,-668,0.3264033264033264
2014,3123,18,16,1290,1024,0.5294117647058824,266,0.557476231633535
2014,3124,29,4,2458,314,0.8787878787878788,2144,0.8867243867243867
2014,3125,14,17,996,1011,0.45161290322580644,-15,0.4962630792227205
2014,3126,10,18,670,955,0.35714285714285715,-285,0.4123076923076923
2014,3127,5,25,291,1196,0.16666666666666666,-905,0.1956960322797579
2014,3129,15,13,1123,847,0.5357142857142857,276,0.5700507614213198
2014,3130,12,19,877,1168,0.3870967741935484,-291,0.4288508557457213
2014,3131,13,20,860,1107,0.3939393939393939,-247,0.43721403152008137
2014,3132,27,4,1935,242,0.8709677419354839,1693,0.8888378502526413
2014,3133,8,22,597,1493,0.26666666666666666,-896,0.2856459330143541
2014,3135,10,18,669,1102,0.35714285714285715,-433,0.37775268210050816
2014,3136,17,14,1275,948,0.5483870967741935,327,0.573549257759784
2014,3137,16,13,1192,766,0.5517241379310345,426,0.6087844739530133
2014,3138,16,13,1085,868,0.5517241379310345,217,0.5555555555555556
2014,3139,15,15,1023,923,0.5,100,0.5256937307297019
2014,3140,26,6,1966,350,0.8125,1616,0.8488773747841105
2014,3141,20,11,1741,821,0.6451612903225806,920,0.6795472287275566
2014,3142,18,13,1435,926,0.5806451612903226,509,0.6077933079203727
2014,3143,21,9,1530,582,0.7,948,0.7244318181818182
2014,3144,17,12,1149,701,0.5862068965517241,448,0.6210810810810811
2014,3145,13,17,836,912,0.43333333333333335,-76,0.4782608695652174
2014,3146,16,12,1036,634,0.5714285714285714,402,0.6203592814371257
2014,3148,11,17,764,1007,0.39285714285714285,-243,0.4313946922642575
2014,3149,5,22,357,1260,0.18518518518518517,-903,0.22077922077922077
2014,3150,15,15,1105,951,0.5,154,0.5374513618677043
2014,3151,29,3,2076,173,0.90625,1903,0.9230769230769231
2014,3152,1,26,55,1365,0.037037037037037035,-1310,0.03873239436619718
2014,3153,13,18,821,827,0.41935483870967744,-6,0.4981796116504854
2014,3155,13,19,892,996,0.40625,-104,0.4724576271186441
2014,3156,13,16,1028,1151,0.4482758620689655,-123,0.4717760440569068
2014,3157,12,16,931,1018,0.42857142857142855,-87,0.4776808619805028
2014,3158,17,14,1314,827,0.5483870967741935,487,0.6137319009808501
2014,3159,8,22,584,1271,0.26666666666666666,-687,0.3148247978436658
2014,3160,17,14,1260,875,0.5483870967741935,385,0.5901639344262295
2014,3161,23,7,1765,402,0.7666666666666667,1363,0.8144900784494693
2014,3162,6,22,429,1252,0.21428571428571427,-823,0.2552052349791791
2014,3163,34,0,2812,0,1.0,2812,1.0
2014,3164,15,14,1086,803,0.5172413793103449,283,0.5749073583906829
2014,3165,14,14,984,784,0.5,200,0.5565610859728507
2014,3166,19,13,1372,727,0.59375,645,0.653644592663173
2014,3167,17,11,1374,726,0.6071428571428571,648,0.6542857142857142
2014,3168,12,18,820,1035,0.4,-215,0.4420485175202156
2014,3169,18,14,1288,905,0.5625,383,0.5873233014135887
2014,3170,18,12,1661,833,0.6,828,0.6659983961507618
2014,3171,5,23,325,1244,0.17857142857142858,-919,0.207138304652645
2014,3172,16,16,1221,1000,0.5,221,0.5497523638000901
2014,3173,23,7,1941,518,0.7666666666666667,1423,0.7893452623017487
2014,3174,20,10,1334,588,0.6666666666666666,746,0.6940686784599376
2014,3175,6,21,474,1230,0.2222222222222222,-756,0.27816901408450706
2014,3176,9,23,703,1505,0.28125,-802,0.3183876811594203
2014,3177,27,6,2285,478,0.8181818181818182,1807,0.8269996380745567
2014,3178,5,23,403,1564,0.17857142857142858,-1161,0.2048805287239451
2014,3179,17,15,1321,952,0.53125,369,0.5811702595688517
2014,3180,15,16,965,878,0.4838709677419355,87,0.5236028214867064
2014,3181,27,6,2259,389,0.8181818181818182,1870,0.8530966767371602
2014,3182,19,12,1362,773,0.6129032258064516,589,0.6379391100702576
2014,3183,12,16,831,925,0.42857142857142855,-94,0.4732346241457859
2014,3184,16,13,1155,817,0.5517241379310345,338,0.5856997971602435
2014,3185,14,13,1078,875,0.5185185185185185,203,0.5519713261648745
2014,3186,15,14,1092,899,0.5172413793103449,193,0.5484681064791562
2014,3187,21,8,1502,577,0.7241379310344828,925,0.7224627224627225
2014,3188,11,19,791,1164,0.36666666666666664,-373,0.4046035805626598
2014,3189,13,16,884,968,0.4482758620689655,-84,0.4773218142548596
2014,3190,9,21,688,1276,0.3,-588,0.35030549898167007
2014,3191,15,15,1091,914,0.5,177,0.5441396508728179
2014,3192,3,26,226,1517,0.10344827586206896,-1291,0.12966150315547906
2014,3193,20,10,1315,527,0.6666666666666666,788,0.7138979370249728
2014,3194,15,14,1230,981,0.5172413793103449,249,0.5563093622795116
2014,3195,26,7,1933,389,0.7878787878787878,1544,0.8324720068906115
2014,3196,19,12,1558,770,0.6129032258064516,788,0.6692439862542955
2014,3197,16,14,1188,941,0.5333333333333333,247,0.5580084546735556
2014,3198,14,18,1057,1146,0.4375,-89,0.47980027235587835
2014,3199,20,11,1467,721,0.6451612903225806,746,0.6704753199268738
2014,3200,25,7,1699,445,0.78125,1254,0.7924440298507462
2014,3201,20,10,1493,610,0.6666666666666666,883,0.7099381835473134
2014,3202,16,12,1160,696,0.5714285714285714,464,0.625
2014,3203,20,10,1623,631,0.6666666666666666,992,0.7200532386867791
2014,3204,10,21,711,1222,0.3225806451612903,-511,0.3678220382824625
2014,3205,15,14,1013,852,0.5172413793103449,161,0.5431635388739946
2014,3206,8,23,650,1488,0.25806451612903225,-838,0.304022450888681
2014,3207,10,21,697,1314,0.3225806451612903,-617,0.34659373446046743
2014,3208,20,11,1402,655,0.6451612903225806,747,0.681575109382596
2014,3209,12,19,869,1213,0.3870967741935484,-344,0.4173871277617675
2014,3210,20,11,1743,728,0.6451612903225806,1015,0.7053824362606232
2014,3211,29,4,2237,253,0.8787878787878788,1984,0.8983935742971888
2014,3212,9,20,693,1296,0.3103448275862069,-603,0.34841628959276016
2014,3213,19,8,1366,489,0.7037037037037037,877,0.736388140161725
2014,3214,28,4,2042,232,0.875,1810,0.8979771328056289
2014,3216,13,18,867,958,0.41935483870967744,-91,0.47506849315068495
2014,3217,21,7,1599,414,0.75,1185,0.7943368107302533
2014,3218,17,13,1182,754,0.5666666666666667,428,0.6105371900826446
2014,3219,21,10,1620,633,0.6774193548387096,987,0.7190412782956058
2014,3220,13,15,876,875,0.4642857142857143,1,0.5002855511136494
2014,3221,20,12,1513,742,0.625,771,0.6709534368070953
2014,3222,6,25,382,1287,0.1935483870967742,-905,0.22887956860395448
2014,3223,11,17,783,1092,0.39285714285714285,-309,0.4176
2014,3224,11,20,753,1120,0.3548387096774194,-367,0.402028830752803
2014,3225,23,8,1789,497,0.7419354838709677,1292,0.7825896762904637
2014,3226,12,17,884,979,0.41379310344827586,-95,0.4745034889962426
2014,3227,21,8,1578,519,0.7241379310344828,1059,0.7525035765379113
2014,3228,9,21,725,1310,0.3,-585,0.35626535626535627
2014,3229,10,20,688,1148,0.3333333333333333,-460,0.3747276688453159
2014,3230,3,15,186,847,0.16666666666666666,-661,0.18005808325266215
2014,3231,18,12,1419,700,0.6,719,0.6696554978763568
2014,3232,20,11,1365,655,0.6451612903225806,710,0.6757425742574258
2014,3233,26,5,1968,323,0.8387096774193549,1645,0.859013531209079
2014,3234,26,8,2085,589,0.7647058823529411,1496,0.7797307404637247
2014,3235,20,10,1619,591,0.6666666666666666,1028,0.7325791855203619
2014,3236,13,14,1110,945,0.48148148148148145,165,0.5401459854014599
2014,3237,20,9,1502,524,0.6896551724137931,978,0.7413622902270484
2014,3238,15,15,1065,888,0.5,177,0.5453149001536098
2014,3239,13,17,953,958,0.43333333333333335,-5,0.4986917844060701
2014,3240,14,18,980,1055,0.4375,-75,0.48157248157248156
2014,3241,28,5,2118,363,0.8484848484848485,1755,0.8536880290205562
2014,3242,13,19,997,1137,0.40625,-140,0.46719775070290537
2014,3243,11,19,811,1054,0.36666666666666664,-243,0.43485254691689007
2014,3244,6,24,435,1369,0.2,-934,0.24113082039911307
2014,3245,7,23,451,1200,0.23333333333333334,-749,0.27316777710478496
2014,3246,24,8,2091,512,0.75,1579,0.803303880138302
2014,3247,15,15,973,763,0.5,210,0.5604838709677419
2014,3248,14,16,999,926,0.4666666666666667,73,0.518961038961039
2014,3249,17,12,1297,747,0.5862068965517241,550,0.6345401174168297
2014,3250,13,18,977,1157,0.41935483870967744,-180,0.457825679475164
2014,3251,19,11,1391,699,0.6333333333333333,692,0.6655502392344498
2014,3252,6,24,507,1574,0.2,-1067,0.24363286881307064
2014,3253,17,15,1302,926,0.53125,376,0.5843806104129264
2014,3254,9,21,614,1175,0.3,-561,0.3432084963666853
2014,3255,8,22,515,1181,0.26666666666666666,-666,0.30365566037735847
2014,3256,12,20,817,1249,0.375,-432,0.39545014520813165
2014,3257,30,4,2454,228,0.8823529411764706,2226,0.9149888143176734
2014,3258,9,21,729,1414,0.3,-685,0.3401773215118992
2014,3259,5,25,325,1271,0.16666666666666666,-946,0.20363408521303258
2014,3260,11,21,788,1163,0.34375,-375,0.40389543823680163
2014,3261,19,12,1402,756,0.6129032258064516,646,0.6496756255792401
2014,3262,4,23,276,1479,0.14814814814814814,-1203,0.15726495726495726
2014,3263,16,14,1127,831,0.5333333333333333,296,0.5755873340143003
2014,3264,9,21,546,1244,0.3,-698,0.30502793296089387
2014,3265,27,6,2019,376,0.8181818181818182,1643,0.8430062630480167
2014,3266,21,10,1600,688,0.6774193548387096,912,0.6993006993006993
2014,3267,8,20,573,1155,0.2857142857142857,-582,0.3315972222222222
2014,3268,24,6,2089,406,0.8,1683,0.8372745490981964
2014,3269,4,27,265,1667,0.12903225806451613,-1402,0.13716356107660455
2014,3270,17,13,1230,762,0.5666666666666667,468,0.6174698795180723
2014,3271,8,21,602,1233,0.27586206896551724,-631,0.32806539509536786
2014,3272,13,18,921,1047,0.41935483870967744,-126,0.4679878048780488
2014,3273,17,14,1168,818,0.5483870967741935,350,0.5881168177240684
2014,3274,16,14,1227,869,0.5333333333333333,358,0.5854007633587787
2014,3275,8,22,582,1365,0.26666666666666666,-783,0.29892141756548535
2014,3276,18,13,1335,809,0.5806451612903226,526,0.6226679104477612
2014,3277,22,9,1738,538,0.7096774193548387,1200,0.7636203866432337
2014,3278,20,12,1458,747,0.625,711,0.6612244897959184
2014,3279,12,20,968,1340,0.375,-372,0.4194107452339688
2014,3280,19,13,1490,793,0.59375,697,0.6526500219010074
2014,3281,17,13,1299,809,0.5666666666666667,490,0.6162239089184061
2014,3282,10,19,798,1332,0.3448275862068966,-534,0.37464788732394366
2014,3283,14,17,1098,988,0.45161290322580644,110,0.5263662511984659
2014,3284,8,25,530,1363,0.24242424242424243,-833,0.2799788695192816
2014,3285,21,10,1537,581,0.6774193548387096,956,0.7256846081208688
2014,3286,13,15,1081,1000,0.4642857142857143,81,0.5194617972128784
2014,3287,11,17,737,1033,0.39285714285714285,-296,0.41638418079096046
2014,3288,4,24,259,1275,0.14285714285714285,-1016,0.16883963494132986
2014,3290,9,21,587,1251,0.3,-664,0.3193688792165397
2014,3291,19,13,1445,813,0.59375,632,0.6399468556244464
2014,3292,29,4,1995,236,0.8787878787878788,1759,0.8942178395338414
2014,3293,10,17,781,1151,0.37037037037037035,-370,0.40424430641821946
2014,3294,13,15,919,852,0.4642857142857143,67,0.5189158667419537
2014,3295,4,24,302,1539,0.14285714285714285,-1237,0.16404128191200434
2014,3296,11,19,771,1081,0.36666666666666664,-310,0.41630669546436283
2014,3297,17,12,1180,689,0.5862068965517241,491,0.6313536650615302
2014,3298,24,7,1717,396,0.7741935483870968,1321,0.812588736393753
2014,3299,23,6,1579,324,0.7931034482758621,1255,0.8297425118234367
2014,3300,11,18,722,910,0.3793103448275862,-188,0.4424019607843137
2014,3301,25,7,1931,491,0.78125,1440,0.7972749793559042
2014,3303,9,16,647,974,0.36,-327,0.39913633559531153
2014,3304,25,6,1953,391,0.8064516129032258,1562,0.8331911262798635
2014,3305,17,13,1330,807,0.5666666666666667,523,0.6223678053345811
2014,3306,18,12,1198,629,0.6,569,0.655719759168035
2014,3307,11,19,769,1132,0.36666666666666664,-363,0.40452393477117304
2014,3308,10,20,841,1285,0.3333333333333333,-444,0.3955785512699906
2014,3310,10,20,710,1238,0.3333333333333333,-528,0.364476386036961
2014,3311,16,14,1191,834,0.5333333333333333,357,0.5881481481481482
2014,3312,7,21,455,1151,0.25,-696,0.2833125778331258
2014,3313,11,16,717,899,0.4074074074074074,-182,0.4436881188118812
2014,3314,24,9,2020,643,0.7272727272727273,1377,0.758542996620353
2014,3315,20,9,1442,555,0.6896551724137931,887,0.7220831246870305
2014,3316,5,23,307,1232,0.17857142857142858,-925,0.19948018193632228
2014,3317,11,18,788,1074,0.3793103448275862,-286,0.42320085929108486
2014,3318,12,18,853,1062,0.4,-209,0.4454308093994778
2014,3319,9,20,766,1345,0.3103448275862069,-579,0.3628612032212222
2014,3320,17,13,1316,732,0.5666666666666667,584,0.642578125
2014,3321,15,15,1084,989,0.5,95,0.5229136517124939
2014,3322,19,12,1316,664,0.6129032258064516,652,0.6646464646464646
2014,3323,32,0,2772,0,1.0,2772,1.0
2014,3324,11,17,881,1044,0.39285714285714285,-163,0.45766233766233766
2014,3325,8,21,628,1167,0.27586206896551724,-539,0.3498607242339833
2014,3326,17,18,1298,1027,0.4857142857142857,271,0.5582795698924731
2014,3328,18,14,1419,1038,0.5625,381,0.5775335775335775
2014,3329,23,8,1694,504,0.7419354838709677,1190,0.7707006369426752
2014,3330,17,15,1283,909,0.53125,374,0.5853102189781022
2014,3331,8,20,619,1149,0.2857142857142857,-530,0.3501131221719457
2014,3332,15,15,1553,1253,0.5,300,0.5534568781183179
2014,3333,22,10,1625,623,0.6875,1002,0.722864768683274
2014,3334,16,12,1291,820,0.5714285714285714,471,0.6115585030791094
2014,3335,22,6,1510,314,0.7857142857142857,1196,0.8278508771929824
2014,3336,22,7,1703,498,0.7586206896551724,1205,0.7737392094502499
2014,3337,6,25,495,1502,0.1935483870967742,-1007,0.24787180771156736
2014,3338,11,20,744,1201,0.3548387096774194,-457,0.3825192802056555
2014,3339,14,16,1048,1000,0.4666666666666667,48,0.51171875
2014,3340,7,21,501,1308,0.25,-807,0.2769485903814262
2014,3341,14,17,1052,973,0.45161290322580644,79,0.5195061728395062
2014,3342,10,19,595,849,0.3448275862068966,-254,0.4120498614958449
2014,3343,20,8,1572,531,0.7142857142857143,1041,0.7475035663338089
2014,3344,7,23,559,1516,0.23333333333333334,-957,0.2693975903614458
2014,3345,21,8,1595,567,0.7241379310344828,1028,0.7377428307123034
2014,3346,21,12,1552,876,0.6363636363636364,676,0.6392092257001647
2014,3347,5,23,299,1224,0.17857142857142858,-925,0.1963230466185161
2014,3348,6,23,399,1193,0.20689655172413793,-794,0.2506281407035176
2014,3349,13,17,897,974,0.43333333333333335,-77,0.4794227685729556
2014,3350,14,16,982,939,0.4666666666666667,43,0.5111920874544508
2014,3351,15,17,1035,1005,0.46875,30,0.5073529411764706
2014,3352,21,11,1542,699,0.65625,843,0.6880856760374833
2014,3353,22,9,1521,537,0.7096774193548387,984,0.739067055393586
2014,3354,6,20,384,1061,0.23076923076923078,-677,0.2657439446366782
2014,3355,22,9,1679,499,0.7096774193548387,1180,0.77089072543618
2014,3356,5,25,335,1359,0.16666666666666666,-1024,0.19775678866587956
2014,3357,12,18,901,1167,0.4,-266,0.43568665377176014
2014,3358,12,16,916,872,0.42857142857142855,44,0.5123042505592841
2014,3359,10,19,616,968,0.3448275862068966,-352,0.3888888888888889
2014,3360,21,8,1524,477,0.7241379310344828,1047,0.7616191904047976
2014,3361,13,17,931,989,0.43333333333333335,-58,0.48489583333333336
2014,3362,12,19,893,1249,0.3870967741935484,-356,0.4169000933706816
2014,3363,10,19,831,1377,0.3448275862068966,-546,0.3763586956521739
2014,3364,7,22,506,1345,0.2413793103448276,-839,0.27336574824419235
2014,3365,9,20,666,1274,0.3103448275862069,-608,0.34329896907216495
2014,3366,17,14,1223,767,0.5483870967741935,456,0.6145728643216081
2014,3367,16,14,1168,828,0.5333333333333333,340,0.5851703406813628
2014,3368,7,22,529,1427,0.2413793103448276,-898,0.27044989775051126
2014,3369,9,19,637,1131,0.32142857142857145,-494,0.3602941176470588
2014,3370,16,16,1214,1096,0.5,118,0.5255411255411255
2014,3371,18,13,1372,830,0.5806451612903226,542,0.623069936421435
2014,3372,18,12,1303,733,0.6,570,0.6399803536345776
2014,3373,9,22,620,1288,0.2903225806451613,-668,0.3249475890985325
2014,3374,17,13,1304,724,0.5666666666666667,580,0.6429980276134122
2014,3375,7,20,471,1162,0.25925925925925924,-691,0.288426209430496
2014,3376,27,4,2019,250,0.8709677419354839,1769,0.8898193036579991
2014,3377,17,13,1373,889,0.5666666666666667,484,0.6069849690539346
2014,3378,19,12,1412,683,0.6129032258064516,729,0.6739856801909307
2014,3379,24,6,1913,412,0.8,1501,0.8227956989247311
2014,3380,18,8,1363,502,0.6923076923076923,861,0.7308310991957104
2014,3381,20,9,1544,602,0.6896551724137931,942,0.7194780987884436
2014,3382,23,10,1511,526,0.696969696969697,985,0.7417771232204222
2014,3383,19,11,1312,690,0.6333333333333333,622,0.6553446553446554
2014,3384,15,17,1401,1236,0.46875,165,0.5312855517633674
2014,3385,22,10,1536,596,0.6875,940,0.7204502814258912
2014,3386,22,9,1657,582,0.7096774193548387,1075,0.7400625279142474
2014,3387,12,18,777,1086,0.4,-309,0.4170692431561997
2014,3388,22,9,1730,662,0.7096774193548387,1068,0.7232441471571907
2014,3389,3,27,197,1288,0.1,-1091,0.13265993265993267
2014,3390,29,3,2276,207,0.90625,2069,0.9166331051147805
2014,3391,25,7,2111,444,0.78125,1667,0.8262230919765167
2014,3392,24,8,1667,439,0.75,1228,0.7915479582146249
2014,3393,22,9,1701,577,0.7096774193548387,1124,0.7467076382791923
2014,3394,17,12,1196,740,0.5862068965517241,456,0.6177685950413223
2014,3395,18,14,1251,763,0.5625,488,0.6211519364448858
2014,3396,14,16,982,955,0.4666666666666667,27,0.5069695405265875
2014,3397,27,5,2175,351,0.84375,1824,0.8610451306413301
2014,3398,11,18,841,1149,0.3793103448275862,-308,0.4226130653266332
2014,3399,11,18,805,1148,0.3793103448275862,-343,0.4121863799283154
2014,3400,21,11,1572,654,0.65625,918,0.706199460916442
2014,3401,24,8,1724,524,0.75,1200,0.7669039145907474
2014,3402,14,15,957,884,0.4827586206896552,73,0.5198261814231396
2014,3403,6,24,416,1326,0.2,-910,0.23880597014925373
2014,3404,24,7,2197,426,0.7741935483870968,1771,0.8375905451772779
2014,3405,16,16,1190,1034,0.5,156,0.5350719424460432
2014,3406,13,17,878,898,0.43333333333333335,-20,0.49436936936936937
2014,3407,11,18,975,1319,0.3793103448275862,-344,0.42502179598953793
2014,3408,19,10,1380,598,0.6551724137931034,782,0.6976744186046512
2014,3409,12,16,882,1065,0.42857142857142855,-183,0.4530046224961479
2014,3410,12,16,806,960,0.42857142857142855,-154,0.4563986409966025
2014,3411,20,12,1473,785,0.625,688,0.6523472099202834
2014,3412,16,15,1166,935,0.5161290322580645,231,0.5549738219895288
2014,3413,14,16,1011,987,0.4666666666666667,24,0.506006006006006
2014,3414,16,15,1235,996,0.5161290322580645,239,0.5535634244733303
2014,3415,6,22,508,1373,0.21428571428571427,-865,0.27006911217437535
2014,3416,9,20,589,1045,0.3103448275862069,-456,0.36046511627906974
2014,3417,13,18,956,1020,0.41935483870967744,-64,0.48380566801619435
2014,3418,12,16,834,961,0.42857142857142855,-127,0.4646239554317549
2014,3419,10,20,812,1276,0.3333333333333333,-464,0.3888888888888889
2014,3420,3,25,190,1228,0.10714285714285714,-1038,0.13399153737658676
2014,3421,10,20,659,1154,0.3333333333333333,-495,0.36348593491450637
2014,3422,7,23,526,1379,0.23333333333333334,-853,0.2761154855643045
2014,3423,5,27,306,1399,0.15625,-1093,0.17947214076246334
2014,3424,13,19,987,1148,0.40625,-161,0.46229508196721314
2014,3425,22,12,1548,734,0.6470588235294118,814,0.6783523225241017
2014,3426,4,25,300,1473,0.13793103448275862,-1173,0.1692047377326565
2014,3427,14,17,952,970,0.45161290322580644,-18,0.4953173777315297
2014,3428,12,19,792,1054,0.3870967741935484,-262,0.42903575297941493
2014,3429,14,15,1127,1085,0.4827586206896552,42,0.509493670886076
2014,3430,6,23,440,1435,0.20689655172413793,-995,0.23466666666666666
2014,3431,23,7,1867,475,0.7666666666666667,1392,0.7971818958155422
2014,3433,22,9,1780,570,0.7096774193548387,1210,0.7574468085106383
2014,3434,6,25,476,1536,0.1935483870967742,-1060,0.23658051689860835
2014,3435,18,12,1421,736,0.6,685,0.6587853500231804
2014,3436,7,23,519,1340,0.23333333333333334,-821,0.279182356105433
2014,3437,22,8,1482,456,0.7333333333333333,1026,0.7647058823529411
2014,3438,14,17,1070,1109,0.45161290322580644,-39,0.49105094079853145
2014,3439,14,16,999,941,0.4666666666666667,58,0.5149484536082474
2014,3441,15,17,979,986,0.46875,-7,0.49821882951653945
2014,3442,11,16,875,1185,0.4074074074074074,-310,0.42475728155339804
2014,3443,24,8,1822,516,0.75,1306,0.7792985457656116
2014,3444,13,18,992,1082,0.41935483870967744,-90,0.4783027965284474
2014,3447,9,21,642,1288,0.3,-646,0.33264248704663213
2014,3448,15,16,1111,992,0.4838709677419355,119,0.5282929148834997
2014,3449,17,13,1281,896,0.5666666666666667,385,0.5884244372990354
2014,3450,17,16,1404,1044,0.5151515151515151,360,0.5735294117647058
2014,3451,5,22,374,1423,0.18518518518518517,-1049,0.20812465219810797
2014,3452,29,4,2181,257,0.8787878787878788,1924,0.894585726004922
2014,3453,22,9,1596,533,0.7096774193548387,1063,0.7496477219351808
2014,3454,8,22,632,1449,0.26666666666666666,-817,0.30370014416146085
2014,3455,26,6,1912,378,0.8125,1534,0.8349344978165939
2014,3456,8,21,611,1183,0.27586206896551724,-572,0.34057971014492755
2014,3457,24,8,1678,535,0.75,1143,0.7582467239042024
2014,3458,10,19,723,1176,0.3448275862068966,-453,0.3807266982622433
2014,3459,5,23,345,1295,0.17857142857142858,-950,0.21036585365853658
2014,3460,25,8,2190,576,0.7575757575757576,1614,0.7917570498915402
2014,3461,19,11,1448,751,0.6333333333333333,697,0.658481127785357
2014,3462,8,23,584,1251,0.25806451612903225,-667,0.3182561307901907
2014,3463,13,15,951,885,0.4642857142857143,66,0.5179738562091504
2014,3464,13,16,983,1032,0.4482758620689655,-49,0.4878411910669975
2015,1101,7,21,542,1166,0.25,-624,0.31733021077283374
2015,1102,12,17,839,1038,0.41379310344827586,-199,0.44698987746403834
2015,1103,20,14,1396,894,0.5882352941176471,502,0.6096069868995633
2015,1104,17,14,1152,914,0.5483870967741935,238,0.5575992255566312
2015,1105,8,20,579,1137,0.2857142857142857,-558,0.3374125874125874
2015,1106,17,10,1253,656,0.6296296296296297,597,0.6563645887899424
2015,1107,24,8,1627,469,0.75,1158,0.7762404580152672
2015,1108,5,25,384,1517,0.16666666666666666,-1133,0.20199894792214623
2015,1110,17,16,1089,849,0.5151515151515151,240,0.5619195046439629
2015,1111,12,17,829,1012,0.41379310344827586,-183,0.45029875067897884
2015,1112,31,3,2398,201,0.9117647058823529,2197,0.9226625625240477
2015,1113,17,15,1250,972,0.53125,278,0.5625562556255626
2015,1114,12,18,901,1168,0.4,-267,0.43547607539874333
2015,1115,12,20,828,1084,0.375,-256,0.4330543933054393
2015,1116,26,8,2096,557,0.7647058823529411,1539,0.7900490011307953
2015,1117,10,18,692,1082,0.35714285714285715,-390,0.3900789177001127
2015,1119,14,15,1061,1010,0.4827586206896552,51,0.5123128923225495
2015,1120,14,20,1072,1224,0.4117647058823529,-152,0.46689895470383275
2015,1122,6,22,406,1387,0.21428571428571427,-981,0.22643614054657
2015,1123,6,23,421,1439,0.20689655172413793,-1018,0.22634408602150538
2015,1124,23,9,1686,526,0.71875,1160,0.7622061482820977
2015,1125,21,10,1617,670,0.6774193548387096,947,0.7070397901180586
2015,1126,9,21,590,1121,0.3,-531,0.3448275862068966
2015,1127,5,25,342,1369,0.16666666666666666,-1027,0.19988310929281122
2015,1129,23,8,1703,463,0.7419354838709677,1240,0.7862419205909511
2015,1130,13,19,911,1194,0.40625,-283,0.4327790973871734
2015,1131,12,17,831,1137,0.41379310344827586,-306,0.4222560975609756
2015,1132,20,10,1379,623,0.6666666666666666,756,0.6888111888111889
2015,1133,8,24,494,1308,0.25,-814,0.2741398446170921
2015,1135,11,18,771,1114,0.3793103448275862,-343,0.4090185676392573
2015,1136,16,15,1140,918,0.5161290322580645,222,0.5539358600583091
2015,1137,18,14,1283,901,0.5625,382,0.5874542124542125
2015,1138,23,9,1793,607,0.71875,1186,0.7470833333333333
2015,1139,22,10,1640,586,0.6875,1054,0.7367475292003594
2015,1140,23,9,1945,674,0.71875,1271,0.7426498663612066
2015,1141,20,8,1555,542,0.7142857142857143,1013,0.7415355269432523
2015,1142,11,16,757,858,0.4074074074074074,-101,0.46873065015479876
2015,1143,18,15,1330,865,0.5454545454545454,465,0.6059225512528473
2015,1144,7,22,471,1324,0.2413793103448276,-853,0.26239554317548747
2015,1145,16,14,1088,838,0.5333333333333333,250,0.564901349948079
2015,1146,2,27,144,1750,0.06896551724137931,-1606,0.07602956705385427
2015,1148,5,26,303,1531,0.16129032258064516,-1228,0.16521264994547438
2015,1149,16,11,1247,696,0.5925925925925926,551,0.6417910447761194
2015,1150,14,18,1111,1251,0.4375,-140,0.4703640982218459
2015,1151,20,10,1496,615,0.6666666666666666,881,0.708668877309332
2015,1152,5,24,342,1260,0.1724137931034483,-918,0.21348314606741572
2015,1153,22,10,1469,527,0.6875,942,0.7359719438877755
2015,1154,8,19,551,1132,0.2962962962962963,-581,0.3273915626856803
2015,1155,16,15,1080,864,0.5161290322580645,216,0.5555555555555556
2015,1156,16,14,1135,827,0.5333333333333333,308,0.5784913353720693
2015,1157,20,9,1433,611,0.6896551724137931,822,0.7010763209393346
2015,1158,9,24,582,1352,0.2727272727272727,-770,0.30093071354705275
2015,1159,15,17,1033,1056,0.46875,-23,0.4944949736716132
2015,1160,15,17,1183,1010,0.46875,173,0.5394436844505244
2015,1161,26,6,1951,339,0.8125,1612,0.8519650655021834
2015,1162,12,15,795,909,0.4444444444444444,-114,0.4665492957746479
2015,1163,20,14,1367,815,0.5882352941176471,552,0.6264894592117324
2015,1164,7,23,576,1540,0.23333333333333334,-964,0.2722117202268431
2015,1165,12,17,797,964,0.41379310344827586,-167,0.45258375922771155
2015,1166,14,19,1067,1154,0.42424242424242425,-87,0.4804142278253039
2015,1167,11,19,699,1140,0.36666666666666664,-441,0.3800978792822186
2015,1168,7,22,484,1358,0.2413793103448276,-874,0.26275787187839306
2015,1169,7,24,523,1466,0.22580645161290322,-943,0.2629462041226747
2015,1170,18,11,1314,711,0.6206896551724138,603,0.6488888888888888
2015,1171,14,14,946,817,0.5,129,0.5365853658536586
2015,1172,23,7,1899,476,0.7666666666666667,1423,0.7995789473684211
2015,1173,25,8,1753,498,0.7575757575757576,1255,0.778764993336295
2015,1174,10,20,707,1272,0.3333333333333333,-565,0.3572511369378474
2015,1175,16,17,1188,1094,0.48484848484848486,94,0.5205959684487291
2015,1176,12,18,867,998,0.4,-131,0.4648793565683646
2015,1177,12,20,896,1324,0.375,-428,0.4036036036036036
2015,1178,13,18,973,1175,0.41935483870967744,-202,0.45297951582867785
2015,1179,8,22,573,1187,0.26666666666666666,-614,0.3255681818181818
2015,1180,11,18,703,1032,0.3793103448275862,-329,0.4051873198847262
2015,1181,29,4,2374,286,0.8787878787878788,2088,0.8924812030075188
2015,1182,11,19,855,1267,0.36666666666666664,-412,0.4029217719132894
2015,1183,15,14,980,812,0.5172413793103449,168,0.546875
2015,1184,17,11,1206,721,0.6071428571428571,485,0.6258432797093928
2015,1185,17,13,1238,809,0.5666666666666667,429,0.6047874938935027
2015,1186,23,8,1908,552,0.7419354838709677,1356,0.775609756097561
2015,1187,12,19,820,1105,0.3870967741935484,-285,0.42597402597402595
2015,1188,10,16,702,999,0.38461538461538464,-297,0.4126984126984127
2015,1189,13,18,974,1127,0.41935483870967744,-153,0.4635887672536887
2015,1190,14,14,1066,934,0.5,132,0.533
2015,1191,18,12,1302,730,0.6,572,0.640748031496063
2015,1192,7,21,529,1325,0.25,-796,0.2853290183387271
2015,1193,7,24,470,1375,0.22580645161290322,-905,0.25474254742547425
2015,1194,7,20,480,1207,0.25925925925925924,-727,0.2845287492590397
2015,1195,19,10,1375,591,0.6551724137931034,784,0.6993896236012207
2015,1196,16,17,1066,1035,0.48484848484848486,31,0.5073774393146121
2015,1197,2,27,121,1486,0.06896551724137931,-1365,0.07529558182949596
2015,1198,14,17,907,1015,0.45161290322580644,-108,0.47190426638917793
2015,1199,17,16,1215,984,0.5151515151515151,231,0.5525238744884038
2015,1200,9,21,651,1270,0.3,-619,0.33888599687662674
2015,1201,13,17,868,1032,0.43333333333333335,-164,0.4568421052631579
2015,1202,9,22,609,1335,0.2903225806451613,-726,0.3132716049382716
2015,1203,21,12,1554,663,0.6363636363636364,891,0.7009472259810555
2015,1204,19,9,1298,541,0.6785714285714286,757,0.7058183795541055
2015,1205,16,14,1248,942,0.5333333333333333,306,0.5698630136986301
2015,1206,8,22,568,1329,0.26666666666666666,-761,0.29942013705851345
2015,1207,21,10,1579,613,0.6774193548387096,966,0.7203467153284672
2015,1208,21,11,1470,717,0.65625,753,0.6721536351165981
2015,1209,23,9,1657,603,0.71875,1054,0.7331858407079646
2015,1210,12,19,823,1139,0.3870967741935484,-316,0.4194699286442406
2015,1211,31,2,2448,133,0.9393939393939394,2315,0.9484695854320031
2015,1213,15,14,1081,886,0.5172413793103449,195,0.5495678698525673
2015,1214,16,17,1176,1040,0.48484848484848486,136,0.5306859205776173
2015,1216,13,16,834,941,0.4482758620689655,-107,0.46985915492957747
2015,1217,20,7,1355,349,0.7407407407407407,1006,0.79518779342723
2015,1218,20,13,1502,866,0.6060606060606061,636,0.6342905405405406
2015,1219,19,9,1413,580,0.6785714285714286,833,0.708981435022579
2015,1220,20,13,1621,966,0.6060606060606061,655,0.6265945110166216
2015,1221,13,16,906,974,0.4482758620689655,-68,0.4819148936170213
2015,1222,13,19,944,1116,0.40625,-172,0.458252427184466
2015,1223,8,16,595,1059,0.3333333333333333,-464,0.3597339782345828
2015,1224,13,16,837,920,0.4482758620689655,-83,0.4763801935116676
2015,1225,11,17,892,1246,0.39285714285714285,-354,0.41721234798877455
2015,1226,5,23,364,1418,0.17857142857142858,-1054,0.20426487093153758
2015,1227,8,24,570,1465,0.25,-895,0.2800982800982801
2015,1228,19,13,1444,779,0.59375,665,0.6495726495726496
2015,1229,20,12,1403,765,0.625,638,0.647140221402214
2015,1230,14,10,1117,740,0.5833333333333334,377,0.6015078082929456
2015,1231,20,13,1647,910,0.6060606060606061,737,0.644114196323817
2015,1232,14,16,989,993,0.4666666666666667,-4,0.4989909182643794
2015,1233,26,8,2102,605,0.7647058823529411,1497,0.7765053564831917
2015,1234,21,11,1567,654,0.65625,913,0.7055380459252589
2015,1235,25,8,2019,567,0.7575757575757576,1452,0.7807424593967517
2015,1236,13,14,998,851,0.48148148148148145,147,0.539751216873986
2015,1237,10,21,661,1222,0.3225806451612903,-561,0.3510355815188529
2015,1238,11,21,752,1189,0.34375,-437,0.3874291602266873
2015,1239,7,22,540,1293,0.2413793103448276,-753,0.2945990180032733
2015,1240,10,19,714,1056,0.3448275862068966,-342,0.4033898305084746
2015,1241,19,13,1354,791,0.59375,563,0.6312354312354312
2015,1242,26,8,1923,498,0.7647058823529411,1425,0.7942998760842627
2015,1243,15,17,1054,962,0.46875,92,0.5228174603174603
2015,1244,8,22,612,1243,0.26666666666666666,-631,0.3299191374663073
2015,1245,20,11,1350,691,0.6451612903225806,659,0.6614404703576678
2015,1246,34,0,2547,0,1.0,2547,1.0
2015,1247,17,16,1146,940,0.5151515151515151,206,0.5493767976989453
2015,1248,19,12,1481,802,0.6129032258064516,679,0.6487078405606658
2015,1249,11,15,797,978,0.4230769230769231,-181,0.4490140845070423
2015,1250,15,14,1114,828,0.5172413793103449,286,0.5736354273944387
2015,1251,4,24,280,1445,0.14285714285714285,-1165,0.16231884057971013
2015,1252,11,17,869,1108,0.39285714285714285,-239,0.4395548811330298
2015,1253,14,17,976,1057,0.45161290322580644,-81,0.48007870142646336
2015,1254,12,18,870,1152,0.4,-282,0.43026706231454004
2015,1255,9,23,682,1444,0.28125,-762,0.32079021636876764
2015,1256,24,8,1790,536,0.75,1254,0.7695614789337919
2015,1257,24,8,1752,463,0.75,1289,0.7909706546275395
2015,1258,7,23,510,1336,0.23333333333333334,-826,0.27627302275189597
2015,1259,11,19,741,1023,0.36666666666666664,-282,0.4200680272108844
2015,1260,17,13,1129,707,0.5666666666666667,422,0.6149237472766884
2015,1261,22,10,1697,661,0.6875,1036,0.7196776929601357
2015,1262,11,17,727,951,0.39285714285714285,-224,0.433253873659118
2015,1263,3,27,219,1593,0.1,-1374,0.12086092715231789
2015,1264,19,13,1405,831,0.59375,574,0.6283542039355993
2015,1265,7,25,493,1464,0.21875,-971,0.2519161982626469
2015,1266,13,19,910,1173,0.40625,-263,0.4368698991838694
2015,1267,9,21,689,1271,0.3,-582,0.35153061224489796
2015,1268,27,6,1932,361,0.8181818181818182,1571,0.8425643262102049
2015,1269,17,15,1245,975,0.53125,270,0.5608108108108109
2015,1270,11,16,786,1035,0.4074074074074074,-249,0.4316309719934102
2015,1271,18,14,1317,848,0.5625,469,0.6083140877598152
2015,1272,18,14,1319,836,0.5625,483,0.6120649651972158
2015,1273,16,15,1190,853,0.5161290322580645,337,0.582476749877631
2015,1274,21,12,1537,720,0.6363636363636364,817,0.6809924678777137
2015,1275,12,19,854,1200,0.3870967741935484,-346,0.4157740993184031
2015,1276,15,16,1041,938,0.4838709677419355,103,0.5260232440626579
2015,1277,23,11,1699,745,0.6764705882352942,954,0.6951718494271686
2015,1278,17,15,1372,968,0.53125,404,0.5863247863247864
2015,1279,20,12,1496,828,0.625,668,0.6437177280550774
2015,1280,12,19,841,1077,0.3870967741935484,-236,0.43847758081334726
2015,1281,8,23,550,1311,0.25806451612903225,-761,0.2955400322407308
2015,1282,12,19,832,1158,0.3870967741935484,-326,0.41809045226130653
2015,1283,9,20,569,1139,0.3103448275862069,-570,0.3331381733021077
2015,1284,18,15,1214,920,0.5454545454545454,294,0.5688847235238987
2015,1285,18,12,1287,835,0.6,452,0.6065032987747409
2015,1286,6,23,488,1350,0.20689655172413793,-862,0.26550598476605003
2015,1287,15,17,1187,1025,0.46875,162,0.536618444846293
2015,1288,7,24,457,1441,0.22580645161290322,-984,0.24077976817702845
2015,1290,6,26,418,1627,0.1875,-1209,0.20440097799511003
2015,1291,15,15,1066,827,0.5,239,0.5631273111463285
2015,1292,18,16,1214,938,0.5294117647058824,276,0.5641263940520446
2015,1293,25,5,1998,342,0.8333333333333334,1656,0.8538461538461538
2015,1294,13,15,1029,1037,0.4642857142857143,-8,0.49806389157792835
2015,1295,21,9,1384,534,0.7,850,0.721584984358707
2015,1296,13,16,936,949,0.4482758620689655,-13,0.496551724137931
2015,1297,11,17,855,1057,0.39285714285714285,-202,0.44717573221757323
2015,1298,12,19,827,1058,0.3870967741935484,-231,0.4387267904509284
2015,1299,7,23,481,1254,0.23333333333333334,-773,0.27723342939481266
2015,1300,22,7,1501,374,0.7586206896551724,1127,0.8005333333333333
2015,1301,20,13,1507,816,0.6060606060606061,691,0.6487300904003444
2015,1303,11,17,927,1205,0.39285714285714285,-278,0.4348030018761726
2015,1304,13,18,889,1016,0.41935483870967744,-127,0.4666666666666667
2015,1305,7,22,480,1244,0.2413793103448276,-764,0.27842227378190254
2015,1306,17,12,1175,716,0.5862068965517241,459,0.6213643574828134
2015,1307,15,16,997,924,0.4838709677419355,73,0.5190005205622071
2015,1308,21,10,1470,637,0.6774193548387096,833,0.6976744186046512
2015,1309,8,18,612,1172,0.3076923076923077,-560,0.3430493273542601
2015,1310,8,22,563,1367,0.26666666666666666,-804,0.2917098445595855
2015,1311,7,19,510,1134,0.2692307692307692,-624,0.3102189781021898
2015,1312,14,11,1055,656,0.56,399,0.6165984804208066
2015,1313,18,13,1373,768,0.5806451612903226,605,0.641289117234937
2015,1314,24,11,1963,764,0.6857142857142857,1199,0.7198386505317198
2015,1315,6,22,445,1433,0.21428571428571427,-988,0.2369542066027689
2015,1316,20,11,1551,741,0.6451612903225806,810,0.6767015706806283
2015,1317,12,17,830,1033,0.41379310344827586,-203,0.4455179817498658
2015,1318,23,11,1653,679,0.6764705882352942,974,0.7088336192109777
2015,1319,18,14,1289,886,0.5625,403,0.5926436781609196
2015,1320,30,3,1961,196,0.9090909090909091,1765,0.9091330551692165
2015,1321,15,17,1036,995,0.46875,41,0.5100935499753816
2015,1322,15,12,1361,902,0.5555555555555556,459,0.6014140521431728
2015,1323,29,5,2358,322,0.8529411764705882,2036,0.8798507462686567
2015,1324,14,16,1097,1095,0.4666666666666667,2,0.5004562043795621
2015,1325,10,20,778,1250,0.3333333333333333,-472,0.38362919132149903
2015,1326,23,10,1889,613,0.696969696969697,1276,0.7549960031974421
2015,1328,22,10,1661,641,0.6875,1020,0.7215464813205907
2015,1329,17,13,1225,771,0.5666666666666667,454,0.6137274549098196
2015,1330,24,7,1624,402,0.7741935483870968,1222,0.8015794669299111
2015,1331,16,14,1189,831,0.5333333333333333,358,0.5886138613861386
2015,1332,24,9,1867,608,0.7272727272727273,1259,0.7543434343434343
2015,1333,16,14,1048,753,0.5333333333333333,295,0.5818989450305386
2015,1334,9,19,615,1149,0.32142857142857145,-534,0.3486394557823129
2015,1335,9,19,580,1107,0.32142857142857145,-527,0.34380557202133966
2015,1336,18,16,1251,1022,0.5294117647058824,229,0.550373955125385
2015,1337,17,13,1132,767,0.5666666666666667,365,0.5961032122169563
2015,1338,18,14,1280,864,0.5625,416,0.5970149253731343
2015,1339,15,15,1091,1000,0.5,91,0.5217599234815877
2015,1340,13,14,1006,899,0.48148148148148145,107,0.5280839895013123
2015,1341,14,18,1039,1108,0.4375,-69,0.48393106660456453
2015,1342,6,22,423,1243,0.21428571428571427,-820,0.2539015606242497
2015,1343,15,14,1081,889,0.5172413793103449,192,0.5487309644670051
2015,1344,22,11,1627,690,0.6666666666666666,937,0.7022011221406992
2015,1345,21,12,1535,775,0.6363636363636364,760,0.6645021645021645
2015,1346,15,15,1112,980,0.5,132,0.5315487571701721
2015,1347,18,11,1323,705,0.6206896551724138,618,0.6523668639053254
2015,1348,21,9,1454,531,0.7,923,0.7324937027707809
2015,1349,10,19,725,1147,0.3448275862068966,-422,0.3872863247863248
2015,1350,19,13,1280,812,0.59375,468,0.6118546845124283
2015,1351,21,11,1439,655,0.65625,784,0.6872015281757402
2015,1352,19,14,1409,868,0.5757575757575758,541,0.6187966622749231
2015,1353,10,22,652,1246,0.3125,-594,0.34351949420442573
2015,1354,9,22,599,1194,0.2903225806451613,-595,0.3340769659788065
2015,1355,21,10,1570,663,0.6774193548387096,907,0.703090013434841
2015,1356,11,21,743,1149,0.34375,-406,0.3927061310782241
2015,1357,14,17,1089,1167,0.45161290322580644,-78,0.48271276595744683
2015,1358,21,8,1542,492,0.7241379310344828,1050,0.7581120943952803
2015,1359,12,19,880,1242,0.3870967741935484,-362,0.41470311027332707
2015,1360,14,16,1012,923,0.4666666666666667,89,0.5229974160206718
2015,1361,25,8,1607,422,0.7575757575757576,1185,0.7920157713159192
2015,1362,13,18,978,1151,0.41935483870967744,-173,0.45937059652418977
2015,1364,17,13,1174,837,0.5666666666666667,337,0.5837891596220786
2015,1365,12,18,831,1049,0.4,-218,0.4420212765957447
2015,1366,7,22,476,1140,0.2413793103448276,-664,0.29455445544554454
2015,1367,19,11,1360,705,0.6333333333333333,655,0.6585956416464891
2015,1368,8,23,630,1464,0.25806451612903225,-834,0.3008595988538682
2015,1369,11,17,813,1094,0.39285714285714285,-281,0.42632406921866806
2015,1370,14,15,922,863,0.4827586206896552,59,0.5165266106442578
2015,1371,16,15,1194,925,0.5161290322580645,269,0.5634733364794714
2015,1372,26,4,2115,254,0.8666666666666667,1861,0.8927817644575771
2015,1373,11,20,821,1343,0.3548387096774194,-522,0.3793900184842883
2015,1374,26,6,1848,373,0.8125,1475,0.8320576316974336
2015,1375,10,21,822,1299,0.3225806451612903,-477,0.38755304101838756
2015,1376,16,16,1142,926,0.5,216,0.5522243713733076
2015,1377,15,16,1090,1049,0.4838709677419355,41,0.50958391771856
2015,1378,8,23,575,1320,0.25806451612903225,-745,0.3034300791556728
2015,1379,7,20,488,1102,0.25925925925925924,-614,0.3069182389937107
2015,1380,15,17,1018,983,0.46875,35,0.5087456271864068
2015,1381,9,19,655,1264,0.32142857142857145,-609,0.341323606044815
2015,1382,18,13,1311,774,0.5806451612903226,537,0.6287769784172662
2015,1383,22,11,1548,706,0.6666666666666666,842,0.686779059449867
2015,1384,15,15,1075,820,0.5,255,0.5672823218997362
2015,1385,20,11,1458,727,0.6451612903225806,731,0.6672768878718536
2015,1386,13,18,858,1054,0.41935483870967744,-196,0.448744769874477
2015,1387,10,21,662,1170,0.3225806451612903,-508,0.361353711790393
2015,1388,20,9,1460,540,0.6896551724137931,920,0.73
2015,1389,16,18,1078,1003,0.47058823529411764,75,0.5180201826045171
2015,1390,19,13,1414,900,0.59375,514,0.6110630942091616
2015,1391,6,22,434,1382,0.21428571428571427,-948,0.23898678414096916
2015,1392,21,11,1440,621,0.65625,819,0.6986899563318777
2015,1393,18,13,1272,824,0.5806451612903226,448,0.6068702290076335
2015,1394,17,13,1187,779,0.5666666666666667,408,0.603763987792472
2015,1395,18,15,1317,932,0.5454545454545454,385,0.5855935971542908
2015,1396,23,10,1600,539,0.696969696969697,1061,0.748013090229079
2015,1397,16,16,1081,944,0.5,137,0.5338271604938272
2015,1398,3,26,182,1439,0.10344827586206896,-1257,0.11227637260950031
2015,1399,10,18,782,1166,0.35714285714285715,-384,0.40143737166324434
2015,1400,20,13,1401,841,0.6060606060606061,560,0.6248884924174843
2015,1401,20,11,1427,656,0.6451612903225806,771,0.6850696111377821
2015,1402,11,17,769,906,0.39285714285714285,-137,0.4591044776119403
2015,1403,13,19,925,1024,0.40625,-99,0.4746023601847101
2015,1404,16,12,1150,741,0.5714285714285714,409,0.6081438392384981
2015,1405,20,13,1551,932,0.6060606060606061,619,0.6246476037051953
2015,1406,11,20,735,1202,0.3548387096774194,-467,0.3794527620030976
2015,1407,8,19,557,1224,0.2962962962962963,-667,0.31274564851207187
2015,1408,14,16,973,911,0.4666666666666667,62,0.5164543524416136
2015,1409,22,9,1488,502,0.7096774193548387,986,0.7477386934673367
2015,1410,7,21,465,1205,0.25,-740,0.27844311377245506
2015,1411,22,12,1627,691,0.6470588235294118,936,0.7018981880931838
2015,1412,18,15,1274,973,0.5454545454545454,301,0.5669781931464174
2015,1413,23,6,1649,415,0.7931034482758621,1234,0.7989341085271318
2015,1414,19,12,1314,757,0.6129032258064516,557,0.6344760985031386
2015,1415,12,17,838,1010,0.41379310344827586,-172,0.45346320346320346
2015,1416,11,18,801,1104,0.3793103448275862,-303,0.4204724409448819
2015,1417,20,13,1634,742,0.6060606060606061,892,0.6877104377104377
2015,1418,17,13,1339,899,0.5666666666666667,440,0.5983020554066131
2015,1419,17,12,1165,613,0.5862068965517241,552,0.6552305961754781
2015,1420,4,26,273,1409,0.13333333333333333,-1136,0.16230677764565993
2015,1421,12,16,922,1064,0.42857142857142855,-142,0.46424974823766363
2015,1422,8,22,620,1420,0.26666666666666666,-800,0.30392156862745096
2015,1423,17,13,1261,802,0.5666666666666667,459,0.6112457586039748
2015,1424,17,15,1201,936,0.53125,265,0.5620028076743098
2015,1425,12,20,842,1301,0.375,-459,0.3929071395240317
2015,1426,15,15,1129,1002,0.5,127,0.5297982167996246
2015,1427,12,16,897,1052,0.42857142857142855,-155,0.46023601847101075
2015,1428,23,8,1756,466,0.7419354838709677,1290,0.7902790279027903
2015,1429,17,13,1144,845,0.5666666666666667,299,0.5751633986928104
2015,1430,9,19,622,976,0.32142857142857145,-354,0.38923654568210264
2015,1431,22,10,1618,598,0.6875,1020,0.73014440433213
2015,1433,26,9,1992,545,0.7428571428571429,1447,0.7851793456838786
2015,1434,25,5,1780,272,0.8333333333333334,1508,0.8674463937621832
2015,1435,18,13,1335,812,0.5806451612903226,523,0.6217978574755473
2015,1436,17,13,1179,786,0.5666666666666667,393,0.6
2015,1437,32,2,2474,119,0.9411764705882353,2355,0.9541072117238719
2015,1438,29,3,1904,187,0.90625,1717,0.9105691056910569
2015,1439,11,22,824,1332,0.3333333333333333,-508,0.3821892393320965
2015,1440,9,19,789,1369,0.32142857142857145,-580,0.36561631139944395
2015,1441,13,17,940,1153,0.43333333333333335,-213,0.44911610129001434
2015,1442,6,20,432,1150,0.23076923076923078,-718,0.27307206068268014
2015,1443,18,12,1324,768,0.6,556,0.6328871892925431
2015,1444,18,13,1369,819,0.5806451612903226,550,0.6256855575868373
2015,1447,9,20,685,1284,0.3103448275862069,-599,0.3478923311325546
2015,1448,13,19,978,1231,0.40625,-253,0.4427342688999547
2015,1449,16,15,1150,978,0.5161290322580645,172,0.5404135338345865
2015,1450,13,18,1094,1095,0.41935483870967744,-1,0.4997715851987209
2015,1451,11,17,747,1080,0.39285714285714285,-333,0.4088669950738916
2015,1452,23,9,1786,580,0.71875,1206,0.7548605240912933
2015,1453,22,8,1560,470,0.7333333333333333,1090,0.7684729064039408
2015,1454,12,16,851,973,0.42857142857142855,-122,0.46655701754385964
2015,1455,27,4,1888,238,0.8709677419354839,1650,0.8880526810912511
2015,1456,18,12,1368,793,0.6,575,0.6330402591392874
2015,1457,16,13,1199,879,0.5517241379310345,320,0.5769971126082772
2015,1458,31,3,2259,185,0.9117647058823529,2074,0.92430441898527
2015,1459,26,6,1776,332,0.8125,1444,0.8425047438330171
2015,1460,9,20,635,1197,0.3103448275862069,-562,0.34661572052401746
2015,1461,23,9,1519,447,0.71875,1072,0.7726347914547305
2015,1462,21,13,1586,915,0.6176470588235294,671,0.6341463414634146
2015,1463,20,10,1353,612,0.6666666666666666,741,0.6885496183206107
2015,1464,8,21,629,1425,0.27586206896551724,-796,0.3062317429406037
2015,3101,13,12,970,656,0.52,314,0.5965559655596556
2015,3102,2,28,148,1466,0.06666666666666667,-1318,0.09169764560099132
2015,3103,21,8,1629,513,0.7241379310344828,1116,0.7605042016806722
2015,3104,13,19,892,1017,0.40625,-125,0.4672603457307491
2015,3105,6,24,397,1397,0.2,-1000,0.22129319955406912
2015,3106,14,14,885,807,0.5,78,0.5230496453900709
2015,3107,24,8,1761,460,0.75,1301,0.7928860873480414
2015,3108,10,18,624,886,0.35714285714285715,-262,0.41324503311258276
2015,3110,24,8,1558,469,0.75,1089,0.7686235816477553
2015,3111,13,16,916,1033,0.4482758620689655,-117,0.46998460749102106
2015,3112,10,20,634,1109,0.3333333333333333,-475,0.36374067699368906
2015,3113,27,5,1891,283,0.84375,1608,0.8698252069917203
2015,3114,28,4,1858,231,0.875,1627,0.8894207754906653
2015,3115,5,21,306,1035,0.19230769230769232,-729,0.22818791946308725
2015,3116,17,13,1117,692,0.5666666666666667,425,0.6174682144831398
2015,3117,22,10,1632,653,0.6875,979,0.7142231947483588
2015,3119,22,7,1372,372,0.7586206896551724,1000,0.786697247706422
2015,3120,13,18,914,872,0.41935483870967744,42,0.5117581187010078
2015,3122,9,20,671,1340,0.3103448275862069,-669,0.3336648433615117
2015,3123,17,13,1232,707,0.5666666666666667,525,0.6353790613718412
2015,3124,30,3,2443,199,0.9090909090909091,2244,0.9246782740348221
2015,3125,14,16,963,912,0.4666666666666667,51,0.5136
2015,3126,11,17,694,897,0.39285714285714285,-203,0.43620364550597107
2015,3127,4,26,300,1449,0.13333333333333333,-1149,0.17152658662092624
2015,3129,20,10,1526,595,0.6666666666666666,931,0.7194719471947195
2015,3130,13,17,933,1027,0.43333333333333335,-94,0.4760204081632653
2015,3131,5,25,305,1359,0.16666666666666666,-1054,0.18329326923076922
2015,3132,9,21,594,1080,0.3,-486,0.3548387096774194
2015,3133,6,24,362,1373,0.2,-1011,0.20864553314121037
2015,3135,10,18,708,1125,0.35714285714285715,-417,0.3862520458265139
2015,3136,22,9,1581,608,0.7096774193548387,973,0.7222476016445866
2015,3137,18,12,1196,636,0.6,560,0.6528384279475983
2015,3138,19,12,1251,747,0.6129032258064516,504,0.6261261261261262
2015,3139,13,16,833,994,0.4482758620689655,-161,0.4559386973180077
2015,3140,22,9,1551,571,0.7096774193548387,980,0.7309142318567389
2015,3141,13,18,870,1168,0.41935483870967744,-298,0.4268891069676153
2015,3142,15,14,1048,903,0.5172413793103449,145,0.5371604305484367
2015,3143,23,9,1728,497,0.71875,1231,0.7766292134831461
2015,3144,17,12,1109,634,0.5862068965517241,475,0.6362593230063109
2015,3145,10,20,689,1156,0.3333333333333333,-467,0.3734417344173442
2015,3146,13,14,797,738,0.48148148148148145,59,0.5192182410423453
2015,3148,19,12,1336,625,0.6129032258064516,711,0.6812850586435492
2015,3149,1,25,70,1305,0.038461538461538464,-1235,0.05090909090909091
2015,3150,15,17,1107,1019,0.46875,88,0.5206961429915334
2015,3151,29,3,1865,162,0.90625,1703,0.9200789343857918
2015,3152,2,25,122,1271,0.07407407407407407,-1149,0.08758076094759512
2015,3153,8,23,557,1138,0.25806451612903225,-581,0.3286135693215339
2015,3155,9,21,654,1114,0.3,-460,0.36990950226244346
2015,3156,17,12,1236,802,0.5862068965517241,434,0.6064769381746811
2015,3157,8,18,574,1128,0.3076923076923077,-554,0.3372502937720329
2015,3158,5,25,303,1373,0.16666666666666666,-1070,0.1807875894988067
2015,3159,9,22,565,1224,0.2903225806451613,-659,0.31581889323644496
2015,3160,15,17,1168,1044,0.46875,124,0.5280289330922242
2015,3161,21,7,1423,406,0.75,1017,0.7780207763805358
2015,3162,8,20,545,1175,0.2857142857142857,-630,0.3168604651162791
2015,3163,32,1,2875,86,0.9696969696969697,2789,0.9709557581898007
2015,3164,6,22,433,1196,0.21428571428571427,-763,0.2658072437077962
2015,3165,15,13,997,643,0.5357142857142857,354,0.6079268292682927
2015,3166,17,13,1280,792,0.5666666666666667,488,0.6177606177606177
2015,3167,22,8,1711,499,0.7333333333333333,1212,0.7742081447963801
2015,3168,13,19,878,1032,0.40625,-154,0.45968586387434557
2015,3169,23,9,1627,530,0.71875,1097,0.7542883634677793
2015,3170,16,15,1466,1205,0.5161290322580645,261,0.5488581055784351
2015,3171,14,14,901,661,0.5,240,0.5768245838668374
2015,3172,5,25,331,1360,0.16666666666666666,-1029,0.19574216439976344
2015,3173,25,6,1957,392,0.8064516129032258,1565,0.8331204767986378
2015,3174,15,17,1004,969,0.46875,35,0.5088697415103902
2015,3175,3,25,186,1506,0.10714285714285714,-1320,0.1099290780141844
2015,3176,8,23,604,1279,0.25806451612903225,-675,0.32076473712161446
2015,3177,26,7,2305,559,0.7878787878787878,1746,0.80481843575419
2015,3178,10,18,732,1040,0.35714285714285715,-308,0.41309255079006774
2015,3179,19,10,1489,701,0.6551724137931034,788,0.6799086757990868
2015,3180,20,10,1225,517,0.6666666666666666,708,0.7032146957520092
2015,3181,21,10,1645,549,0.6774193548387096,1096,0.7497721057429353
2015,3182,21,10,1581,607,0.6774193548387096,974,0.7225776965265083
2015,3183,10,20,674,1104,0.3333333333333333,-430,0.37907761529808776
2015,3184,8,17,540,1005,0.32,-465,0.34951456310679613
2015,3185,19,12,1355,692,0.6129032258064516,663,0.6619443087445042
2015,3186,18,11,1331,683,0.6206896551724138,648,0.6608738828202582
2015,3187,21,10,1505,555,0.6774193548387096,950,0.7305825242718447
2015,3188,19,12,1421,739,0.6129032258064516,682,0.6578703703703703
2015,3189,17,12,1212,711,0.5862068965517241,501,0.6302652106084243
2015,3190,21,11,1549,639,0.65625,910,0.7079524680073126
2015,3191,12,19,857,1072,0.3870967741935484,-215,0.4442716433385174
2015,3192,10,20,709,1282,0.3333333333333333,-573,0.3561024610748368
2015,3193,15,16,922,854,0.4838709677419355,68,0.5191441441441441
2015,3194,12,17,948,993,0.41379310344827586,-45,0.4884080370942813
2015,3195,29,2,2070,152,0.9354838709677419,1918,0.9315931593159316
2015,3196,13,17,927,931,0.43333333333333335,-4,0.49892357373519913
2015,3197,7,21,466,1109,0.25,-643,0.2958730158730159
2015,3198,3,26,217,1465,0.10344827586206896,-1248,0.12901307966706302
2015,3199,29,4,2242,257,0.8787878787878788,1985,0.8971588635454182
2015,3200,20,11,1256,567,0.6451612903225806,689,0.6889742183214481
2015,3201,20,9,1297,530,0.6896551724137931,767,0.7099069512862616
2015,3202,17,13,1201,807,0.5666666666666667,394,0.5981075697211156
2015,3203,28,3,2053,201,0.9032258064516129,1852,0.9108251996450755
2015,3204,4,24,295,1375,0.14285714285714285,-1080,0.17664670658682635
2015,3205,13,17,906,969,0.43333333333333335,-63,0.4832
2015,3206,13,17,988,1047,0.43333333333333335,-59,0.4855036855036855
2015,3207,4,27,311,1647,0.12903225806451613,-1336,0.1588355464759959
2015,3208,19,12,1235,591,0.6129032258064516,644,0.676341730558598
2015,3209,12,17,887,1024,0.41379310344827586,-137,0.4641548927263213
2015,3210,18,14,1429,896,0.5625,533,0.6146236559139785
2015,3211,24,7,1812,400,0.7741935483870968,1412,0.8191681735985533
2015,3212,8,20,508,1011,0.2857142857142857,-503,0.3344305464121132
2015,3213,11,14,729,774,0.44,-45,0.48502994011976047
2015,3214,18,12,1271,671,0.6,600,0.6544799176107106
2015,3216,16,17,977,955,0.48484848484848486,22,0.5056935817805382
2015,3217,14,14,1013,811,0.5,202,0.5553728070175439
2015,3218,21,8,1424,511,0.7241379310344828,913,0.7359173126614987
2015,3219,19,12,1429,715,0.6129032258064516,714,0.6665111940298507
2015,3220,20,12,1285,704,0.625,581,0.6460532931121167
2015,3221,15,17,994,993,0.46875,1,0.5002516356316055
2015,3222,6,24,357,1241,0.2,-884,0.22340425531914893
2015,3223,11,18,749,1108,0.3793103448275862,-359,0.403338718362951
2015,3224,4,27,300,1578,0.12903225806451613,-1278,0.1597444089456869
2015,3225,12,15,853,963,0.4444444444444444,-110,0.4697136563876652
2015,3226,11,17,769,980,0.39285714285714285,-211,0.4396798170383076
2015,3227,14,14,968,776,0.5,192,0.555045871559633
2015,3228,15,16,1095,978,0.4838709677419355,117,0.5282199710564399
2015,3229,2,28,141,1431,0.06666666666666667,-1290,0.08969465648854962
2015,3230,3,22,203,1198,0.12,-995,0.14489650249821556
2015,3231,15,16,1234,995,0.4838709677419355,239,0.5536114849708389
2015,3232,16,13,1075,708,0.5517241379310345,367,0.6029164329781268
2015,3233,15,15,1110,961,0.5,149,0.5359729599227426
2015,3234,24,7,1959,515,0.7741935483870968,1444,0.7918350848827809
2015,3235,18,12,1360,725,0.6,635,0.6522781774580336
2015,3236,7,21,510,1390,0.25,-880,0.26842105263157895
2015,3237,13,16,941,937,0.4482758620689655,4,0.5010649627263046
2015,3238,14,17,1010,961,0.45161290322580644,49,0.5124302384576357
2015,3239,10,17,664,947,0.37037037037037035,-283,0.4121663563004345
2015,3240,19,10,1315,569,0.6551724137931034,746,0.6979830148619958
2015,3241,29,3,2237,188,0.90625,2049,0.9224742268041237
2015,3242,15,17,1014,1011,0.46875,3,0.5007407407407407
2015,3243,17,13,1052,715,0.5666666666666667,337,0.5953593661573288
2015,3244,17,13,1132,771,0.5666666666666667,361,0.5948502364687336
2015,3245,5,25,291,1370,0.16666666666666666,-1079,0.17519566526189043
2015,3246,23,9,1780,600,0.71875,1180,0.7478991596638656
2015,3247,15,16,1021,901,0.4838709677419355,120,0.5312174817898023
2015,3248,14,17,890,910,0.45161290322580644,-20,0.49444444444444446
2015,3249,14,13,1088,808,0.5185185185185185,280,0.5738396624472574
2015,3250,18,12,1357,697,0.6,660,0.6606621226874392
2015,3251,26,6,1787,365,0.8125,1422,0.8303903345724907
2015,3252,7,21,510,1260,0.25,-750,0.288135593220339
2015,3253,21,9,1460,572,0.7,888,0.718503937007874
2015,3254,9,21,663,1264,0.3,-601,0.34405812143227815
2015,3255,4,26,278,1396,0.13333333333333333,-1118,0.16606929510155316
2015,3256,15,15,1161,938,0.5,223,0.5531205335874226
2015,3257,25,6,1923,351,0.8064516129032258,1572,0.8456464379947229
2015,3258,7,24,493,1533,0.22580645161290322,-1040,0.2433366238894373
2015,3259,7,23,420,1160,0.23333333333333334,-740,0.26582278481012656
2015,3260,6,25,373,1337,0.1935483870967742,-964,0.21812865497076023
2015,3261,17,13,1188,709,0.5666666666666667,479,0.6262519768054824
2015,3262,13,15,941,814,0.4642857142857143,127,0.5361823361823361
2015,3263,23,8,1489,405,0.7419354838709677,1084,0.7861668426610349
2015,3264,3,27,190,1360,0.1,-1170,0.12258064516129032
2015,3265,21,11,1412,625,0.65625,787,0.6931762395679921
2015,3266,9,22,696,1392,0.2903225806451613,-696,0.3333333333333333
2015,3267,14,14,977,775,0.5,202,0.557648401826484
2015,3268,30,2,2431,136,0.9375,2295,0.9470198675496688
2015,3269,12,18,826,997,0.4,-171,0.45309928688974216
2015,3270,13,13,976,785,0.5,191,0.5542305508233958
2015,3271,13,17,873,960,0.43333333333333335,-87,0.4762684124386252
2015,3272,14,17,906,905,0.45161290322580644,1,0.500276090557703
2015,3273,18,14,1301,826,0.5625,475,0.611659614480489
2015,3274,19,12,1358,713,0.6129032258064516,645,0.6557218734910671
2015,3275,6,23,413,1168,0.20689655172413793,-755,0.2612270714737508
2015,3276,16,14,1234,867,0.5333333333333333,367,0.5873393622084722
2015,3277,16,15,1175,933,0.5161290322580645,242,0.5574003795066413
2015,3278,23,9,1851,591,0.71875,1260,0.757985257985258
2015,3279,17,13,1210,726,0.5666666666666667,484,0.625
2015,3280,26,6,1968,405,0.8125,1563,0.8293299620733249
2015,3281,17,13,1153,748,0.5666666666666667,405,0.6065228826933193
2015,3282,6,22,396,1203,0.21428571428571427,-807,0.24765478424015008
2015,3283,18,14,1332,824,0.5625,508,0.6178107606679035
2015,3284,13,18,950,1013,0.41935483870967744,-63,0.48395313295975545
2015,3285,22,8,1527,443,0.7333333333333333,1084,0.7751269035532995
2015,3286,13,15,927,946,0.4642857142857143,-19,0.49492792311799255
2015,3287,11,18,809,1197,0.3793103448275862,-388,0.4032901296111665
2015,3288,9,19,578,981,0.32142857142857145,-403,0.3707504810776139
2015,3290,2,26,135,1247,0.07142857142857142,-1112,0.09768451519536903
2015,3291,8,22,542,1173,0.26666666666666666,-631,0.3160349854227405
2015,3292,21,9,1625,551,0.7,1074,0.7467830882352942
2015,3293,6,21,512,1394,0.2222222222222222,-882,0.26862539349422876
2015,3294,19,12,1388,662,0.6129032258064516,726,0.6770731707317074
2015,3295,10,18,758,1138,0.35714285714285715,-380,0.399789029535865
2015,3296,12,17,781,807,0.41379310344827586,-26,0.49181360201511337
2015,3297,18,13,1211,699,0.5806451612903226,512,0.6340314136125654
2015,3298,16,14,978,674,0.5333333333333333,304,0.5920096852300242
2015,3299,18,11,1138,586,0.6206896551724138,552,0.660092807424594
2015,3300,7,21,422,1020,0.25,-598,0.2926490984743412
2015,3301,16,14,1197,803,0.5333333333333333,394,0.5985
2015,3303,8,18,519,1008,0.3076923076923077,-489,0.33988212180746563
2015,3304,21,10,1513,566,0.6774193548387096,947,0.7277537277537277
2015,3305,8,21,539,1139,0.27586206896551724,-600,0.3212157330154946
2015,3306,16,12,1026,652,0.5714285714285714,374,0.6114421930870083
2015,3307,20,12,1278,694,0.625,584,0.6480730223123732
2015,3308,20,7,1451,491,0.7407407407407407,960,0.747167868177137
2015,3309,7,18,519,921,0.28,-402,0.36041666666666666
2015,3310,14,17,904,1040,0.45161290322580644,-136,0.46502057613168724
2015,3311,16,13,1084,742,0.5517241379310345,342,0.5936473165388828
2015,3312,10,17,618,835,0.37037037037037035,-217,0.4253269098417068
2015,3313,14,16,999,912,0.4666666666666667,87,0.5227629513343799
2015,3314,24,8,1878,537,0.75,1341,0.7776397515527951
2015,3315,15,14,1105,916,0.5172413793103449,189,0.5467590301830777
2015,3316,9,19,559,898,0.32142857142857145,-339,0.38366506520247085
2015,3317,5,24,314,1189,0.1724137931034483,-875,0.20891550232867598
2015,3318,4,25,276,1475,0.13793103448275862,-1199,0.15762421473443747
2015,3319,12,16,847,906,0.42857142857142855,-59,0.4831717056474615
2015,3320,17,14,1126,849,0.5483870967741935,277,0.570126582278481
2015,3321,23,8,1682,560,0.7419354838709677,1122,0.7502230151650312
2015,3322,15,14,1037,695,0.5172413793103449,342,0.598729792147806
2015,3323,31,2,2560,121,0.9393939393939394,2439,0.9548675867213726
2015,3324,10,18,733,1114,0.35714285714285715,-381,0.39685977260422306
2015,3325,27,4,1936,242,0.8709677419354839,1694,0.8888888888888888
2015,3326,23,10,1954,708,0.696969696969697,1246,0.7340345604808415
2015,3328,20,11,1528,750,0.6451612903225806,778,0.6707638279192274
2015,3329,20,11,1386,606,0.6451612903225806,780,0.6957831325301205
2015,3330,20,12,1334,664,0.625,670,0.6676676676676677
2015,3331,14,15,1015,782,0.4827586206896552,233,0.5648302726766834
2015,3332,13,17,927,1032,0.43333333333333335,-105,0.47320061255742724
2015,3333,25,4,1848,253,0.8620689655172413,1595,0.8795811518324608
2015,3334,19,9,1406,543,0.6785714285714286,863,0.7213955874807594
2015,3335,19,8,1210,399,0.7037037037037037,811,0.7520198881292729
2015,3336,6,24,461,1425,0.2,-964,0.24443266171792152
2015,3337,8,22,593,1304,0.26666666666666666,-711,0.31259884027411705
2015,3338,19,11,1413,582,0.6333333333333333,831,0.7082706766917293
2015,3339,4,26,312,1599,0.13333333333333333,-1287,0.16326530612244897
2015,3340,4,23,280,1219,0.14814814814814814,-939,0.1867911941294196
2015,3341,13,18,962,939,0.41935483870967744,23,0.5060494476591267
2015,3342,14,15,820,694,0.4827586206896552,126,0.5416116248348745
2015,3343,30,0,2274,0,1.0,2274,1.0
2015,3344,6,24,409,1408,0.2,-999,0.22509631260319207
2015,3345,11,20,762,1197,0.3548387096774194,-435,0.3889739663093415
2015,3346,31,3,2465,200,0.9117647058823529,2265,0.924953095684803
2015,3347,17,12,1057,639,0.5862068965517241,418,0.6232311320754716
2015,3348,17,13,1085,653,0.5666666666666667,432,0.6242807825086306
2015,3349,9,21,623,1235,0.3,-612,0.3353067814854682
2015,3350,18,13,1230,737,0.5806451612903226,493,0.6253177427554651
2015,3351,11,20,681,1017,0.3548387096774194,-336,0.4010600706713781
2015,3352,17,15,1250,881,0.53125,369,0.5865790708587517
2015,3353,22,9,1559,573,0.7096774193548387,986,0.7312382739212008
2015,3354,14,12,915,599,0.5384615384615384,316,0.6043593130779392
2015,3355,24,8,1743,577,0.75,1166,0.7512931034482758
2015,3356,17,13,1256,729,0.5666666666666667,527,0.6327455919395466
2015,3357,15,13,1109,815,0.5357142857142857,294,0.5764033264033264
2015,3358,6,21,397,1235,0.2222222222222222,-838,0.24325980392156862
2015,3359,14,15,966,754,0.4827586206896552,212,0.5616279069767441
2015,3360,23,6,1568,366,0.7931034482758621,1202,0.8107549120992761
2015,3361,12,19,833,936,0.3870967741935484,-103,0.4708875070661391
2015,3362,17,13,1230,837,0.5666666666666667,393,0.5950653120464441
2015,3363,14,17,1200,1201,0.45161290322580644,-1,0.4997917534360683
2015,3364,2,27,105,1284,0.06896551724137931,-1179,0.0755939524838013
2015,3365,10,18,722,1096,0.35714285714285715,-374,0.39713971397139713
2015,3366,19,10,1284,501,0.6551724137931034,783,0.719327731092437
2015,3367,12,16,819,952,0.42857142857142855,-133,0.4624505928853755
2015,3368,5,22,351,1361,0.18518518518518517,-1010,0.2050233644859813
2015,3369,8,19,535,1070,0.2962962962962963,-535,0.3333333333333333
2015,3370,10,21,615,1264,0.3225806451612903,-649,0.32730175625332625
2015,3371,28,5,2155,348,0.8484848484848485,1807,0.8609668397922493
2015,3372,20,7,1408,457,0.7407407407407407,951,0.7549597855227882
2015,3373,19,12,1252,672,0.6129032258064516,580,0.6507276507276507
2015,3374,7,23,469,1196,0.23333333333333334,-727,0.2816816816816817
2015,3375,3,24,201,1289,0.1111111111111111,-1088,0.1348993288590604
2015,3376,30,2,2299,118,0.9375,2181,0.951179147703765
2015,3377,24,7,1957,428,0.7741935483870968,1529,0.8205450733752621
2015,3378,26,7,1946,425,0.7878787878787878,1521,0.8207507380851962
2015,3379,21,10,1475,595,0.6774193548387096,880,0.7125603864734299
2015,3380,19,11,1332,595,0.6333333333333333,737,0.6912298910223145
2015,3381,11,15,814,853,0.4230769230769231,-39,0.48830233953209357
2015,3382,15,15,988,799,0.5,189,0.5528819250139899
2015,3383,15,18,1007,983,0.45454545454545453,24,0.5060301507537689
2015,3384,6,23,471,1535,0.20689655172413793,-1064,0.23479561316051845
2015,3385,21,10,1335,614,0.6774193548387096,721,0.6849666495638789
2015,3386,13,17,858,990,0.43333333333333335,-132,0.4642857142857143
2015,3387,14,16,975,994,0.4666666666666667,-19,0.4951752158456069
2015,3388,20,10,1353,604,0.6666666666666666,749,0.6913643331630046
2015,3389,5,26,311,1257,0.16129032258064516,-946,0.19834183673469388
2015,3390,24,9,1780,495,0.7272727272727273,1285,0.7824175824175824
2015,3391,21,7,1601,366,0.75,1235,0.8139298423995933
2015,3392,17,13,1101,721,0.5666666666666667,380,0.6042810098792536
2015,3393,21,9,1467,617,0.7,850,0.7039347408829175
2015,3394,15,14,970,754,0.5172413793103449,216,0.5626450116009281
2015,3395,17,13,1251,818,0.5666666666666667,433,0.6046399226679555
2015,3396,16,16,1172,948,0.5,224,0.5528301886792453
2015,3397,27,5,1986,311,0.84375,1675,0.8646060078363083
2015,3398,18,12,1288,733,0.6,555,0.6373082632360217
2015,3399,6,23,438,1428,0.20689655172413793,-990,0.2347266881028939
2015,3400,22,10,1570,608,0.6875,962,0.7208448117539027
2015,3401,23,9,1598,542,0.71875,1056,0.7467289719626168
2015,3402,15,14,984,796,0.5172413793103449,188,0.5528089887640449
2015,3403,15,16,966,842,0.4838709677419355,124,0.5342920353982301
2015,3404,22,10,1734,591,0.6875,1143,0.7458064516129033
2015,3405,17,13,1146,822,0.5666666666666667,324,0.5823170731707317
2015,3406,11,21,723,1152,0.34375,-429,0.3856
2015,3407,20,10,1606,687,0.6666666666666666,919,0.7003924989097252
2015,3408,22,10,1533,531,0.6875,1002,0.7427325581395349
2015,3409,17,13,1242,741,0.5666666666666667,501,0.6263237518910741
2015,3410,16,14,1110,786,0.5333333333333333,324,0.5854430379746836
2015,3411,19,10,1338,565,0.6551724137931034,773,0.7031003678402522
2015,3412,18,13,1195,706,0.5806451612903226,489,0.6286165176223041
2015,3413,14,16,998,935,0.4666666666666667,63,0.5162959130884636
2015,3414,7,24,467,1322,0.22580645161290322,-855,0.26103968697596425
2015,3415,17,14,1310,866,0.5483870967741935,444,0.6020220588235294
2015,3416,9,21,649,1237,0.3,-588,0.34411452810180276
2015,3417,13,18,914,1112,0.41935483870967744,-198,0.45113524185587367
2015,3418,17,12,1145,653,0.5862068965517241,492,0.6368186874304783
2015,3419,9,17,572,956,0.34615384615384615,-384,0.3743455497382199
2015,3420,11,19,776,1021,0.36666666666666664,-245,0.4318308291597106
2015,3421,8,22,550,1235,0.26666666666666666,-685,0.3081232492997199
2015,3422,5,24,351,1473,0.1724137931034483,-1122,0.1924342105263158
2015,3423,13,16,975,915,0.4482758620689655,60,0.5158730158730159
2015,3424,13,17,996,1114,0.43333333333333335,-118,0.4720379146919431
2015,3425,15,15,1169,870,0.5,299,0.573320255026974
2015,3426,15,13,904,694,0.5357142857142857,210,0.5657071339173968
2015,3427,16,15,1012,845,0.5161290322580645,167,0.5449649973074852
2015,3428,9,21,602,1044,0.3,-442,0.36573511543134873
2015,3429,7,23,535,1390,0.23333333333333334,-855,0.2779220779220779
2015,3430,9,19,570,1096,0.32142857142857145,-526,0.34213685474189676
2015,3431,11,16,798,957,0.4074074074074074,-159,0.4547008547008547
2015,3433,16,14,1065,802,0.5333333333333333,263,0.5704338510980183
2015,3434,5,24,378,1432,0.1724137931034483,-1054,0.20883977900552486
2015,3435,14,16,929,908,0.4666666666666667,21,0.5057158410451824
2015,3436,5,24,348,1363,0.1724137931034483,-1015,0.2033898305084746
2015,3437,19,13,1272,691,0.59375,581,0.6479877738155884
2015,3438,17,13,1270,755,0.5666666666666667,515,0.6271604938271605
2015,3439,12,20,817,1005,0.375,-188,0.44840834248079037
2015,3441,8,19,589,1015,0.2962962962962963,-426,0.3672069825436409
2015,3442,15,13,1149,844,0.5357142857142857,305,0.5765178123432012
2015,3443,30,4,2315,268,0.8823529411764706,2047,0.8962446767324816
2015,3444,18,12,1202,628,0.6,574,0.6568306010928961
2015,3447,7,22,532,1278,0.2413793103448276,-746,0.29392265193370165
2015,3448,13,20,951,1260,0.3939393939393939,-309,0.43012211668928085
2015,3449,23,9,1832,564,0.71875,1268,0.7646076794657763
2015,3450,17,14,1269,843,0.5483870967741935,426,0.6008522727272727
2015,3451,9,18,594,954,0.3333333333333333,-360,0.38372093023255816
2015,3452,18,14,1326,766,0.5625,560,0.6338432122370937
2015,3453,27,4,1911,250,0.8709677419354839,1661,0.8843128181397502
2015,3454,10,20,747,1234,0.3333333333333333,-487,0.3770822816759212
2015,3455,29,4,1916,209,0.8787878787878788,1707,0.9016470588235294
2015,3456,15,15,1035,858,0.5,177,0.5467511885895404
2015,3457,16,13,1110,698,0.5517241379310345,412,0.6139380530973452
2015,3458,9,20,609,1259,0.3103448275862069,-650,0.32601713062098503
2015,3459,6,22,393,1146,0.21428571428571427,-753,0.2553606237816764
2015,3460,23,8,1908,485,0.7419354838709677,1423,0.7973255328040117
2015,3461,14,14,1042,820,0.5,222,0.5596133190118152
2015,3462,17,14,1200,777,0.5483870967741935,423,0.6069802731411229
2015,3463,13,14,851,726,0.48148148148148145,125,0.5396322130627774
2015,3464,19,10,1417,559,0.6551724137931034,858,0.7171052631578947
2016,1101,9,18,704,1182,0.3333333333333333,-478,0.37327677624602335
2016,1102,12,18,850,1173,0.4,-323,0.42016806722689076
2016,1103,25,8,1975,544,0.7575757575757576,1431,0.7840412862246924
2016,1104,18,14,1280,859,0.5625,421,0.5984104721832632
2016,1105,10,18,727,1152,0.35714285714285715,-425,0.38690792974986693
2016,1106,12,17,872,1160,0.41379310344827586,-288,0.42913385826771655
2016,1107,23,8,1784,529,0.7419354838709677,1255,0.7712926934716818
2016,1108,13,15,950,914,0.4642857142857143,36,0.509656652360515
2016,1110,12,19,792,993,0.3870967741935484,-201,0.4436974789915966
2016,1111,9,22,689,1498,0.2903225806451613,-809,0.31504343850022865
2016,1112,25,8,2057,623,0.7575757575757576,1434,0.7675373134328358
2016,1113,15,17,1173,1172,0.46875,1,0.5002132196162047
2016,1114,27,4,1899,271,0.8709677419354839,1628,0.8751152073732719
2016,1115,8,25,493,1374,0.24242424242424243,-881,0.2640599892876272
2016,1116,16,16,1371,1130,0.5,241,0.5481807277089165
2016,1117,9,20,697,1400,0.3103448275862069,-703,0.3323795898903195
2016,1119,18,13,1465,916,0.5806451612903226,549,0.6152876942461151
2016,1120,11,20,943,1249,0.3548387096774194,-306,0.4302007299270073
2016,1122,16,17,1334,1132,0.48484848484848486,202,0.5409570154095702
2016,1123,18,13,1325,836,0.5806451612903226,489,0.6131420638593243
2016,1124,21,11,1719,723,0.65625,996,0.7039312039312039
2016,1125,19,11,1645,829,0.6333333333333333,816,0.6649151172190784
2016,1126,12,18,889,1183,0.4,-294,0.42905405405405406
2016,1127,8,22,569,1258,0.26666666666666666,-689,0.3114395183360701
2016,1129,18,12,1425,855,0.6,570,0.625
2016,1130,7,25,522,1437,0.21875,-915,0.2664624808575804
2016,1131,17,14,1281,975,0.5483870967741935,306,0.5678191489361702
2016,1132,14,18,1074,1143,0.4375,-69,0.4844384303112314
2016,1133,4,27,244,1488,0.12903225806451613,-1244,0.14087759815242495
2016,1135,7,20,569,1402,0.25925925925925924,-833,0.2886859462201928
2016,1136,7,23,537,1399,0.23333333333333334,-862,0.27737603305785125
2016,1137,16,13,1306,955,0.5517241379310345,351,0.5776205218929678
2016,1138,19,14,1574,954,0.5757575757575758,620,0.622626582278481
2016,1139,21,10,1841,657,0.6774193548387096,1184,0.7369895916733387
2016,1140,22,10,1912,749,0.6875,1163,0.7185268695978956
2016,1141,14,15,1084,1082,0.4827586206896552,2,0.5004616805170822
2016,1142,8,20,639,1376,0.2857142857142857,-737,0.31712158808933
2016,1143,23,10,1797,682,0.696969696969697,1115,0.7248890681726503
2016,1144,9,18,743,1180,0.3333333333333333,-437,0.38637545501820075
2016,1145,14,19,1161,1365,0.42424242424242425,-204,0.45961995249406173
2016,1146,7,21,680,1430,0.25,-750,0.3222748815165877
2016,1148,4,25,302,1586,0.13793103448275862,-1284,0.15995762711864406
2016,1149,6,21,441,1409,0.2222222222222222,-968,0.23837837837837839
2016,1150,14,19,1281,1303,0.42424242424242425,-22,0.49574303405572756
2016,1151,27,5,2096,297,0.84375,1799,0.875888006686168
2016,1152,1,28,77,1740,0.034482758620689655,-1663,0.04237754540451293
2016,1153,22,10,1660,682,0.6875,978,0.7087959009393681
2016,1154,7,22,635,1776,0.2413793103448276,-1141,0.26337619245126503
2016,1155,17,14,1229,930,0.5483870967741935,299,0.5692450208429829
2016,1156,7,23,451,1357,0.23333333333333334,-906,0.24944690265486727
2016,1157,15,11,1120,729,0.5769230769230769,391,0.6057328285559762
2016,1158,16,14,1080,859,0.5333333333333333,221,0.556988138215575
2016,1159,12,17,912,1091,0.41379310344827586,-179,0.455317024463305
2016,1160,21,11,1714,700,0.65625,1014,0.7100248550124275
2016,1161,16,16,1371,1155,0.5,216,0.5427553444180523
2016,1162,19,10,1427,732,0.6551724137931034,695,0.6609541454377026
2016,1163,24,10,1883,613,0.7058823529411765,1270,0.7544070512820513
2016,1164,7,22,536,1532,0.2413793103448276,-996,0.25918762088974856
2016,1165,9,18,721,1195,0.3333333333333333,-474,0.3763048016701461
2016,1166,18,14,1582,964,0.5625,618,0.6213668499607227
2016,1167,21,8,1582,499,0.7241379310344828,1083,0.7602114368092263
2016,1168,8,20,587,1354,0.2857142857142857,-767,0.3024214322514168
2016,1169,8,20,621,1371,0.2857142857142857,-750,0.3117469879518072
2016,1170,12,17,889,1147,0.41379310344827586,-258,0.43664047151277013
2016,1171,9,18,690,1181,0.3333333333333333,-491,0.36878674505611975
2016,1172,19,12,1618,833,0.6129032258064516,785,0.6601387188902489
2016,1173,25,7,1878,464,0.78125,1414,0.8018787361229718
2016,1174,7,23,473,1513,0.23333333333333334,-1040,0.23816717019133937
2016,1175,5,25,341,1460,0.16666666666666666,-1119,0.18933925596890616
2016,1176,16,15,1141,880,0.5161290322580645,261,0.5645719940623454
2016,1177,9,22,702,1390,0.2903225806451613,-688,0.3355640535372849
2016,1178,14,15,1181,1204,0.4827586206896552,-23,0.4951781970649895
2016,1179,6,24,469,1527,0.2,-1058,0.23496993987975953
2016,1180,6,24,385,1508,0.2,-1123,0.20338087691494983
2016,1181,23,10,1988,700,0.696969696969697,1288,0.7395833333333334
2016,1182,15,16,1257,1159,0.4838709677419355,98,0.5202814569536424
2016,1183,11,17,866,1100,0.39285714285714285,-234,0.4404883011190234
2016,1184,14,16,1245,1151,0.4666666666666667,94,0.5196160267111853
2016,1185,14,15,1118,1083,0.4827586206896552,35,0.5079509313948205
2016,1186,15,15,1287,1103,0.5,184,0.5384937238493723
2016,1187,12,20,924,1262,0.375,-338,0.42268984446477587
2016,1188,6,22,440,1399,0.21428571428571427,-959,0.2392604676454595
2016,1189,14,16,1139,1100,0.4666666666666667,39,0.5087092451987495
2016,1190,21,11,1685,754,0.65625,931,0.6908569085690857
2016,1191,24,9,1888,554,0.7272727272727273,1334,0.7731367731367731
2016,1192,17,14,1403,979,0.5483870967741935,424,0.5890008396305626
2016,1193,19,13,1581,879,0.59375,702,0.6426829268292683
2016,1194,7,24,525,1520,0.22580645161290322,-995,0.2567237163814181
2016,1195,16,13,1297,895,0.5517241379310345,402,0.5916970802919708
2016,1196,19,14,1490,939,0.5757575757575758,551,0.6134211609715933
2016,1197,6,21,450,1240,0.2222222222222222,-790,0.26627218934911245
2016,1198,11,19,820,1319,0.36666666666666664,-499,0.383356708742403
2016,1199,19,13,1546,953,0.59375,593,0.6186474589835934
2016,1200,16,13,1248,816,0.5517241379310345,432,0.6046511627906976
2016,1201,23,9,1777,611,0.71875,1166,0.7441373534338358
2016,1202,16,15,1195,969,0.5161290322580645,226,0.5522181146025879
2016,1203,23,10,1796,687,0.696969696969697,1109,0.7233185662505034
2016,1204,12,17,950,1183,0.41379310344827586,-233,0.4453820909517112
2016,1205,14,16,1052,1091,0.4666666666666667,-39,0.4909006066262249
2016,1206,11,21,803,1337,0.34375,-534,0.3752336448598131
2016,1207,15,18,1152,1278,0.45454545454545453,-126,0.4740740740740741
2016,1208,19,13,1359,884,0.59375,475,0.6058849754792688
2016,1209,14,14,952,869,0.5,83,0.5227896760021966
2016,1210,19,14,1509,908,0.5757575757575758,601,0.6243276789408357
2016,1211,25,7,2101,443,0.78125,1658,0.8258647798742138
2016,1212,4,24,296,1365,0.14285714285714285,-1069,0.1782059000602047
2016,1213,23,6,1798,400,0.7931034482758621,1398,0.8180163785259327
2016,1214,20,10,1576,673,0.6666666666666666,903,0.7007558915073366
2016,1216,9,23,728,1539,0.28125,-811,0.3211292456991619
2016,1217,12,16,895,974,0.42857142857142855,-79,0.47886570358480474
2016,1218,25,5,1952,362,0.8333333333333334,1590,0.8435609334485739
2016,1219,18,10,1420,687,0.6428571428571429,733,0.6739439962031324
2016,1220,23,9,1841,664,0.71875,1177,0.7349301397205589
2016,1221,14,19,988,1168,0.42424242424242425,-180,0.4582560296846011
2016,1222,22,9,1839,575,0.7096774193548387,1264,0.7618061309030655
2016,1223,13,16,1017,1100,0.4482758620689655,-83,0.48039678790741613
2016,1224,10,20,766,1341,0.3333333333333333,-575,0.3635500711912672
2016,1225,19,12,1343,752,0.6129032258064516,591,0.6410501193317423
2016,1226,14,15,1110,1001,0.4827586206896552,109,0.5258171482709616
2016,1227,3,25,215,1617,0.10714285714285714,-1402,0.11735807860262008
2016,1228,15,19,1214,1238,0.4411764705882353,-24,0.49510603588907015
2016,1229,17,14,1174,902,0.5483870967741935,272,0.5655105973025049
2016,1230,14,11,1085,696,0.56,389,0.6092083099382369
2016,1231,25,7,2132,501,0.78125,1631,0.8097227497151538
2016,1232,14,17,1014,1081,0.45161290322580644,-67,0.4840095465393795
2016,1233,22,10,1775,772,0.6875,1003,0.6968983117393012
2016,1234,21,10,1712,709,0.6774193548387096,1003,0.7071458075175547
2016,1235,21,11,1725,894,0.65625,831,0.6586483390607102
2016,1236,22,9,1825,610,0.7096774193548387,1215,0.7494866529774127
2016,1237,12,19,920,1175,0.3870967741935484,-255,0.43914081145584727
2016,1238,17,15,1206,945,0.53125,261,0.5606694560669456
2016,1239,12,16,946,1149,0.42857142857142855,-203,0.4515513126491647
2016,1240,6,23,453,1470,0.20689655172413793,-1017,0.23556942277691106
2016,1241,20,11,1524,775,0.6451612903225806,749,0.6628969117007395
2016,1242,29,4,2375,275,0.8787878787878788,2100,0.8962264150943396
2016,1243,17,16,1276,1058,0.5151515151515151,218,0.5467009425878321
2016,1244,9,20,743,1324,0.3103448275862069,-581,0.3594581519109821
2016,1245,18,13,1379,878,0.5806451612903226,501,0.6109880372175455
2016,1246,26,8,2128,581,0.7647058823529411,1547,0.7855297157622739
2016,1247,8,22,606,1300,0.26666666666666666,-694,0.3179433368310598
2016,1248,6,24,489,1653,0.2,-1164,0.22829131652661064
2016,1249,7,19,567,1332,0.2692307692307692,-765,0.2985781990521327
2016,1250,16,15,1208,976,0.5161290322580645,232,0.5531135531135531
2016,1251,10,19,698,1132,0.3448275862068966,-434,0.3814207650273224
2016,1252,10,21,842,1569,0.3225806451612903,-727,0.3492326835338034
2016,1253,18,14,1339,994,0.5625,345,0.5739391341620231
2016,1254,16,15,1280,1082,0.5161290322580645,198,0.541913632514818
2016,1255,7,23,545,1604,0.23333333333333334,-1059,0.2536063285248953
2016,1256,21,9,1737,627,0.7,1110,0.7347715736040609
2016,1257,23,8,1833,491,0.7419354838709677,1342,0.7887263339070568
2016,1258,13,17,1031,1091,0.43333333333333335,-60,0.4858623939679548
2016,1259,9,21,684,1406,0.3,-722,0.32727272727272727
2016,1260,14,17,974,1001,0.45161290322580644,-27,0.4931645569620253
2016,1261,19,14,1632,970,0.5757575757575758,662,0.6272098385857033
2016,1262,10,18,892,1225,0.35714285714285715,-333,0.4213509683514407
2016,1263,8,22,724,1555,0.26666666666666666,-831,0.3176831943835015
2016,1264,13,18,997,1136,0.41935483870967744,-139,0.4674167838724801
2016,1265,7,23,562,1583,0.23333333333333334,-1021,0.262004662004662
2016,1266,20,13,1622,895,0.6060606060606061,727,0.6444179578863727
2016,1267,17,16,1563,1275,0.5151515151515151,288,0.5507399577167019
2016,1268,24,8,1882,535,0.75,1347,0.7786512205213074
2016,1269,14,18,1128,1225,0.4375,-97,0.4793880152996175
2016,1270,7,19,546,1310,0.2692307692307692,-764,0.2941810344827586
2016,1271,9,22,687,1376,0.2903225806451613,-689,0.3330101793504605
2016,1272,19,15,1518,1085,0.5588235294117647,433,0.5831732616212063
2016,1273,17,14,1259,952,0.5483870967741935,307,0.5694255992763455
2016,1274,25,7,1950,470,0.78125,1480,0.8057851239669421
2016,1275,12,20,776,1245,0.375,-469,0.3839683325086591
2016,1276,21,12,1662,794,0.6363636363636364,868,0.6767100977198697
2016,1277,29,5,2355,357,0.8529411764705882,1998,0.8683628318584071
2016,1278,8,23,620,1488,0.25806451612903225,-868,0.29411764705882354
2016,1279,20,12,1585,820,0.625,765,0.659043659043659
2016,1280,14,17,1111,1212,0.45161290322580644,-101,0.4782608695652174
2016,1281,10,21,789,1337,0.3225806451612903,-548,0.3711194731890875
2016,1282,9,19,688,1247,0.32142857142857145,-559,0.35555555555555557
2016,1283,12,19,872,1204,0.3870967741935484,-332,0.42003853564547206
2016,1284,27,7,2156,544,0.7941176470588235,1612,0.7985185185185185
2016,1285,18,11,1429,665,0.6206896551724138,764,0.6824259789875836
2016,1286,13,17,1061,1218,0.43333333333333335,-157,0.4655550680122861
2016,1287,17,12,1217,834,0.5862068965517241,383,0.5933690882496343
2016,1288,8,22,588,1435,0.26666666666666666,-847,0.2906574394463668
2016,1290,8,27,568,1725,0.22857142857142856,-1157,0.2477104230266027
2016,1291,14,19,1021,1197,0.42424242424242425,-176,0.46032461677186653
2016,1292,22,9,1663,579,0.7096774193548387,1084,0.7417484388938448
2016,1293,15,14,1072,934,0.5172413793103449,138,0.5343968095712861
2016,1294,8,21,642,1474,0.27586206896551724,-832,0.30340264650283555
2016,1295,18,13,1238,859,0.5806451612903226,379,0.5903671912255604
2016,1296,17,12,1241,796,0.5862068965517241,445,0.6092292587137947
2016,1297,7,21,582,1363,0.25,-781,0.2992287917737789
2016,1298,18,14,1275,879,0.5625,396,0.5919220055710307
2016,1299,10,21,733,1349,0.3225806451612903,-616,0.3520653218059558
2016,1300,10,19,734,1223,0.3448275862068966,-489,0.37506387327542157
2016,1301,16,17,1267,1215,0.48484848484848486,52,0.5104754230459307
2016,1303,16,13,1414,1018,0.5517241379310345,396,0.5814144736842105
2016,1304,16,18,1277,1179,0.47058823529411764,98,0.5199511400651465
2016,1305,17,13,1288,868,0.5666666666666667,420,0.5974025974025974
2016,1306,17,12,1305,716,0.5862068965517241,589,0.6457199406234537
2016,1307,17,15,1374,1058,0.53125,316,0.5649671052631579
2016,1308,21,10,1599,603,0.6774193548387096,996,0.726158038147139
2016,1309,7,20,575,1403,0.25925925925925924,-828,0.29069767441860467
2016,1310,7,25,487,1580,0.21875,-1093,0.235607160135462
2016,1311,8,23,595,1454,0.25806451612903225,-859,0.2903855539287457
2016,1312,16,14,1270,980,0.5333333333333333,290,0.5644444444444444
2016,1313,15,16,1234,1057,0.4838709677419355,177,0.5386294194674814
2016,1314,28,6,2360,437,0.8235294117647058,1923,0.8437611726850197
2016,1315,14,15,1152,979,0.4827586206896552,173,0.5405912717034256
2016,1316,19,11,1684,818,0.6333333333333333,866,0.6730615507593924
2016,1317,10,20,766,1398,0.3333333333333333,-632,0.3539741219963031
2016,1318,17,15,1246,1039,0.53125,207,0.5452954048140044
2016,1319,3,25,226,1657,0.10714285714285714,-1431,0.12002124269782262
2016,1320,21,12,1489,740,0.6363636363636364,749,0.6680125616868551
2016,1321,20,12,1572,732,0.625,840,0.6822916666666666
2016,1322,5,19,438,1406,0.20833333333333334,-968,0.23752711496746204
2016,1323,21,11,1710,713,0.65625,997,0.7057366900536525
2016,1324,21,11,1890,872,0.65625,1018,0.6842867487328023
2016,1325,20,11,1603,812,0.6451612903225806,791,0.663768115942029
2016,1326,20,13,1483,841,0.6060606060606061,642,0.6381239242685026
2016,1328,25,7,2056,517,0.78125,1539,0.7990672366886903
2016,1329,12,20,890,1238,0.375,-348,0.4182330827067669
2016,1330,22,13,1592,805,0.6285714285714286,787,0.6641635377555277
2016,1331,12,17,904,1252,0.41379310344827586,-348,0.41929499072356213
2016,1332,27,6,2172,420,0.8181818181818182,1752,0.8379629629629629
2016,1333,18,12,1363,797,0.6,566,0.6310185185185185
2016,1334,6,20,436,1345,0.23076923076923078,-909,0.24480628860190903
2016,1335,10,17,761,1077,0.37037037037037035,-316,0.41403699673558214
2016,1336,16,16,1129,978,0.5,151,0.5358329378262933
2016,1337,17,13,1299,887,0.5666666666666667,412,0.5942360475754803
2016,1338,20,11,1700,649,0.6451612903225806,1051,0.7237122179650916
2016,1339,11,20,911,1474,0.3548387096774194,-563,0.3819706498951782
2016,1340,11,18,932,1271,0.3793103448275862,-339,0.4230594643667726
2016,1341,7,24,474,1399,0.22580645161290322,-925,0.2530699412706887
2016,1342,8,20,604,1211,0.2857142857142857,-607,0.3327823691460055
2016,1343,21,6,1715,398,0.7777777777777778,1317,0.8116422148603881
2016,1344,23,10,1758,683,0.696969696969697,1075,0.720196640721016
2016,1345,26,8,2119,524,0.7647058823529411,1595,0.8017404464623534
2016,1346,9,21,622,1347,0.3,-725,0.3158963941086846
2016,1347,14,15,1046,1029,0.4827586206896552,17,0.5040963855421686
2016,1348,17,15,1288,932,0.53125,356,0.5801801801801801
2016,1349,10,20,846,1421,0.3333333333333333,-575,0.37318041464490515
2016,1350,16,16,1326,1124,0.5,202,0.5412244897959184
2016,1351,13,20,976,1201,0.3939393939393939,-225,0.44832338079926504
2016,1352,10,22,702,1380,0.3125,-678,0.3371757925072046
2016,1353,6,25,480,1614,0.1935483870967742,-1134,0.22922636103151864
2016,1354,17,14,1323,889,0.5483870967741935,434,0.5981012658227848
2016,1355,24,7,1836,514,0.7741935483870968,1322,0.7812765957446809
2016,1356,22,10,1731,629,0.6875,1102,0.7334745762711864
2016,1357,12,18,952,1265,0.4,-313,0.42940911141181776
2016,1358,15,14,1195,894,0.5172413793103449,301,0.572044040210627
2016,1359,12,19,979,1263,0.3870967741935484,-284,0.4366636931311329
2016,1360,8,21,555,1196,0.27586206896551724,-641,0.316961736150771
2016,1361,23,9,1669,502,0.71875,1167,0.7687701520036849
2016,1362,14,15,1113,1116,0.4827586206896552,-3,0.4993270524899058
2016,1363,6,22,410,1467,0.21428571428571427,-1057,0.2184336707511987
2016,1364,17,13,1280,849,0.5666666666666667,431,0.6012212306247064
2016,1365,10,20,729,1281,0.3333333333333333,-552,0.36268656716417913
2016,1366,14,15,921,842,0.4827586206896552,79,0.5224049914917753
2016,1367,7,21,543,1434,0.25,-891,0.2746585735963581
2016,1368,10,21,806,1361,0.3225806451612903,-555,0.3719427780341486
2016,1369,3,24,204,1562,0.1111111111111111,-1358,0.11551528878822197
2016,1370,12,16,828,968,0.42857142857142855,-140,0.4610244988864143
2016,1371,25,8,1899,571,0.7575757575757576,1328,0.7688259109311741
2016,1372,23,5,1914,313,0.8214285714285714,1601,0.859452177817692
2016,1373,21,12,1692,887,0.6363636363636364,805,0.6560682435052346
2016,1374,25,5,1978,341,0.8333333333333334,1637,0.8529538594221647
2016,1375,12,19,899,1218,0.3870967741935484,-319,0.4246575342465753
2016,1376,23,8,1853,498,0.7419354838709677,1355,0.7881752445767758
2016,1377,12,18,1012,1266,0.4,-254,0.4442493415276558
2016,1378,8,25,582,1503,0.24242424242424243,-921,0.27913669064748203
2016,1379,7,20,508,1214,0.25925925925925924,-706,0.29500580720092917
2016,1380,19,12,1416,792,0.6129032258064516,624,0.6413043478260869
2016,1381,4,24,315,1620,0.14285714285714285,-1305,0.16279069767441862
2016,1382,22,8,1722,612,0.7333333333333333,1110,0.7377892030848329
2016,1383,14,17,990,1012,0.45161290322580644,-22,0.4945054945054945
2016,1384,12,17,910,1097,0.41379310344827586,-187,0.4534130543099153
2016,1385,7,24,477,1597,0.22580645161290322,-1120,0.22999035679845709
2016,1386,27,7,2095,543,0.7941176470588235,1552,0.7941622441243367
2016,1387,11,21,861,1245,0.34375,-384,0.40883190883190884
2016,1388,26,5,1997,320,0.8387096774193549,1677,0.8618903754855416
2016,1389,14,16,973,993,0.4666666666666667,-20,0.49491353001017296
2016,1390,14,15,1079,926,0.4827586206896552,153,0.5381546134663342
2016,1391,8,22,681,1656,0.26666666666666666,-975,0.2913992297817715
2016,1392,24,6,1871,393,0.8,1478,0.8264134275618374
2016,1393,19,13,1398,849,0.59375,549,0.6221628838451269
2016,1394,23,7,1765,419,0.7666666666666667,1346,0.8081501831501832
2016,1395,12,21,871,1338,0.36363636363636365,-467,0.3942960615663196
2016,1396,21,11,1508,689,0.65625,819,0.6863905325443787
2016,1397,15,19,1222,1332,0.4411764705882353,-110,0.47846515270164447
2016,1398,18,10,1350,701,0.6428571428571429,649,0.6582155046318869
2016,1399,17,11,1398,758,0.6071428571428571,640,0.6484230055658627
2016,1400,20,12,1487,796,0.625,691,0.6513359614542269
2016,1401,26,8,2041,540,0.7647058823529411,1501,0.790778767919411
2016,1402,13,16,922,948,0.4482758620689655,-26,0.493048128342246
2016,1403,19,12,1465,779,0.6129032258064516,686,0.6528520499108734
2016,1404,17,14,1307,886,0.5483870967741935,421,0.5959872321021432
2016,1405,16,15,1360,1026,0.5161290322580645,334,0.5699916177703269
2016,1406,18,12,1399,711,0.6,688,0.6630331753554503
2016,1407,7,22,489,1474,0.2413793103448276,-985,0.24910850738665308
2016,1408,12,22,885,1355,0.35294117647058826,-470,0.3950892857142857
2016,1409,20,11,1527,767,0.6451612903225806,760,0.6656495204882301
2016,1410,5,22,392,1358,0.18518518518518517,-966,0.224
2016,1411,18,14,1389,941,0.5625,448,0.596137339055794
2016,1412,25,6,1987,424,0.8064516129032258,1563,0.8241393612608876
2016,1413,9,19,620,1144,0.32142857142857145,-524,0.35147392290249435
2016,1414,23,9,1712,551,0.71875,1161,0.7565178965974371
2016,1415,12,19,892,1212,0.3870967741935484,-320,0.42395437262357416
2016,1416,12,18,932,1130,0.4,-198,0.451988360814743
2016,1417,15,17,1208,1272,0.46875,-64,0.4870967741935484
2016,1418,15,14,1258,992,0.5172413793103449,266,0.5591111111111111
2016,1419,18,13,1436,789,0.5806451612903226,647,0.6453932584269663
2016,1420,7,25,567,1740,0.21875,-1173,0.24577373211963588
2016,1421,20,11,1522,787,0.6451612903225806,735,0.6591598094413166
2016,1422,11,18,873,1209,0.3793103448275862,-336,0.41930835734870314
2016,1423,23,7,1859,483,0.7666666666666667,1376,0.7937660119555935
2016,1424,16,15,1359,1022,0.5161290322580645,337,0.5707685846283075
2016,1425,21,12,1801,867,0.6363636363636364,934,0.6750374812593704
2016,1426,22,10,1813,716,0.6875,1097,0.7168841439304072
2016,1427,4,26,312,1845,0.13333333333333333,-1533,0.14464534075104313
2016,1428,25,8,2031,493,0.7575757575757576,1538,0.804675118858954
2016,1429,14,15,1123,995,0.4827586206896552,128,0.5302171860245515
2016,1430,9,18,778,1221,0.3333333333333333,-443,0.3891945972986493
2016,1431,18,14,1508,950,0.5625,558,0.613506916192026
2016,1433,24,10,1941,684,0.7058823529411765,1257,0.7394285714285714
2016,1434,24,6,1831,427,0.8,1404,0.8108945969884854
2016,1435,19,13,1573,883,0.59375,690,0.6404723127035831
2016,1436,20,13,1579,887,0.6060606060606061,692,0.6403081914030819
2016,1437,29,5,2261,356,0.8529411764705882,1905,0.8639663737103553
2016,1438,26,7,1880,442,0.7878787878787878,1438,0.8096468561584841
2016,1439,19,14,1495,966,0.5757575757575758,529,0.6074766355140186
2016,1440,6,21,523,1291,0.2222222222222222,-768,0.28831312017640576
2016,1441,13,17,1029,1110,0.43333333333333335,-81,0.48106591865357645
2016,1442,7,17,536,1111,0.2916666666666667,-575,0.3254401942926533
2016,1443,16,16,1273,1157,0.5,116,0.5238683127572017
2016,1444,11,19,900,1256,0.36666666666666664,-356,0.4174397031539889
2016,1447,21,10,1523,650,0.6774193548387096,873,0.7008743672342383
2016,1448,11,20,879,1416,0.3548387096774194,-537,0.38300653594771245
2016,1449,18,14,1603,1065,0.5625,538,0.6008245877061469
2016,1450,8,22,664,1449,0.26666666666666666,-785,0.3142451490771415
2016,1451,23,8,1758,552,0.7419354838709677,1206,0.7610389610389611
2016,1452,26,8,2175,518,0.7647058823529411,1657,0.8076494615670257
2016,1453,21,12,1769,977,0.6363636363636364,792,0.6442097596504006
2016,1454,18,13,1442,966,0.5806451612903226,476,0.5988372093023255
2016,1455,23,8,1779,488,0.7419354838709677,1291,0.7847375385972651
2016,1456,18,11,1421,784,0.6206896551724138,637,0.6444444444444445
2016,1457,20,9,1665,663,0.6896551724137931,1002,0.7152061855670103
2016,1458,20,12,1473,731,0.625,742,0.6683303085299456
2016,1459,13,17,1045,1076,0.43333333333333335,-31,0.4926921263554927
2016,1460,20,13,1469,796,0.6060606060606061,673,0.6485651214128035
2016,1461,12,18,881,1229,0.4,-348,0.41753554502369666
2016,1462,27,5,2247,356,0.84375,1891,0.8632347291586631
2016,1463,21,6,1643,368,0.7777777777777778,1275,0.8170064644455495
2016,1464,9,21,773,1496,0.3,-723,0.34067871308946673
2016,3101,22,3,1666,164,0.88,1502,0.9103825136612022
2016,3102,1,29,59,1363,0.03333333333333333,-1304,0.04149085794655415
2016,3103,18,13,1312,868,0.5806451612903226,444,0.6018348623853211
2016,3104,15,15,1102,821,0.5,281,0.5730629225169007
2016,3105,4,25,323,1346,0.13793103448275862,-1023,0.19352905931695627
2016,3106,18,11,1234,601,0.6206896551724138,633,0.6724795640326976
2016,3107,27,4,1965,237,0.8709677419354839,1728,0.8923705722070845
2016,3108,9,19,673,1033,0.32142857142857145,-360,0.39449003516998826
2016,3110,8,23,470,1202,0.25806451612903225,-732,0.2811004784688995
2016,3111,10,20,758,1230,0.3333333333333333,-472,0.3812877263581489
2016,3112,13,19,863,957,0.40625,-94,0.47417582417582416
2016,3113,25,6,1633,339,0.8064516129032258,1294,0.8280933062880325
2016,3114,20,12,1226,671,0.625,555,0.6462836056931998
2016,3115,6,20,441,1040,0.23076923076923078,-599,0.2977717758271438
2016,3116,12,18,817,987,0.4,-170,0.45288248337028825
2016,3117,26,5,1984,355,0.8387096774193549,1629,0.8482257374946558
2016,3119,28,2,1977,130,0.9333333333333333,1847,0.9383009017560513
2016,3120,19,12,1329,599,0.6129032258064516,730,0.6893153526970954
2016,3122,8,20,657,1244,0.2857142857142857,-587,0.34560757496054706
2016,3123,20,9,1419,557,0.6896551724137931,862,0.7181174089068826
2016,3124,33,1,2598,45,0.9705882352941176,2553,0.9829738933030647
2016,3125,22,8,1732,508,0.7333333333333333,1224,0.7732142857142857
2016,3126,16,12,1020,646,0.5714285714285714,374,0.6122448979591837
2016,3127,11,17,647,879,0.39285714285714285,-232,0.4239842726081258
2016,3129,17,11,1243,675,0.6071428571428571,568,0.6480709071949948
2016,3130,15,16,960,884,0.4838709677419355,76,0.5206073752711496
2016,3131,3,27,185,1363,0.1,-1178,0.11950904392764858
2016,3132,10,18,683,962,0.35714285714285715,-279,0.41519756838905775
2016,3133,8,22,488,1139,0.26666666666666666,-651,0.2999385371850031
2016,3135,13,13,940,768,0.5,172,0.550351288056206
2016,3136,18,13,1298,795,0.5806451612903226,503,0.6201624462494028
2016,3137,24,7,1659,375,0.7741935483870968,1284,0.8156342182890856
2016,3138,20,13,1271,741,0.6060606060606061,530,0.6317097415506958
2016,3139,10,21,659,1149,0.3225806451612903,-490,0.3644911504424779
2016,3140,25,6,1797,348,0.8064516129032258,1449,0.8377622377622378
2016,3141,22,10,1713,675,0.6875,1038,0.7173366834170855
2016,3142,15,16,993,962,0.4838709677419355,31,0.507928388746803
2016,3143,15,17,1202,960,0.46875,242,0.5559666975023126
2016,3144,13,17,883,817,0.43333333333333335,66,0.5194117647058824
2016,3145,13,17,853,981,0.43333333333333335,-128,0.46510359869138496
2016,3146,24,3,1559,152,0.8888888888888888,1407,0.9111630625365283
2016,3148,12,18,802,964,0.4,-162,0.45413363533408835
2016,3149,11,17,722,883,0.39285714285714285,-161,0.44984423676012464
2016,3150,19,11,1478,768,0.6333333333333333,710,0.6580587711487088
2016,3151,24,7,1516,281,0.7741935483870968,1235,0.8436282693377852
2016,3152,4,25,285,1288,0.13793103448275862,-1003,0.18118245390972665
2016,3153,8,22,534,1178,0.26666666666666666,-644,0.3119158878504673
2016,3155,4,26,244,1324,0.13333333333333333,-1080,0.1556122448979592
2016,3156,9,20,617,1178,0.3103448275862069,-561,0.34373259052924793
2016,3157,9,18,612,991,0.3333333333333333,-379,0.3817841547099189
2016,3158,11,20,697,1025,0.3548387096774194,-328,0.40476190476190477
2016,3159,7,23,491,1277,0.23333333333333334,-786,0.27771493212669685
2016,3160,7,23,551,1307,0.23333333333333334,-756,0.2965554359526372
2016,3161,29,1,1976,48,0.9666666666666667,1928,0.9762845849802372
2016,3162,11,17,813,1000,0.39285714285714285,-187,0.4484280198565913
2016,3163,32,0,2802,0,1.0,2802,1.0
2016,3164,16,15,1118,828,0.5161290322580645,290,0.5745118191161357
2016,3165,14,14,990,735,0.5,255,0.5739130434782609
2016,3166,17,17,1207,997,0.5,210,0.5476406533575318
2016,3167,12,19,861,1097,0.3870967741935484,-236,0.4397344228804903
2016,3168,3,27,225,1449,0.1,-1224,0.13440860215053763
2016,3169,7,24,518,1415,0.22580645161290322,-897,0.26797723745473356
2016,3170,14,17,1364,1349,0.45161290322580644,15,0.5027644673792849
2016,3171,12,18,741,898,0.4,-157,0.4521049420378279
2016,3172,11,19,721,1067,0.36666666666666664,-346,0.40324384787472034
2016,3173,14,14,1054,841,0.5,213,0.5562005277044855
2016,3174,16,15,1010,797,0.5161290322580645,213,0.5589374654122855
2016,3175,9,21,682,1127,0.3,-445,0.377003869541183
2016,3176,5,25,285,1320,0.16666666666666666,-1035,0.17757009345794392
2016,3177,25,8,2086,586,0.7575757575757576,1500,0.780688622754491
2016,3178,14,15,1096,928,0.4827586206896552,168,0.541501976284585
2016,3179,21,9,1749,625,0.7,1124,0.7367312552653749
2016,3180,19,13,1193,724,0.59375,469,0.6223265519040166
2016,3181,20,12,1509,680,0.625,829,0.6893558702603929
2016,3182,26,5,1907,307,0.8387096774193549,1600,0.8613369467028004
2016,3183,3,25,205,1479,0.10714285714285714,-1274,0.12173396674584323
2016,3184,16,12,1222,757,0.5714285714285714,465,0.6174835775644265
2016,3185,19,11,1379,713,0.6333333333333333,666,0.6591778202676865
2016,3186,19,12,1401,833,0.6129032258064516,568,0.6271262309758281
2016,3187,13,19,974,1188,0.40625,-214,0.45050878815911194
2016,3188,18,13,1411,834,0.5806451612903226,577,0.6285077951002227
2016,3189,17,12,1131,717,0.5862068965517241,414,0.612012987012987
2016,3190,13,14,896,708,0.48148148148148145,188,0.5586034912718204
2016,3191,3,28,195,1501,0.0967741935483871,-1306,0.11497641509433962
2016,3192,11,21,798,1277,0.34375,-479,0.38457831325301206
2016,3193,16,14,1038,726,0.5333333333333333,312,0.5884353741496599
2016,3194,13,16,947,998,0.4482758620689655,-51,0.48688946015424167
2016,3195,27,5,1750,274,0.84375,1476,0.8646245059288538
2016,3196,22,8,1793,547,0.7333333333333333,1246,0.7662393162393163
2016,3197,14,15,971,827,0.4827586206896552,144,0.5400444938820912
2016,3198,5,26,344,1497,0.16129032258064516,-1153,0.1868549701249321
2016,3199,23,7,1779,441,0.7666666666666667,1338,0.8013513513513514
2016,3200,14,17,879,842,0.45161290322580644,37,0.5107495642068565
2016,3201,19,11,1168,699,0.6333333333333333,469,0.6256025709694697
2016,3202,13,16,950,860,0.4482758620689655,90,0.5248618784530387
2016,3203,26,6,1900,398,0.8125,1502,0.8268059181897301
2016,3204,7,22,449,1090,0.2413793103448276,-641,0.2917478882391163
2016,3205,17,12,1100,688,0.5862068965517241,412,0.6152125279642058
2016,3206,12,19,857,1083,0.3870967741935484,-226,0.4417525773195876
2016,3207,16,13,1092,796,0.5517241379310345,296,0.5783898305084746
2016,3208,21,9,1459,464,0.7,995,0.7587103484139366
2016,3209,10,19,702,1156,0.3448275862068966,-454,0.37782561894510225
2016,3210,19,12,1424,717,0.6129032258064516,707,0.6651097617935544
2016,3211,18,13,1259,751,0.5806451612903226,508,0.6263681592039801
2016,3212,15,14,1052,785,0.5172413793103449,267,0.57267283614589
2016,3213,13,14,863,761,0.48148148148148145,102,0.5314039408866995
2016,3214,14,17,903,988,0.45161290322580644,-85,0.4775251189846642
2016,3216,11,19,629,837,0.36666666666666664,-208,0.42905866302864937
2016,3217,14,13,1001,791,0.5185185185185185,210,0.55859375
2016,3218,21,10,1445,572,0.6774193548387096,873,0.7164105106593951
2016,3219,11,19,783,1150,0.36666666666666664,-367,0.40506983962752197
2016,3220,22,8,1492,427,0.7333333333333333,1065,0.7774882751433038
2016,3221,13,17,859,955,0.43333333333333335,-96,0.4735391400220507
2016,3222,6,24,384,1286,0.2,-902,0.22994011976047904
2016,3223,11,15,754,882,0.4230769230769231,-128,0.460880195599022
2016,3224,7,24,492,1473,0.22580645161290322,-981,0.250381679389313
2016,3225,22,9,1770,564,0.7096774193548387,1206,0.7583547557840618
2016,3226,16,15,1099,830,0.5161290322580645,269,0.5697252462415759
2016,3227,12,18,801,1053,0.4,-252,0.4320388349514563
2016,3228,9,21,696,1360,0.3,-664,0.33852140077821014
2016,3229,8,22,517,1150,0.26666666666666666,-633,0.3101379724055189
2016,3230,3,22,201,1185,0.12,-984,0.14502164502164502
2016,3231,20,11,1488,741,0.6451612903225806,747,0.6675639300134589
2016,3232,13,17,843,905,0.43333333333333335,-62,0.48226544622425627
2016,3233,23,11,1533,596,0.6764705882352942,937,0.720056364490371
2016,3234,19,13,1432,912,0.59375,520,0.6109215017064846
2016,3235,13,17,995,1027,0.43333333333333335,-32,0.4920870425321464
2016,3236,5,23,348,1444,0.17857142857142858,-1096,0.19419642857142858
2016,3237,18,10,1245,589,0.6428571428571429,656,0.6788440567066522
2016,3238,11,16,772,851,0.4074074074074074,-79,0.47566235366605053
2016,3239,20,10,1386,539,0.6666666666666666,847,0.72
2016,3240,9,18,555,914,0.3333333333333333,-359,0.3778080326752893
2016,3241,27,5,1933,290,0.84375,1643,0.8695456590193432
2016,3242,6,25,419,1268,0.1935483870967742,-849,0.24836988737403676
2016,3243,18,12,1273,686,0.6,587,0.6498213374170495
2016,3244,10,19,662,1059,0.3448275862068966,-397,0.38466008134805346
2016,3245,5,23,364,1345,0.17857142857142858,-981,0.21299005266237567
2016,3246,23,7,1762,467,0.7666666666666667,1295,0.7904890085240018
2016,3247,5,25,344,1405,0.16666666666666666,-1061,0.19668381932532875
2016,3248,6,23,414,1261,0.20689655172413793,-847,0.2471641791044776
2016,3249,8,19,582,1242,0.2962962962962963,-660,0.3190789473684211
2016,3250,17,13,1239,750,0.5666666666666667,489,0.6229260935143288
2016,3251,19,12,1233,655,0.6129032258064516,578,0.653072033898305
2016,3252,4,25,300,1494,0.13793103448275862,-1194,0.16722408026755853
2016,3253,24,8,1579,423,0.75,1156,0.7887112887112887
2016,3254,9,21,604,1136,0.3,-532,0.3471264367816092
2016,3255,6,22,392,1178,0.21428571428571427,-786,0.24968152866242038
2016,3256,13,16,934,1013,0.4482758620689655,-79,0.47971237801746275
2016,3257,25,7,1839,456,0.78125,1383,0.8013071895424837
2016,3258,11,20,871,1281,0.3548387096774194,-410,0.40473977695167285
2016,3259,16,16,952,794,0.5,158,0.54524627720504
2016,3260,14,16,985,967,0.4666666666666667,18,0.5046106557377049
2016,3261,10,21,647,1041,0.3225806451612903,-394,0.38329383886255924
2016,3262,4,24,291,1337,0.14285714285714285,-1046,0.17874692874692874
2016,3263,25,8,1590,401,0.7575757575757576,1189,0.7985936715218483
2016,3264,15,16,1004,891,0.4838709677419355,113,0.5298153034300792
2016,3265,16,16,1115,878,0.5,237,0.5594581033617662
2016,3266,14,16,1190,1131,0.4666666666666667,59,0.5127100387763894
2016,3267,19,11,1397,685,0.6333333333333333,712,0.6709894332372719
2016,3268,30,3,2543,230,0.9090909090909091,2313,0.9170573386224306
2016,3269,12,18,880,1052,0.4,-172,0.4554865424430642
2016,3270,17,12,1351,699,0.5862068965517241,652,0.6590243902439025
2016,3271,11,17,710,878,0.39285714285714285,-168,0.44710327455919396
2016,3272,18,12,1338,693,0.6,645,0.6587887740029542
2016,3273,22,8,1491,409,0.7333333333333333,1082,0.7847368421052632
2016,3274,24,8,1763,500,0.75,1263,0.7790543526292532
2016,3275,9,21,623,1173,0.3,-550,0.34688195991091314
2016,3276,17,13,1464,894,0.5666666666666667,570,0.6208651399491094
2016,3277,24,8,1889,546,0.75,1343,0.7757700205338809
2016,3278,19,11,1679,821,0.6333333333333333,858,0.6716
2016,3279,10,20,818,1123,0.3333333333333333,-305,0.42143225141679547
2016,3280,26,7,1953,365,0.7878787878787878,1588,0.8425366695427092
2016,3281,21,9,1552,490,0.7,1062,0.7600391772771793
2016,3282,8,18,483,1019,0.3076923076923077,-536,0.3215712383488682
2016,3283,23,9,1675,562,0.71875,1113,0.7487706750111757
2016,3284,14,17,1010,1043,0.45161290322580644,-33,0.4919629810034096
2016,3285,19,11,1425,636,0.6333333333333333,789,0.6914119359534207
2016,3286,19,9,1552,561,0.6785714285714286,991,0.73450070989115
2016,3287,8,20,683,1462,0.2857142857142857,-779,0.3184149184149184
2016,3288,12,17,786,768,0.41379310344827586,18,0.5057915057915058
2016,3290,1,26,62,1237,0.037037037037037035,-1175,0.04772902232486528
2016,3291,9,21,541,1155,0.3,-614,0.31898584905660377
2016,3292,24,8,1787,454,0.75,1333,0.7974118697010263
2016,3293,10,17,740,1027,0.37037037037037035,-287,0.4187889077532541
2016,3294,12,16,826,903,0.42857142857142855,-77,0.4777327935222672
2016,3295,5,22,390,1318,0.18518518518518517,-928,0.22833723653395785
2016,3296,10,19,755,1199,0.3448275862068966,-444,0.38638689866939613
2016,3297,17,13,1283,843,0.5666666666666667,440,0.603480714957667
2016,3298,14,15,829,746,0.4827586206896552,83,0.5263492063492063
2016,3299,17,11,1186,566,0.6071428571428571,620,0.6769406392694064
2016,3300,4,23,243,1113,0.14814814814814814,-870,0.17920353982300885
2016,3301,20,11,1429,663,0.6451612903225806,766,0.6830783938814532
2016,3303,13,15,862,894,0.4642857142857143,-32,0.4908883826879271
2016,3304,18,12,1458,733,0.6,725,0.6654495664080329
2016,3305,4,25,277,1359,0.13793103448275862,-1082,0.16931540342298287
2016,3306,11,18,708,945,0.3793103448275862,-237,0.4283121597096189
2016,3307,17,14,1145,751,0.5483870967741935,394,0.6039029535864979
2016,3308,24,4,1702,229,0.8571428571428571,1473,0.8814085965820818
2016,3309,6,19,379,1066,0.24,-687,0.2622837370242215
2016,3310,8,23,471,1267,0.25806451612903225,-796,0.2710011507479862
2016,3311,9,19,624,1127,0.32142857142857145,-503,0.35636778983438033
2016,3312,2,26,114,1230,0.07142857142857142,-1116,0.08482142857142858
2016,3313,3,24,255,1348,0.1111111111111111,-1093,0.15907673112913287
2016,3314,14,18,1006,1145,0.4375,-139,0.4676894467689447
2016,3315,18,13,1223,759,0.5806451612903226,464,0.6170534813319879
2016,3316,5,22,354,1124,0.18518518518518517,-770,0.2395128552097429
2016,3317,11,19,706,1132,0.36666666666666664,-426,0.38411316648531013
2016,3318,15,16,1012,885,0.4838709677419355,127,0.5334739061676331
2016,3319,4,24,266,1531,0.14285714285714285,-1265,0.14802448525319978
2016,3320,21,10,1344,648,0.6774193548387096,696,0.6746987951807228
2016,3321,18,16,1430,1116,0.5294117647058824,314,0.5616653574234093
2016,3322,15,11,1006,579,0.5769230769230769,427,0.6347003154574132
2016,3323,31,1,2454,81,0.96875,2373,0.9680473372781065
2016,3324,13,15,1003,1053,0.4642857142857143,-50,0.48784046692607
2016,3325,24,6,1854,320,0.8,1534,0.8528058877644894
2016,3326,24,7,2141,546,0.7741935483870968,1595,0.7967994045403796
2016,3328,21,10,1545,633,0.6774193548387096,912,0.709366391184573
2016,3329,21,9,1532,432,0.7,1100,0.780040733197556
2016,3330,17,17,1185,932,0.5,253,0.5597543693906472
2016,3331,13,15,818,807,0.4642857142857143,11,0.5033846153846154
2016,3332,20,10,1609,570,0.6666666666666666,1039,0.7384121156493805
2016,3333,28,4,1923,216,0.875,1707,0.8990182328190743
2016,3334,12,17,921,1083,0.41379310344827586,-162,0.4595808383233533
2016,3335,23,4,1499,188,0.8518518518518519,1311,0.8885595732068761
2016,3336,12,19,905,1267,0.3870967741935484,-362,0.4166666666666667
2016,3337,7,23,509,1403,0.23333333333333334,-894,0.2662133891213389
2016,3338,13,18,900,957,0.41935483870967744,-57,0.48465266558966075
2016,3339,2,27,150,1531,0.06896551724137931,-1381,0.08923259964306961
2016,3340,3,25,252,1600,0.10714285714285714,-1348,0.13606911447084233
2016,3341,12,15,882,792,0.4444444444444444,90,0.5268817204301075
2016,3342,15,13,961,650,0.5357142857142857,311,0.5965238981998758
2016,3343,23,5,1805,323,0.8214285714285714,1482,0.8482142857142857
2016,3344,5,24,353,1293,0.1724137931034483,-940,0.21445929526123936
2016,3345,20,11,1439,671,0.6451612903225806,768,0.6819905213270142
2016,3346,24,8,1708,434,0.75,1274,0.7973856209150327
2016,3347,16,13,1014,672,0.5517241379310345,342,0.6014234875444839
2016,3348,12,18,797,1022,0.4,-225,0.43815283122594834
2016,3349,9,22,653,1182,0.2903225806451613,-529,0.355858310626703
2016,3350,13,18,811,918,0.41935483870967744,-107,0.46905725853094277
2016,3351,8,22,537,1208,0.26666666666666666,-671,0.30773638968481376
2016,3352,19,12,1248,686,0.6129032258064516,562,0.6452947259565667
2016,3353,18,14,1176,829,0.5625,347,0.5865336658354114
2016,3354,11,16,665,803,0.4074074074074074,-138,0.4529972752043597
2016,3355,26,6,1875,369,0.8125,1506,0.8355614973262032
2016,3356,20,12,1463,724,0.625,739,0.6689529035208047
2016,3357,20,12,1412,683,0.625,729,0.6739856801909307
2016,3358,12,18,863,1044,0.4,-181,0.45254326166754066
2016,3359,18,11,1041,543,0.6206896551724138,498,0.6571969696969697
2016,3360,22,7,1551,441,0.7586206896551724,1110,0.7786144578313253
2016,3361,11,19,719,1023,0.36666666666666664,-304,0.41274397244546496
2016,3362,19,11,1484,671,0.6333333333333333,813,0.688631090487239
2016,3363,12,17,881,1194,0.41379310344827586,-313,0.42457831325301204
2016,3364,11,20,785,1099,0.3548387096774194,-314,0.4166666666666667
2016,3365,21,8,1386,466,0.7241379310344828,920,0.7483801295896328
2016,3366,8,18,498,809,0.3076923076923077,-311,0.38102524866105586
2016,3367,17,11,1252,583,0.6071428571428571,669,0.6822888283378746
2016,3368,4,25,278,1543,0.13793103448275862,-1265,0.1526633717737507
2016,3369,13,15,1001,950,0.4642857142857143,51,0.513070220399795
2016,3370,8,21,544,1182,0.27586206896551724,-638,0.31517960602549244
2016,3371,23,8,1762,507,0.7419354838709677,1255,0.7765535478184222
2016,3372,15,12,1092,680,0.5555555555555556,412,0.6162528216704289
2016,3373,14,18,906,919,0.4375,-13,0.4964383561643836
2016,3374,13,18,882,982,0.41935483870967744,-100,0.47317596566523606
2016,3375,13,15,836,728,0.4642857142857143,108,0.5345268542199488
2016,3376,31,1,2299,54,0.96875,2245,0.9770505737356566
2016,3377,25,6,2066,358,0.8064516129032258,1708,0.8523102310231023
2016,3378,23,9,1794,563,0.71875,1231,0.7611370386084005
2016,3379,13,16,878,817,0.4482758620689655,61,0.5179941002949853
2016,3380,17,11,1193,568,0.6071428571428571,625,0.6774559909142532
2016,3381,4,25,291,1411,0.13793103448275862,-1120,0.1709753231492362
2016,3382,23,7,1518,387,0.7666666666666667,1131,0.7968503937007874
2016,3383,7,22,471,1220,0.2413793103448276,-749,0.2785334121821407
2016,3384,13,17,1087,1141,0.43333333333333335,-54,0.4878815080789946
2016,3385,23,9,1605,539,0.71875,1066,0.7486007462686567
2016,3386,14,15,953,869,0.4827586206896552,84,0.5230515916575192
2016,3387,23,7,1672,446,0.7666666666666667,1226,0.789423984891407
2016,3388,24,7,1873,442,0.7741935483870968,1431,0.8090712742980561
2016,3389,4,26,246,1295,0.13333333333333333,-1049,0.15963659961064244
2016,3390,24,7,1721,370,0.7741935483870968,1351,0.8230511716881874
2016,3391,16,11,1130,621,0.5925925925925926,509,0.6453455168475157
2016,3392,17,14,1074,738,0.5483870967741935,336,0.5927152317880795
2016,3393,25,7,1888,418,0.78125,1470,0.818733738074588
2016,3394,8,19,533,1048,0.2962962962962963,-515,0.3371283997469956
2016,3395,16,14,1232,899,0.5333333333333333,333,0.5781323322383858
2016,3396,20,11,1510,656,0.6451612903225806,854,0.6971375807940905
2016,3397,19,13,1338,745,0.59375,593,0.6423427748439751
2016,3398,10,18,689,1025,0.35714285714285715,-336,0.40198366394399065
2016,3399,10,19,700,1091,0.3448275862068966,-391,0.3908431044109436
2016,3400,28,4,2030,234,0.875,1796,0.8966431095406361
2016,3401,21,9,1533,591,0.7,942,0.7217514124293786
2016,3402,10,19,684,1088,0.3448275862068966,-404,0.3860045146726862
2016,3403,13,18,987,976,0.41935483870967744,11,0.5028018339276618
2016,3404,21,9,1617,584,0.7,1033,0.7346660608814175
2016,3405,17,13,1249,756,0.5666666666666667,493,0.6229426433915212
2016,3406,7,24,504,1399,0.22580645161290322,-895,0.26484498160798736
2016,3407,18,12,1557,838,0.6,719,0.6501043841336117
2016,3408,21,11,1462,614,0.65625,848,0.7042389210019268
2016,3409,12,19,854,1068,0.3870967741935484,-214,0.44432882414151925
2016,3410,16,13,1031,718,0.5517241379310345,313,0.5894797026872498
2016,3411,19,11,1206,579,0.6333333333333333,627,0.6756302521008404
2016,3412,15,16,1008,903,0.4838709677419355,105,0.5274725274725275
2016,3413,18,13,1296,804,0.5806451612903226,492,0.6171428571428571
2016,3414,3,27,193,1479,0.1,-1286,0.11543062200956938
2016,3415,23,8,1929,508,0.7419354838709677,1421,0.7915469839967173
2016,3416,7,23,545,1345,0.23333333333333334,-800,0.28835978835978837
2016,3417,24,8,1832,549,0.75,1283,0.7694246115077699
2016,3418,19,10,1210,575,0.6551724137931034,635,0.6778711484593838
2016,3419,8,17,555,856,0.32,-301,0.3933380581148122
2016,3420,17,13,1086,657,0.5666666666666667,429,0.6230636833046471
2016,3421,24,6,1691,333,0.8,1358,0.8354743083003953
2016,3422,6,21,473,1276,0.2222222222222222,-803,0.27044025157232704
2016,3423,6,23,339,1183,0.20689655172413793,-844,0.22273324572930356
2016,3424,17,14,1106,791,0.5483870967741935,315,0.5830258302583026
2016,3425,18,13,1298,740,0.5806451612903226,558,0.6368989205103042
2016,3426,14,16,887,855,0.4666666666666667,32,0.5091848450057406
2016,3427,8,19,516,1080,0.2962962962962963,-564,0.3233082706766917
2016,3428,16,14,1211,806,0.5333333333333333,405,0.6003966286564204
2016,3429,12,17,838,1079,0.41379310344827586,-241,0.4371413667188315
2016,3430,14,15,1007,868,0.4827586206896552,139,0.5370666666666667
2016,3431,25,4,1822,222,0.8620689655172413,1600,0.8913894324853229
2016,3433,23,9,1515,544,0.71875,971,0.7357940747935892
2016,3434,7,21,516,1224,0.25,-708,0.296551724137931
2016,3435,18,14,1224,776,0.5625,448,0.612
2016,3436,9,21,551,1126,0.3,-575,0.3285629099582588
2016,3437,19,11,1263,622,0.6333333333333333,641,0.670026525198939
2016,3438,16,15,1158,820,0.5161290322580645,338,0.5854398382204247
2016,3439,17,13,1102,641,0.5666666666666667,461,0.6322432587492829
2016,3441,4,22,311,1254,0.15384615384615385,-943,0.1987220447284345
2016,3442,13,15,1061,1002,0.4642857142857143,59,0.5142995637421232
2016,3443,23,6,1658,401,0.7931034482758621,1257,0.8052452646915979
2016,3444,15,15,1092,885,0.5,207,0.5523520485584219
2016,3447,5,24,361,1386,0.1724137931034483,-1025,0.20663995420721237
2016,3448,16,15,1031,853,0.5161290322580645,178,0.54723991507431
2016,3449,22,10,1660,614,0.6875,1046,0.7299912049252418
2016,3450,14,16,971,967,0.4666666666666667,4,0.5010319917440661
2016,3451,18,11,1285,710,0.6206896551724138,575,0.6441102756892231
2016,3452,24,9,1806,509,0.7272727272727273,1297,0.7801295896328294
2016,3453,28,4,1904,227,0.875,1677,0.8934772407320507
2016,3454,19,12,1368,683,0.6129032258064516,685,0.666991711360312
2016,3455,8,22,473,1110,0.26666666666666666,-637,0.29879974731522424
2016,3456,15,15,1042,820,0.5,222,0.5596133190118152
2016,3457,4,26,245,1357,0.13333333333333333,-1112,0.15293383270911362
2016,3458,7,22,505,1359,0.2413793103448276,-854,0.2709227467811159
2016,3459,7,20,509,1086,0.25925925925925924,-577,0.31912225705329156
2016,3460,22,10,1725,653,0.6875,1072,0.7253994953742641
2016,3461,12,16,879,875,0.42857142857142855,4,0.5011402508551881
2016,3462,17,13,1104,711,0.5666666666666667,393,0.6082644628099173
2016,3463,13,17,851,1073,0.43333333333333335,-222,0.4423076923076923
2016,3464,17,12,1177,690,0.5862068965517241,487,0.6304231387252276
2017,1101,9,16,669,1028,0.36,-359,0.3942251031231585
2017,1102,10,21,801,1417,0.3225806451612903,-616,0.3611361587015329
2017,1103,25,8,1993,537,0.7575757575757576,1456,0.7877470355731225
2017,1104,19,14,1386,880,0.5757575757575758,506,0.6116504854368932
2017,1105,2,27,166,1628,0.06896551724137931,-1462,0.09253065774804906
2017,1106,7,23,530,1437,0.23333333333333334,-907,0.26944585663446874
2017,1107,20,13,1562,782,0.6060606060606061,780,0.6663822525597269
2017,1108,15,14,1107,855,0.5172413793103449,252,0.5642201834862385
2017,1110,8,22,532,1313,0.26666666666666666,-781,0.2883468834688347
2017,1111,7,21,538,1435,0.25,-897,0.27268119614799796
2017,1112,30,4,2336,257,0.8823529411764706,2079,0.9008870034708831
2017,1113,15,18,1342,1251,0.45454545454545453,91,0.5175472425761666
2017,1114,13,17,944,1047,0.43333333333333335,-103,0.4741336012054244
2017,1115,6,24,461,1359,0.2,-898,0.2532967032967033
2017,1116,25,9,2083,630,0.7352941176470589,1453,0.7677847401400664
2017,1117,19,12,1472,774,0.6129032258064516,698,0.655387355298308
2017,1119,12,19,880,1353,0.3870967741935484,-473,0.39408866995073893
2017,1120,18,14,1513,1060,0.5625,453,0.5880295375048581
2017,1122,9,19,760,1382,0.32142857142857145,-622,0.35480859010270777
2017,1123,20,12,1668,837,0.625,831,0.665868263473054
2017,1124,24,7,1754,466,0.7741935483870968,1288,0.7900900900900901
2017,1125,21,6,1676,395,0.7777777777777778,1281,0.8092708836310961
2017,1126,8,22,576,1536,0.26666666666666666,-960,0.2727272727272727
2017,1127,9,20,655,1233,0.3103448275862069,-578,0.3469279661016949
2017,1129,18,11,1453,737,0.6206896551724138,716,0.6634703196347032
2017,1130,9,23,726,1594,0.28125,-868,0.3129310344827586
2017,1131,17,14,1290,958,0.5483870967741935,332,0.5738434163701067
2017,1132,12,19,964,1305,0.3870967741935484,-341,0.4248567650947554
2017,1133,12,20,919,1174,0.375,-255,0.43908265647396083
2017,1135,11,17,895,1201,0.39285714285714285,-306,0.42700381679389315
2017,1136,11,20,820,1465,0.3548387096774194,-645,0.3588621444201313
2017,1137,26,8,2025,564,0.7647058823529411,1461,0.7821552723059096
2017,1138,15,15,1224,1092,0.5,132,0.5284974093264249
2017,1139,23,8,1823,542,0.7419354838709677,1281,0.7708245243128964
2017,1140,22,11,1829,823,0.6666666666666666,1006,0.6896681749622926
2017,1141,14,16,1306,1296,0.4666666666666667,10,0.5019215987701768
2017,1142,9,20,685,1253,0.3103448275862069,-568,0.35345717234262125
2017,1143,21,12,1535,715,0.6363636363636364,820,0.6822222222222222
2017,1144,14,17,1075,1060,0.45161290322580644,15,0.5035128805620609
2017,1145,18,15,1523,1068,0.5454545454545454,455,0.5878039367039753
2017,1146,8,24,683,1712,0.25,-1029,0.28517745302713987
2017,1148,6,23,418,1409,0.20689655172413793,-991,0.2287903667214012
2017,1149,9,19,669,1344,0.32142857142857145,-675,0.3323397913561848
2017,1150,12,17,983,1211,0.41379310344827586,-228,0.4480401093892434
2017,1151,17,12,1332,773,0.5862068965517241,559,0.6327790973871734
2017,1152,3,26,227,1585,0.10344827586206896,-1358,0.12527593818984548
2017,1153,29,5,2240,292,0.8529411764705882,1948,0.8846761453396524
2017,1154,9,21,866,1689,0.3,-823,0.33894324853228963
2017,1155,17,15,1340,1059,0.53125,281,0.5585660691954981
2017,1156,8,22,588,1416,0.26666666666666666,-828,0.2934131736526946
2017,1157,14,17,1072,1122,0.45161290322580644,-50,0.4886052871467639
2017,1158,24,9,1714,569,0.7272727272727273,1145,0.750766535260622
2017,1159,9,22,611,1443,0.2903225806451613,-832,0.2974683544303797
2017,1160,18,14,1364,1049,0.5625,315,0.5652714463323664
2017,1161,21,11,1563,727,0.65625,836,0.6825327510917031
2017,1162,10,16,767,1089,0.38461538461538464,-322,0.41325431034482757
2017,1163,15,17,1059,1068,0.46875,-9,0.4978843441466855
2017,1164,7,23,550,1407,0.23333333333333334,-857,0.28104241185487994
2017,1165,7,21,543,1431,0.25,-888,0.2750759878419453
2017,1166,24,9,2043,648,0.7272727272727273,1395,0.7591973244147158
2017,1167,19,9,1398,529,0.6785714285714286,869,0.7254800207576544
2017,1168,15,14,1147,952,0.5172413793103449,195,0.5464506908051453
2017,1169,10,18,812,1338,0.35714285714285715,-526,0.3776744186046512
2017,1170,11,18,875,1166,0.3793103448275862,-291,0.42871141597256246
2017,1171,7,20,527,1285,0.25925925925925924,-758,0.29083885209713023
2017,1172,17,15,1316,1046,0.53125,270,0.5571549534292972
2017,1173,23,7,1809,470,0.7666666666666667,1339,0.7937691970162352
2017,1174,11,20,735,1274,0.3548387096774194,-539,0.36585365853658536
2017,1175,8,22,575,1416,0.26666666666666666,-841,0.2887995981918634
2017,1176,16,14,1220,1055,0.5333333333333333,165,0.5362637362637362
2017,1177,9,23,701,1505,0.28125,-804,0.31776971894832273
2017,1178,7,23,620,1668,0.23333333333333334,-1048,0.270979020979021
2017,1179,6,23,538,1525,0.20689655172413793,-987,0.260785264178381
2017,1180,8,23,649,1664,0.25806451612903225,-1015,0.28058798097708604
2017,1181,27,8,2242,581,0.7714285714285715,1661,0.7941905773999292
2017,1182,10,22,754,1502,0.3125,-748,0.3342198581560284
2017,1183,12,15,911,1074,0.4444444444444444,-163,0.4589420654911839
2017,1184,10,19,792,1243,0.3448275862068966,-451,0.3891891891891892
2017,1185,12,17,999,1174,0.41379310344827586,-175,0.4597330878969167
2017,1186,20,11,1710,731,0.6451612903225806,979,0.7005325686194183
2017,1187,15,18,1074,1014,0.45454545454545453,60,0.514367816091954
2017,1188,5,23,361,1554,0.17857142857142858,-1193,0.18851174934725848
2017,1189,16,14,1231,982,0.5333333333333333,249,0.5562584726615454
2017,1190,25,7,2076,471,0.78125,1605,0.8150765606595995
2017,1191,14,17,1046,1091,0.45161290322580644,-45,0.48947122133832477
2017,1192,10,19,762,1325,0.3448275862068966,-563,0.36511739338763777
2017,1193,16,14,1246,922,0.5333333333333333,324,0.5747232472324724
2017,1194,8,20,622,1311,0.2857142857142857,-689,0.32177961717537507
2017,1195,23,7,1826,467,0.7666666666666667,1359,0.7963366768425644
2017,1196,24,8,1963,542,0.75,1421,0.7836327345309381
2017,1197,5,23,367,1592,0.17857142857142858,-1225,0.18734047983665136
2017,1198,5,24,404,1609,0.1724137931034483,-1205,0.20069547938400398
2017,1199,25,8,2143,578,0.7575757575757576,1565,0.7875780962881294
2017,1200,12,19,835,1154,0.3870967741935484,-319,0.41980894922071393
2017,1201,18,12,1341,858,0.6,483,0.6098226466575716
2017,1202,19,11,1470,711,0.6333333333333333,759,0.6740027510316369
2017,1203,19,14,1391,912,0.5757575757575758,479,0.6039947894051237
2017,1204,16,14,1265,980,0.5333333333333333,285,0.5634743875278396
2017,1205,16,14,1300,946,0.5333333333333333,354,0.578806767586821
2017,1206,19,13,1506,865,0.59375,641,0.6351750316322227
2017,1207,14,18,1144,1225,0.4375,-81,0.48290417897847193
2017,1208,18,14,1325,955,0.5625,370,0.581140350877193
2017,1209,18,12,1417,767,0.6,650,0.6488095238095238
2017,1210,16,15,1168,880,0.5161290322580645,288,0.5703125
2017,1211,32,1,2720,71,0.9696969696969697,2649,0.974561089215335
2017,1212,13,17,957,1094,0.43333333333333335,-137,0.4666016577279376
2017,1213,20,9,1508,589,0.6896551724137931,919,0.7191225560324273
2017,1214,12,16,947,971,0.42857142857142855,-24,0.4937434827945777
2017,1216,9,23,668,1468,0.28125,-800,0.31273408239700373
2017,1217,16,10,1201,663,0.6153846153846154,538,0.64431330472103
2017,1218,13,16,979,977,0.4482758620689655,2,0.5005112474437627
2017,1219,12,16,860,1043,0.42857142857142855,-183,0.45191802417235943
2017,1220,14,17,1116,1268,0.45161290322580644,-152,0.46812080536912754
2017,1221,15,17,992,940,0.46875,52,0.5134575569358178
2017,1222,21,10,1653,630,0.6774193548387096,1023,0.7240473061760841
2017,1223,13,13,1048,905,0.5,143,0.536610343061956
2017,1224,8,24,603,1418,0.25,-815,0.2983671449777338
2017,1225,16,13,1270,837,0.5517241379310345,433,0.6027527289985761
2017,1226,4,26,335,1753,0.13333333333333333,-1418,0.16044061302681992
2017,1227,13,18,1041,1286,0.41935483870967744,-245,0.4473571121615814
2017,1228,17,14,1314,871,0.5483870967741935,443,0.6013729977116705
2017,1229,26,6,1827,363,0.8125,1464,0.8342465753424657
2017,1230,8,17,647,1220,0.32,-573,0.3465452597750402
2017,1231,18,15,1616,1032,0.5454545454545454,584,0.6102719033232629
2017,1232,10,20,740,1334,0.3333333333333333,-594,0.35679845708775315
2017,1233,22,12,1829,907,0.6470588235294118,922,0.6684941520467836
2017,1234,18,14,1531,1028,0.5625,503,0.5982805783509183
2017,1235,23,10,1977,692,0.696969696969697,1285,0.7407268639940052
2017,1236,16,12,1458,922,0.5714285714285714,536,0.6126050420168068
2017,1237,12,18,1016,1294,0.4,-278,0.43982683982683984
2017,1238,12,17,839,1018,0.41379310344827586,-179,0.4518039849219171
2017,1239,13,15,1069,1017,0.4642857142857143,52,0.512464046021093
2017,1240,18,14,1294,915,0.5625,379,0.5857854232684473
2017,1241,9,23,653,1459,0.28125,-806,0.3091856060606061
2017,1242,28,4,2308,339,0.875,1969,0.8719304873441632
2017,1243,20,13,1490,877,0.6060606060606061,613,0.6294888043937473
2017,1244,12,18,930,1302,0.4,-372,0.4166666666666667
2017,1245,21,13,1657,924,0.6176470588235294,733,0.6419992251065478
2017,1246,29,5,2541,381,0.8529411764705882,2160,0.8696098562628337
2017,1247,15,15,1241,1025,0.5,216,0.5476610767872904
2017,1248,8,21,596,1295,0.27586206896551724,-699,0.31517715494447385
2017,1249,15,14,1224,924,0.5172413793103449,300,0.5698324022346368
2017,1250,19,12,1505,834,0.6129032258064516,671,0.6434373663958957
2017,1251,16,13,1148,752,0.5517241379310345,396,0.6042105263157894
2017,1252,17,13,1505,978,0.5666666666666667,527,0.6061216270640355
2017,1253,13,19,978,1379,0.40625,-401,0.41493423843869326
2017,1254,19,12,1404,796,0.6129032258064516,608,0.6381818181818182
2017,1255,4,24,304,1541,0.14285714285714285,-1237,0.16476964769647698
2017,1256,21,10,1676,707,0.6774193548387096,969,0.7033151489718842
2017,1257,24,8,1951,530,0.75,1421,0.7863764611043934
2017,1258,14,15,1016,998,0.4827586206896552,18,0.5044687189672294
2017,1259,14,16,1024,936,0.4666666666666667,88,0.5224489795918368
2017,1260,16,14,1199,952,0.5333333333333333,247,0.5574151557415156
2017,1261,10,21,810,1509,0.3225806451612903,-699,0.34928848641655885
2017,1262,10,20,819,1513,0.3333333333333333,-694,0.35120068610634647
2017,1263,6,25,405,1568,0.1935483870967742,-1163,0.20527116066903192
2017,1264,10,22,753,1506,0.3125,-753,0.3333333333333333
2017,1265,8,24,661,1562,0.25,-901,0.29734592892487627
2017,1266,19,12,1689,869,0.6129032258064516,820,0.6602814698983581
2017,1267,19,15,1716,1200,0.5588235294117647,516,0.588477366255144
2017,1268,23,8,1752,528,0.7419354838709677,1224,0.7684210526315789
2017,1269,15,18,1114,1257,0.45454545454545453,-143,0.4698439477013918
2017,1270,5,21,387,1405,0.19230769230769232,-1018,0.21595982142857142
2017,1271,12,20,971,1278,0.375,-307,0.43174744330813697
2017,1272,19,13,1527,840,0.59375,687,0.6451204055766794
2017,1273,13,17,960,1124,0.43333333333333335,-164,0.46065259117082535
2017,1274,21,11,1560,660,0.65625,900,0.7027027027027027
2017,1275,9,21,676,1400,0.3,-724,0.325626204238921
2017,1276,24,11,1861,757,0.6857142857142857,1104,0.7108479755538579
2017,1277,19,14,1470,897,0.5757575757575758,573,0.6210392902408112
2017,1278,24,9,1894,590,0.7272727272727273,1304,0.7624798711755234
2017,1279,20,13,1685,880,0.6060606060606061,805,0.6569200779727096
2017,1280,16,16,1254,1066,0.5,188,0.5405172413793103
2017,1281,8,24,631,1582,0.25,-951,0.2851333032083145
2017,1282,14,16,1156,1099,0.4666666666666667,57,0.5126385809312639
2017,1283,16,16,1203,1100,0.5,103,0.5223621363438993
2017,1284,27,6,2249,429,0.8181818181818182,1820,0.8398058252427184
2017,1285,16,16,1234,1157,0.5,77,0.5161020493517356
2017,1286,14,16,1127,1248,0.4666666666666667,-121,0.4745263157894737
2017,1287,12,16,1016,1128,0.42857142857142855,-112,0.47388059701492535
2017,1288,13,16,964,973,0.4482758620689655,-9,0.4976768198244708
2017,1290,7,25,570,1665,0.21875,-1095,0.2550335570469799
2017,1291,19,15,1387,936,0.5588235294117647,451,0.5970727507533362
2017,1292,29,4,2199,250,0.8787878787878788,1949,0.897917517354022
2017,1293,14,17,1187,1250,0.45161290322580644,-63,0.48707427164546574
2017,1294,9,18,716,1168,0.3333333333333333,-452,0.38004246284501064
2017,1295,17,11,1387,682,0.6071428571428571,705,0.6703721604639923
2017,1296,12,17,890,1149,0.41379310344827586,-259,0.43648847474252084
2017,1297,22,10,1729,667,0.6875,1062,0.7216193656093489
2017,1298,15,16,1074,928,0.4838709677419355,146,0.5364635364635365
2017,1299,1,29,68,1835,0.03333333333333333,-1767,0.03573305307409354
2017,1300,22,8,1675,525,0.7333333333333333,1150,0.7613636363636364
2017,1301,15,17,1270,1213,0.46875,57,0.5114780507450665
2017,1303,17,14,1504,1069,0.5483870967741935,435,0.5845316750874465
2017,1304,11,19,852,1246,0.36666666666666664,-394,0.40610104861773116
2017,1305,28,6,2318,401,0.8235294117647058,1917,0.852519308569327
2017,1306,17,12,1268,740,0.5862068965517241,528,0.6314741035856574
2017,1307,17,14,1337,946,0.5483870967741935,391,0.5856329391151993
2017,1308,25,5,2007,316,0.8333333333333334,1691,0.8639690055962118
2017,1309,17,11,1263,718,0.6071428571428571,545,0.6375567895002524
2017,1310,10,23,788,1660,0.30303030303030304,-872,0.32189542483660133
2017,1311,10,17,813,1151,0.37037037037037035,-338,0.4139511201629328
2017,1312,9,20,674,1387,0.3103448275862069,-713,0.3270257156720039
2017,1313,15,16,1175,966,0.4838709677419355,209,0.5488089677720691
2017,1314,26,7,2287,496,0.7878787878787878,1791,0.8217750628817823
2017,1315,19,9,1584,619,0.6785714285714286,965,0.7190195188379482
2017,1316,11,19,926,1278,0.36666666666666664,-352,0.42014519056261346
2017,1317,6,22,458,1459,0.21428571428571427,-1001,0.2389149713093375
2017,1318,15,16,1157,1077,0.4838709677419355,80,0.517905102954342
2017,1319,8,23,579,1547,0.25806451612903225,-968,0.27234242709313267
2017,1320,13,16,893,887,0.4482758620689655,6,0.501685393258427
2017,1321,23,11,1756,661,0.6764705882352942,1095,0.7265204799338022
2017,1322,9,16,728,1128,0.36,-400,0.3922413793103448
2017,1323,25,9,2028,624,0.7352941176470589,1404,0.7647058823529411
2017,1324,22,8,1795,574,0.7333333333333333,1221,0.7577036724356269
2017,1325,19,11,1504,806,0.6333333333333333,698,0.651082251082251
2017,1326,17,15,1275,1054,0.53125,221,0.5474452554744526
2017,1328,11,20,904,1358,0.3548387096774194,-454,0.39964633068081346
2017,1329,19,12,1706,930,0.6129032258064516,776,0.6471927162367223
2017,1330,19,12,1268,730,0.6129032258064516,538,0.6346346346346347
2017,1331,6,22,511,1559,0.21428571428571427,-1048,0.24685990338164251
2017,1332,28,5,2262,334,0.8484848484848485,1928,0.8713405238828967
2017,1333,4,27,287,1650,0.12903225806451613,-1363,0.1481672689726381
2017,1334,10,22,719,1385,0.3125,-666,0.3417300380228137
2017,1335,13,15,982,946,0.4642857142857143,36,0.5093360995850622
2017,1336,15,18,1124,1243,0.45454545454545453,-119,0.4748626953950148
2017,1337,8,22,607,1448,0.26666666666666666,-841,0.2953771289537713
2017,1338,16,17,1340,1064,0.48484848484848486,276,0.5574043261231281
2017,1339,9,22,687,1334,0.2903225806451613,-647,0.33993072736269175
2017,1340,12,16,1026,1278,0.42857142857142855,-252,0.4453125
2017,1341,11,20,838,1267,0.3548387096774194,-429,0.3980997624703088
2017,1342,3,25,221,1418,0.10714285714285714,-1197,0.13483831604636973
2017,1343,22,6,1564,419,0.7857142857142857,1145,0.7887039838628341
2017,1344,20,12,1479,769,0.625,710,0.6579181494661922
2017,1345,25,7,2044,520,0.78125,1524,0.797191887675507
2017,1346,10,21,857,1520,0.3225806451612903,-663,0.3605384938998738
2017,1347,12,18,874,1043,0.4,-169,0.4559207094418362
2017,1348,24,9,1839,582,0.7272727272727273,1257,0.7596034696406444
2017,1349,20,11,1719,794,0.6451612903225806,925,0.6840429765220851
2017,1350,20,12,1518,852,0.625,666,0.640506329113924
2017,1351,18,15,1483,1015,0.5454545454545454,468,0.5936749399519615
2017,1352,14,19,975,1150,0.42424242424242425,-175,0.4588235294117647
2017,1353,14,18,1009,1068,0.4375,-59,0.48579682233991334
2017,1354,9,20,679,1305,0.3103448275862069,-626,0.34223790322580644
2017,1355,16,16,1321,1146,0.5,175,0.535468179975679
2017,1356,16,16,1234,941,0.5,293,0.5673563218390805
2017,1357,13,19,1056,1270,0.40625,-214,0.45399828030954426
2017,1358,17,13,1285,849,0.5666666666666667,436,0.6021555763823805
2017,1359,17,15,1337,1175,0.53125,162,0.5322452229299363
2017,1360,12,18,931,989,0.4,-58,0.48489583333333336
2017,1361,18,14,1303,876,0.5625,427,0.5979807251032584
2017,1362,19,12,1435,760,0.6129032258064516,675,0.6537585421412301
2017,1363,12,16,917,1060,0.42857142857142855,-143,0.46383409205867476
2017,1364,5,22,301,1325,0.18518518518518517,-1024,0.18511685116851168
2017,1365,16,16,1194,935,0.5,259,0.5608266791921089
2017,1366,11,16,983,1283,0.4074074074074074,-300,0.43380406001765226
2017,1367,13,15,1038,1106,0.4642857142857143,-68,0.4841417910447761
2017,1368,14,16,1075,1019,0.4666666666666667,56,0.5133715377268386
2017,1369,13,18,1048,1237,0.41935483870967744,-189,0.4586433260393873
2017,1370,10,17,795,1048,0.37037037037037035,-253,0.43136190992946283
2017,1371,21,11,1633,713,0.65625,920,0.696078431372549
2017,1372,15,14,1084,897,0.5172413793103449,187,0.547198384654215
2017,1373,17,17,1331,1218,0.5,113,0.5221655551196548
2017,1374,30,4,2281,253,0.8823529411764706,2028,0.9001578531965272
2017,1375,12,18,906,1221,0.4,-315,0.42595204513399154
2017,1376,21,10,1556,660,0.6774193548387096,896,0.7021660649819494
2017,1377,20,11,1605,780,0.6451612903225806,825,0.6729559748427673
2017,1378,7,23,529,1416,0.23333333333333334,-887,0.27197943444730077
2017,1379,7,22,524,1267,0.2413793103448276,-743,0.2925739810161921
2017,1380,13,17,986,1133,0.43333333333333335,-147,0.4653138272770175
2017,1381,4,27,364,1986,0.12903225806451613,-1622,0.1548936170212766
2017,1382,20,12,1608,851,0.625,757,0.65392435949573
2017,1383,3,27,263,1589,0.1,-1326,0.1420086393088553
2017,1384,15,16,1189,1112,0.4838709677419355,77,0.5167318557149065
2017,1385,14,19,1179,1355,0.42424242424242425,-176,0.4652722967640095
2017,1386,11,20,825,1330,0.3548387096774194,-505,0.382830626450116
2017,1387,12,21,860,1166,0.36363636363636365,-306,0.4244817374136229
2017,1388,28,4,2077,227,0.875,1850,0.9014756944444444
2017,1389,19,13,1375,754,0.59375,621,0.6458431188351339
2017,1390,13,17,971,1112,0.43333333333333335,-141,0.46615458473355736
2017,1391,8,21,676,1521,0.27586206896551724,-845,0.3076923076923077
2017,1392,18,13,1334,812,0.5806451612903226,522,0.6216216216216216
2017,1393,18,14,1508,916,0.5625,592,0.6221122112211221
2017,1394,17,11,1357,702,0.6071428571428571,655,0.6590577950461389
2017,1395,18,15,1419,1011,0.5454545454545454,408,0.5839506172839506
2017,1396,16,16,1280,989,0.5,291,0.5641251652710445
2017,1397,15,16,1226,1062,0.4838709677419355,164,0.5358391608391608
2017,1398,15,13,1056,901,0.5357142857142857,155,0.5396014307613695
2017,1399,10,20,798,1341,0.3333333333333333,-543,0.37307152875175315
2017,1400,11,22,843,1372,0.3333333333333333,-529,0.3805869074492099
2017,1401,16,15,1234,942,0.5161290322580645,292,0.5670955882352942
2017,1402,18,13,1253,814,0.5806451612903226,439,0.606192549588776
2017,1403,18,14,1442,904,0.5625,538,0.6146632566069906
2017,1404,19,12,1514,831,0.6129032258064516,683,0.6456289978678038
2017,1405,16,16,1297,1211,0.5,86,0.5171451355661882
2017,1406,19,13,1509,839,0.59375,670,0.6426746166950597
2017,1407,20,14,1596,979,0.5882352941176471,617,0.6198058252427184
2017,1408,6,25,505,1674,0.1935483870967742,-1169,0.231757687012391
2017,1409,15,17,1128,1030,0.46875,98,0.5227062094531975
2017,1410,7,22,605,1621,0.2413793103448276,-1016,0.27178796046720577
2017,1411,23,11,1759,770,0.6764705882352942,989,0.6955318307631475
2017,1412,16,16,1264,1007,0.5,257,0.5565830030823425
2017,1413,20,12,1453,767,0.625,686,0.6545045045045045
2017,1414,19,14,1405,857,0.5757575757575758,548,0.621131741821397
2017,1415,6,21,410,1308,0.2222222222222222,-898,0.23864959254947612
2017,1416,21,11,1510,641,0.65625,869,0.701999070199907
2017,1417,29,4,2659,323,0.8787878787878788,2336,0.891683433936955
2017,1418,19,12,1587,906,0.6129032258064516,681,0.6365824308062575
2017,1419,7,24,527,1503,0.22580645161290322,-976,0.2596059113300493
2017,1420,16,12,1400,853,0.5714285714285714,547,0.6213936972924989
2017,1421,21,9,1661,623,0.7,1038,0.7272329246935202
2017,1422,22,9,1673,584,0.7096774193548387,1089,0.741249446167479
2017,1423,27,5,2304,356,0.84375,1948,0.8661654135338346
2017,1424,11,21,886,1316,0.34375,-430,0.40236148955495005
2017,1425,24,9,1960,637,0.7272727272727273,1323,0.7547169811320755
2017,1426,23,8,1802,563,0.7419354838709677,1239,0.7619450317124735
2017,1427,12,19,796,1215,0.3870967741935484,-419,0.3958229736449528
2017,1428,18,11,1494,772,0.6206896551724138,722,0.6593115622241836
2017,1429,13,17,1057,1100,0.43333333333333335,-43,0.4900324524802967
2017,1430,12,16,995,1133,0.42857142857142855,-138,0.4675751879699248
2017,1431,14,17,1055,1074,0.45161290322580644,-19,0.49553781117895723
2017,1433,26,8,2033,506,0.7647058823529411,1527,0.8007089405277669
2017,1434,23,8,1797,522,0.7419354838709677,1275,0.7749029754204398
2017,1435,19,15,1446,977,0.5588235294117647,469,0.5967808501857201
2017,1436,28,5,2117,305,0.8484848484848485,1812,0.8740710156895128
2017,1437,31,3,2445,196,0.9117647058823529,2249,0.9257856872396819
2017,1438,22,10,1539,592,0.6875,947,0.7221961520412952
2017,1439,22,10,1814,722,0.6875,1092,0.7152996845425867
2017,1440,4,24,348,1559,0.14285714285714285,-1211,0.1824855794441531
2017,1441,7,23,519,1272,0.23333333333333334,-753,0.2897822445561139
2017,1442,6,20,477,1349,0.23076923076923078,-872,0.2612267250821468
2017,1443,15,17,1130,1079,0.46875,51,0.5115436849253056
2017,1444,15,16,1195,1132,0.4838709677419355,63,0.5135367425870219
2017,1447,15,14,1037,916,0.5172413793103449,121,0.5309779825908858
2017,1448,19,13,1649,996,0.59375,653,0.6234404536862004
2017,1449,9,22,811,1557,0.2903225806451613,-746,0.3424831081081081
2017,1450,12,18,944,1154,0.4,-210,0.449952335557674
2017,1451,17,13,1430,896,0.5666666666666667,534,0.6147893379191746
2017,1452,26,8,2181,606,0.7647058823529411,1575,0.7825618945102261
2017,1453,16,13,1337,954,0.5517241379310345,383,0.5835879528590135
2017,1454,10,24,709,1550,0.29411764705882354,-841,0.3138556883576804
2017,1455,29,4,2441,262,0.8787878787878788,2179,0.903070662227155
2017,1456,15,14,1309,1016,0.5172413793103449,293,0.563010752688172
2017,1457,24,6,1905,474,0.8,1431,0.8007566204287516
2017,1458,25,9,1891,555,0.7352941176470589,1336,0.7730989370400654
2017,1459,13,17,1126,1155,0.43333333333333335,-29,0.49364313897413414
2017,1460,18,12,1446,825,0.6,621,0.6367239101717305
2017,1461,16,14,1305,1019,0.5333333333333333,286,0.5615318416523236
2017,1462,21,13,1653,884,0.6176470588235294,769,0.6515569570358691
2017,1463,17,11,1374,675,0.6071428571428571,699,0.6705710102489019
2017,1464,11,21,917,1515,0.34375,-598,0.3770559210526316
2017,3101,19,8,1460,454,0.7037037037037037,1006,0.7628004179728317
2017,3102,4,25,246,1305,0.13793103448275862,-1059,0.15860735009671179
2017,3103,7,21,534,1212,0.25,-678,0.30584192439862545
2017,3104,19,13,1461,718,0.59375,743,0.6704910509407985
2017,3106,13,16,900,810,0.4482758620689655,90,0.5263157894736842
2017,3107,20,11,1411,635,0.6451612903225806,776,0.6896383186705768
2017,3108,9,21,626,1116,0.3,-490,0.3593570608495982
2017,3110,15,16,1008,877,0.4838709677419355,131,0.5347480106100796
2017,3111,12,19,882,1066,0.3870967741935484,-184,0.4527720739219713
2017,3112,14,16,1004,916,0.4666666666666667,88,0.5229166666666667
2017,3113,19,12,1304,662,0.6129032258064516,642,0.6632756866734486
2017,3114,24,8,1596,380,0.75,1216,0.8076923076923077
2017,3115,10,18,617,920,0.35714285714285715,-303,0.4014313597918022
2017,3116,13,17,957,967,0.43333333333333335,-10,0.4974012474012474
2017,3117,7,25,460,1478,0.21875,-1018,0.23735810113519093
2017,3119,21,9,1450,526,0.7,924,0.7338056680161943
2017,3120,17,14,1154,796,0.5483870967741935,358,0.5917948717948718
2017,3122,12,16,914,951,0.42857142857142855,-37,0.4900804289544236
2017,3123,20,10,1563,673,0.6666666666666666,890,0.6990161001788909
2017,3124,30,3,2719,206,0.9090909090909091,2513,0.9295726495726496
2017,3125,26,5,2099,304,0.8387096774193549,1795,0.873491468997087
2017,3126,19,10,1198,555,0.6551724137931034,643,0.6833998859098688
2017,3127,11,17,711,996,0.39285714285714285,-285,0.4165202108963093
2017,3129,23,7,1606,444,0.7666666666666667,1162,0.7834146341463415
2017,3130,9,21,611,1171,0.3,-560,0.34287317620650953
2017,3131,13,17,870,919,0.43333333333333335,-49,0.48630519843487985
2017,3132,6,22,415,1306,0.21428571428571427,-891,0.2411388727484021
2017,3133,11,19,708,1077,0.36666666666666664,-369,0.39663865546218485
2017,3135,15,12,1132,782,0.5555555555555556,350,0.5914315569487983
2017,3136,18,14,1189,756,0.5625,433,0.6113110539845759
2017,3137,27,5,1904,259,0.84375,1645,0.8802588996763754
2017,3138,22,10,1504,668,0.6875,836,0.6924493554327809
2017,3139,6,25,406,1385,0.1935483870967742,-979,0.2266890005583473
2017,3140,20,11,1436,657,0.6451612903225806,779,0.6860965121834687
2017,3141,23,8,1938,488,0.7419354838709677,1450,0.798845836768343
2017,3142,11,18,786,1169,0.3793103448275862,-383,0.4020460358056266
2017,3143,19,13,1456,780,0.59375,676,0.6511627906976745
2017,3144,18,9,1093,455,0.6666666666666666,638,0.7060723514211886
2017,3145,10,21,648,1188,0.3225806451612903,-540,0.35294117647058826
2017,3146,22,4,1497,226,0.8461538461538461,1271,0.8688334300638422
2017,3148,11,20,756,1160,0.3548387096774194,-404,0.3945720250521921
2017,3149,15,13,946,720,0.5357142857142857,226,0.5678271308523409
2017,3150,21,10,1635,646,0.6774193548387096,989,0.7167908811924595
2017,3151,21,10,1411,554,0.6774193548387096,857,0.7180661577608143
2017,3153,15,14,1051,768,0.5172413793103449,283,0.5777899945024739
2017,3155,15,16,988,843,0.4838709677419355,145,0.539595849262698
2017,3156,13,15,897,955,0.4642857142857143,-58,0.484341252699784
2017,3157,12,15,797,874,0.4444444444444444,-77,0.47695990424895274
2017,3158,9,21,665,1267,0.3,-602,0.3442028985507246
2017,3159,10,20,743,1269,0.3333333333333333,-526,0.36928429423459247
2017,3160,15,15,1157,909,0.5,248,0.5600193610842207
2017,3161,22,8,1459,441,0.7333333333333333,1018,0.7678947368421053
2017,3162,13,14,930,802,0.48148148148148145,128,0.5369515011547344
2017,3163,32,0,2772,0,1.0,2772,1.0
2017,3164,8,21,523,1053,0.27586206896551724,-530,0.33185279187817257
2017,3165,16,11,1065,614,0.5925925925925926,451,0.6343061346039309
2017,3166,23,7,1571,408,0.7666666666666667,1163,0.7938352703385548
2017,3167,13,14,885,807,0.48148148148148145,78,0.5230496453900709
2017,3168,2,25,136,1328,0.07407407407407407,-1192,0.09289617486338798
2017,3169,18,14,1310,811,0.5625,499,0.6176331918906176
2017,3170,9,20,794,1575,0.3103448275862069,-781,0.33516251582946394
2017,3171,8,19,540,1051,0.2962962962962963,-511,0.33940917661847897
2017,3172,6,23,400,1264,0.20689655172413793,-864,0.2403846153846154
2017,3173,22,9,1533,516,0.7096774193548387,1017,0.7481698389458272
2017,3174,16,14,1016,697,0.5333333333333333,319,0.5931115002918855
2017,3175,3,27,188,1530,0.1,-1342,0.10942956926658906
2017,3176,6,24,420,1448,0.2,-1028,0.22483940042826553
2017,3177,26,7,2152,513,0.7878787878787878,1639,0.8075046904315197
2017,3178,18,14,1360,896,0.5625,464,0.6028368794326241
2017,3179,27,4,2268,272,0.8709677419354839,1996,0.8929133858267716
2017,3180,21,10,1431,611,0.6774193548387096,820,0.7007835455435847
2017,3181,27,5,2058,289,0.84375,1769,0.8768640818065616
2017,3182,18,15,1281,878,0.5454545454545454,403,0.5933302454840204
2017,3183,7,19,493,1177,0.2692307692307692,-684,0.2952095808383233
2017,3184,11,20,783,1198,0.3548387096774194,-415,0.3952549217566885
2017,3185,5,25,356,1484,0.16666666666666666,-1128,0.1934782608695652
2017,3186,17,13,1211,789,0.5666666666666667,422,0.6055
2017,3187,10,19,701,1053,0.3448275862068966,-352,0.3996579247434436
2017,3188,13,17,946,1126,0.43333333333333335,-180,0.45656370656370654
2017,3189,26,6,1862,382,0.8125,1480,0.8297682709447415
2017,3190,16,14,1127,823,0.5333333333333333,304,0.5779487179487179
2017,3191,13,17,875,937,0.43333333333333335,-62,0.4828918322295806
2017,3192,8,21,525,1201,0.27586206896551724,-676,0.3041714947856315
2017,3193,17,14,1069,735,0.5483870967741935,334,0.5925720620842572
2017,3194,3,25,200,1546,0.10714285714285714,-1346,0.1145475372279496
2017,3195,24,8,1774,509,0.75,1265,0.777047744196233
2017,3196,15,16,1143,1048,0.4838709677419355,95,0.5216795983569147
2017,3197,11,19,707,1015,0.36666666666666664,-308,0.4105691056910569
2017,3198,5,24,344,1258,0.1724137931034483,-914,0.21473158551810237
2017,3199,25,6,2079,391,0.8064516129032258,1688,0.8417004048582996
2017,3200,21,11,1368,546,0.65625,822,0.7147335423197492
2017,3201,16,15,1025,814,0.5161290322580645,211,0.5573681348559
2017,3202,11,17,708,969,0.39285714285714285,-261,0.4221824686940966
2017,3203,20,9,1391,524,0.6896551724137931,867,0.7263707571801566
2017,3204,12,17,797,941,0.41379310344827586,-144,0.45857307249712315
2017,3205,9,19,664,1058,0.32142857142857145,-394,0.38559814169570267
2017,3206,13,17,817,1000,0.43333333333333335,-183,0.449642267473858
2017,3207,17,12,1183,756,0.5862068965517241,427,0.6101083032490975
2017,3208,16,15,1108,817,0.5161290322580645,291,0.5755844155844155
2017,3209,11,18,712,1034,0.3793103448275862,-322,0.40778923253150057
2017,3210,17,14,1222,892,0.5483870967741935,330,0.5780510879848628
2017,3211,26,6,1911,402,0.8125,1509,0.8261997405966277
2017,3212,18,14,1288,798,0.5625,490,0.6174496644295302
2017,3213,14,12,980,696,0.5384615384615384,284,0.5847255369928401
2017,3214,20,12,1337,628,0.625,709,0.6804071246819339
2017,3216,17,14,1230,842,0.5483870967741935,388,0.5936293436293436
2017,3217,20,8,1343,445,0.7142857142857143,898,0.7511185682326622
2017,3218,11,18,736,952,0.3793103448275862,-216,0.43601895734597157
2017,3219,13,15,1006,877,0.4642857142857143,129,0.5342538502389803
2017,3220,13,18,895,1013,0.41935483870967744,-118,0.4690775681341719
2017,3221,8,22,478,1214,0.26666666666666666,-736,0.28250591016548465
2017,3222,12,19,857,1039,0.3870967741935484,-182,0.4520042194092827
2017,3223,4,22,257,1129,0.15384615384615385,-872,0.18542568542568544
2017,3224,16,13,1151,729,0.5517241379310345,422,0.6122340425531915
2017,3225,15,14,1199,870,0.5172413793103449,329,0.5795070082165297
2017,3226,18,14,1147,779,0.5625,368,0.5955347871235722
2017,3227,4,25,279,1346,0.13793103448275862,-1067,0.1716923076923077
2017,3228,9,22,667,1268,0.2903225806451613,-601,0.344702842377261
2017,3229,8,23,506,1174,0.25806451612903225,-668,0.3011904761904762
2017,3230,7,20,542,1140,0.25925925925925924,-598,0.3222354340071344
2017,3231,20,10,1610,674,0.6666666666666666,936,0.7049036777583187
2017,3232,12,18,768,886,0.4,-118,0.46432889963724305
2017,3233,18,13,1098,738,0.5806451612903226,360,0.5980392156862745
2017,3234,17,13,1367,902,0.5666666666666667,465,0.6024680475980608
2017,3235,18,12,1450,774,0.6,676,0.6519784172661871
2017,3236,4,23,266,1235,0.14814814814814814,-969,0.17721518987341772
2017,3237,22,8,1496,468,0.7333333333333333,1028,0.7617107942973523
2017,3238,8,16,578,973,0.3333333333333333,-395,0.3726627981947131
2017,3239,20,8,1415,414,0.7142857142857143,1001,0.7736468015308912
2017,3240,12,15,792,935,0.4444444444444444,-143,0.4585987261146497
2017,3241,24,8,1760,490,0.75,1270,0.7822222222222223
2017,3242,8,22,578,1281,0.26666666666666666,-703,0.31091984938138784
2017,3243,22,10,1558,621,0.6875,937,0.7150068838916934
2017,3244,10,20,713,1021,0.3333333333333333,-308,0.41118800461361016
2017,3245,19,12,1452,761,0.6129032258064516,691,0.6561229100768188
2017,3246,21,10,1510,688,0.6774193548387096,822,0.6869881710646042
2017,3247,17,13,1098,778,0.5666666666666667,320,0.5852878464818764
2017,3248,4,28,289,1455,0.125,-1166,0.16571100917431192
2017,3249,18,7,1358,406,0.72,952,0.7698412698412699
2017,3250,9,20,691,1127,0.3103448275862069,-436,0.38008800880088006
2017,3251,12,17,848,971,0.41379310344827586,-123,0.46619021440351843
2017,3252,5,24,359,1340,0.1724137931034483,-981,0.2113007651559741
2017,3253,22,10,1510,607,0.6875,903,0.7132735002361833
2017,3254,6,23,383,1154,0.20689655172413793,-771,0.24918672739102146
2017,3255,3,25,243,1280,0.10714285714285714,-1037,0.15955351280367697
2017,3256,17,13,1197,816,0.5666666666666667,381,0.5946348733233979
2017,3257,27,7,2079,460,0.7941176470588235,1619,0.8188263095706971
2017,3258,14,16,955,1026,0.4666666666666667,-71,0.48207975769813227
2017,3259,11,20,760,1098,0.3548387096774194,-338,0.40904198062432723
2017,3260,2,28,123,1309,0.06666666666666667,-1186,0.08589385474860335
2017,3261,20,11,1367,611,0.6451612903225806,756,0.6911021233569262
2017,3262,2,26,143,1387,0.07142857142857142,-1244,0.0934640522875817
2017,3263,18,16,1194,841,0.5294117647058824,353,0.5867321867321867
2017,3264,8,22,505,1143,0.26666666666666666,-638,0.30643203883495146
2017,3265,15,17,1056,916,0.46875,140,0.5354969574036511
2017,3266,25,7,2072,465,0.78125,1607,0.816712652739456
2017,3267,11,17,776,1161,0.39285714285714285,-385,0.40061951471347446
2017,3268,30,2,2708,168,0.9375,2540,0.9415855354659249
2017,3269,8,21,546,1090,0.27586206896551724,-544,0.33374083129584353
2017,3270,10,17,724,1085,0.37037037037037035,-361,0.4002211166390271
2017,3271,12,16,818,870,0.42857142857142855,-52,0.48459715639810425
2017,3272,14,16,898,854,0.4666666666666667,44,0.5125570776255708
2017,3273,22,6,1486,319,0.7857142857142857,1167,0.8232686980609418
2017,3274,23,8,1752,487,0.7419354838709677,1265,0.7824921840107191
2017,3275,9,21,613,1210,0.3,-597,0.3362589138782227
2017,3276,22,9,1805,609,0.7096774193548387,1196,0.747721623860812
2017,3277,21,11,1619,741,0.65625,878,0.6860169491525424
2017,3278,15,16,1223,1063,0.4838709677419355,160,0.5349956255468067
2017,3279,17,13,1264,756,0.5666666666666667,508,0.6257425742574257
2017,3280,29,4,2220,249,0.8787878787878788,1971,0.8991494532199271
2017,3281,21,10,1468,600,0.6774193548387096,868,0.7098646034816247
2017,3282,8,19,544,1089,0.2962962962962963,-545,0.3331292100428659
2017,3283,15,14,1033,844,0.5172413793103449,189,0.5503462972828982
2017,3284,15,16,1011,1002,0.4838709677419355,9,0.5022354694485842
2017,3285,5,23,324,1201,0.17857142857142858,-877,0.2124590163934426
2017,3286,23,6,1735,364,0.7931034482758621,1371,0.8265840876607908
2017,3287,19,9,1448,544,0.6785714285714286,904,0.7269076305220884
2017,3288,8,21,518,1012,0.27586206896551724,-494,0.338562091503268
2017,3290,8,20,517,1090,0.2857142857142857,-573,0.32171748599875544
2017,3291,12,18,778,985,0.4,-207,0.44129325014180376
2017,3292,21,10,1612,572,0.6774193548387096,1040,0.7380952380952381
2017,3293,13,14,995,937,0.48148148148148145,58,0.5150103519668737
2017,3294,21,8,1560,471,0.7241379310344828,1089,0.7680945347119645
2017,3295,4,24,304,1437,0.14285714285714285,-1133,0.1746122917863297
2017,3296,21,11,1845,879,0.65625,966,0.6773127753303965
2017,3297,8,22,556,1108,0.26666666666666666,-552,0.33413461538461536
2017,3298,22,9,1494,549,0.7096774193548387,945,0.7312775330396476
2017,3299,12,18,839,961,0.4,-122,0.4661111111111111
2017,3300,7,20,414,924,0.25925925925925924,-510,0.3094170403587444
2017,3301,22,8,1626,510,0.7333333333333333,1116,0.7612359550561798
2017,3303,14,15,1086,874,0.4827586206896552,212,0.5540816326530612
2017,3304,7,22,487,1333,0.2413793103448276,-846,0.2675824175824176
2017,3305,10,19,768,1174,0.3448275862068966,-406,0.39546858908341914
2017,3306,25,5,1584,264,0.8333333333333334,1320,0.8571428571428571
2017,3307,14,15,1053,873,0.4827586206896552,180,0.5467289719626168
2017,3308,22,6,1598,310,0.7857142857142857,1288,0.8375262054507338
2017,3309,11,15,871,923,0.4230769230769231,-52,0.4855072463768116
2017,3310,8,22,539,1269,0.26666666666666666,-730,0.2981194690265487
2017,3311,10,20,768,1253,0.3333333333333333,-485,0.380009896091044
2017,3312,9,19,588,943,0.32142857142857145,-355,0.3840627041149575
2017,3313,13,15,902,817,0.4642857142857143,85,0.5247236765561373
2017,3314,15,16,1208,1029,0.4838709677419355,179,0.5400089405453733
2017,3315,18,10,1335,688,0.6428571428571429,647,0.6599110232328226
2017,3316,7,20,519,1044,0.25925925925925924,-525,0.33205374280230326
2017,3317,12,19,835,1040,0.3870967741935484,-205,0.44533333333333336
2017,3318,12,19,786,1028,0.3870967741935484,-242,0.43329658213891953
2017,3319,8,21,594,1385,0.27586206896551724,-791,0.30015159171298633
2017,3320,23,8,1591,478,0.7419354838709677,1113,0.7689705171580473
2017,3321,20,11,1449,671,0.6451612903225806,778,0.6834905660377358
2017,3322,9,17,714,902,0.34615384615384615,-188,0.44183168316831684
2017,3323,30,3,2430,192,0.9090909090909091,2238,0.9267734553775744
2017,3324,16,12,1323,750,0.5714285714285714,573,0.638205499276411
2017,3325,22,9,1578,573,0.7096774193548387,1005,0.7336122733612274
2017,3326,26,6,2336,435,0.8125,1901,0.8430169613857813
2017,3328,22,9,1683,601,0.7096774193548387,1082,0.7368651488616462
2017,3329,17,14,1276,786,0.5483870967741935,490,0.6188166828322017
2017,3330,17,14,1290,912,0.5483870967741935,378,0.5858310626702997
2017,3331,13,15,944,797,0.4642857142857143,147,0.5422171165996553
2017,3332,20,13,1566,782,0.6060606060606061,784,0.6669505962521295
2017,3333,29,4,1968,222,0.8787878787878788,1746,0.8986301369863013
2017,3334,8,21,639,1296,0.27586206896551724,-657,0.3302325581395349
2017,3335,21,7,1327,361,0.75,966,0.7861374407582938
2017,3336,19,10,1497,629,0.6551724137931034,868,0.7041392285983067
2017,3337,7,23,462,1362,0.23333333333333334,-900,0.2532894736842105
2017,3338,12,17,817,915,0.41379310344827586,-98,0.47170900692840645
2017,3339,5,24,374,1307,0.1724137931034483,-933,0.22248661511005355
2017,3340,15,17,1121,1055,0.46875,66,0.5151654411764706
2017,3341,13,18,907,1040,0.41935483870967744,-133,0.4658448895737031
2017,3342,13,18,796,901,0.41935483870967744,-105,0.46906305244549207
2017,3343,16,13,1172,706,0.5517241379310345,466,0.6240681576144835
2017,3344,12,18,862,999,0.4,-137,0.4631918323481999
2017,3345,22,12,1541,728,0.6470588235294118,813,0.6791538122520935
2017,3346,27,6,1914,336,0.8181818181818182,1578,0.8506666666666667
2017,3347,22,8,1403,403,0.7333333333333333,1000,0.7768549280177187
2017,3348,6,23,420,1225,0.20689655172413793,-805,0.2553191489361702
2017,3349,17,13,1213,773,0.5666666666666667,440,0.6107754279959718
2017,3350,13,17,810,900,0.43333333333333335,-90,0.47368421052631576
2017,3351,24,8,1619,479,0.75,1140,0.7716873212583413
2017,3352,21,10,1377,579,0.6774193548387096,798,0.7039877300613497
2017,3353,6,24,351,1165,0.2,-814,0.23153034300791556
2017,3354,3,23,180,1248,0.11538461538461539,-1068,0.12605042016806722
2017,3355,22,8,1630,474,0.7333333333333333,1156,0.7747148288973384
2017,3356,15,14,1028,802,0.5172413793103449,226,0.5617486338797815
2017,3357,17,14,1148,818,0.5483870967741935,330,0.5839267548321465
2017,3358,3,24,238,1192,0.1111111111111111,-954,0.16643356643356644
2017,3359,11,19,637,1001,0.36666666666666664,-364,0.3888888888888889
2017,3360,14,16,1011,937,0.4666666666666667,74,0.518993839835729
2017,3361,9,19,682,1080,0.32142857142857145,-398,0.3870601589103292
2017,3362,18,13,1406,723,0.5806451612903226,683,0.660403945514326
2017,3363,10,21,837,1357,0.3225806451612903,-520,0.3814949863263446
2017,3364,16,16,1072,932,0.5,140,0.5349301397205589
2017,3365,13,16,868,908,0.4482758620689655,-40,0.48873873873873874
2017,3366,10,19,585,884,0.3448275862068966,-299,0.39823008849557523
2017,3367,6,21,436,1147,0.2222222222222222,-711,0.27542640555906506
2017,3368,4,24,316,1470,0.14285714285714285,-1154,0.1769316909294513
2017,3369,11,17,864,1147,0.39285714285714285,-283,0.4296369965191447
2017,3370,15,17,1031,1020,0.46875,11,0.5026816187225743
2017,3371,12,19,863,1128,0.3870967741935484,-265,0.4334505273731793
2017,3372,22,7,1679,423,0.7586206896551724,1256,0.7987630827783063
2017,3373,14,16,1006,969,0.4666666666666667,37,0.5093670886075949
2017,3374,17,14,1087,732,0.5483870967741935,355,0.5975810885101704
2017,3375,9,20,562,944,0.3103448275862069,-382,0.37317397078353254
2017,3376,27,4,2111,252,0.8709677419354839,1859,0.8933559035124842
2017,3377,20,8,1499,513,0.7142857142857143,986,0.7450298210735586
2017,3378,24,8,1811,459,0.75,1352,0.7977973568281939
2017,3379,22,10,1654,582,0.6875,1072,0.7397137745974955
2017,3380,13,14,875,827,0.48148148148148145,48,0.5141010575793185
2017,3381,6,23,428,1476,0.20689655172413793,-1048,0.22478991596638656
2017,3382,9,20,578,1033,0.3103448275862069,-455,0.35878336436995656
2017,3383,8,22,520,1228,0.26666666666666666,-708,0.2974828375286041
2017,3384,16,14,1272,1001,0.5333333333333333,271,0.559612846458425
2017,3385,20,11,1322,582,0.6451612903225806,740,0.694327731092437
2017,3386,17,14,1165,811,0.5483870967741935,354,0.5895748987854251
2017,3387,24,8,1874,496,0.75,1378,0.790717299578059
2017,3388,20,12,1456,804,0.625,652,0.6442477876106195
2017,3389,3,27,216,1401,0.1,-1185,0.13358070500927643
2017,3390,28,5,2072,306,0.8484848484848485,1766,0.8713204373423045
2017,3391,23,6,1616,368,0.7931034482758621,1248,0.8145161290322581
2017,3392,11,18,726,916,0.3793103448275862,-190,0.44214372716199757
2017,3393,21,10,1766,682,0.6774193548387096,1084,0.7214052287581699
2017,3394,11,18,756,963,0.3793103448275862,-207,0.4397905759162304
2017,3395,12,18,966,1163,0.4,-197,0.45373414748708313
2017,3396,24,7,1742,426,0.7741935483870968,1316,0.8035055350553506
2017,3397,19,11,1519,697,0.6333333333333333,822,0.6854693140794224
2017,3398,9,16,643,951,0.36,-308,0.40338770388958595
2017,3399,9,20,600,1204,0.3103448275862069,-604,0.3325942350332594
2017,3400,23,8,1776,513,0.7419354838709677,1263,0.7758846657929227
2017,3401,21,11,1570,661,0.65625,909,0.7037203047960556
2017,3402,16,13,1024,680,0.5517241379310345,344,0.6009389671361502
2017,3403,14,17,1085,1021,0.45161290322580644,64,0.5151946818613485
2017,3404,12,19,941,1243,0.3870967741935484,-302,0.4308608058608059
2017,3405,24,8,1760,490,0.75,1270,0.7822222222222223
2017,3406,12,18,793,1076,0.4,-283,0.42429106474050293
2017,3407,20,10,1723,701,0.6666666666666666,1022,0.7108085808580858
2017,3408,16,14,1125,784,0.5333333333333333,341,0.5893137768465165
2017,3409,10,21,714,1259,0.3225806451612903,-545,0.36188545362392294
2017,3410,15,13,1010,734,0.5357142857142857,276,0.5791284403669725
2017,3411,22,9,1428,482,0.7096774193548387,946,0.7476439790575916
2017,3412,14,15,1007,879,0.4827586206896552,128,0.5339342523860021
2017,3413,22,7,1611,380,0.7586206896551724,1231,0.8091411351079859
2017,3414,4,26,292,1483,0.13333333333333333,-1191,0.1645070422535211
2017,3415,16,15,1149,899,0.5161290322580645,250,0.56103515625
2017,3416,20,11,1315,662,0.6451612903225806,653,0.6651492159838138
2017,3417,23,8,1755,536,0.7419354838709677,1219,0.7660410301178525
2017,3418,18,11,1326,662,0.6206896551724138,664,0.6670020120724346
2017,3419,4,24,269,1259,0.14285714285714285,-990,0.17604712041884818
2017,3420,14,15,926,777,0.4827586206896552,149,0.543746330005872
2017,3421,18,14,1218,803,0.5625,415,0.6026719445818901
2017,3422,13,14,867,803,0.48148148148148145,64,0.5191616766467065
2017,3423,10,20,606,992,0.3333333333333333,-386,0.37922403003754696
2017,3424,21,10,1311,523,0.6774193548387096,788,0.7148309705561614
2017,3425,14,16,1068,958,0.4666666666666667,110,0.527147087857848
2017,3426,20,8,1449,473,0.7142857142857143,976,0.7539021852237253
2017,3427,13,15,1017,941,0.4642857142857143,76,0.5194075587334014
2017,3428,16,14,1149,787,0.5333333333333333,362,0.59349173553719
2017,3429,16,14,1016,737,0.5333333333333333,279,0.5795778665145465
2017,3430,7,22,466,1172,0.2413793103448276,-706,0.2844932844932845
2017,3431,7,23,510,1436,0.23333333333333334,-926,0.2620760534429599
2017,3433,16,15,1067,893,0.5161290322580645,174,0.5443877551020408
2017,3434,8,21,522,1223,0.27586206896551724,-701,0.29914040114613183
2017,3435,14,16,1089,972,0.4666666666666667,117,0.5283842794759825
2017,3436,9,20,548,1060,0.3103448275862069,-512,0.3407960199004975
2017,3437,16,14,1044,783,0.5333333333333333,261,0.5714285714285714
2017,3438,19,12,1271,696,0.6129032258064516,575,0.6461616675139806
2017,3439,17,13,1306,822,0.5666666666666667,484,0.6137218045112782
2017,3441,7,22,486,1118,0.2413793103448276,-632,0.3029925187032419
2017,3442,24,6,1964,379,0.8,1585,0.8382415706359369
2017,3443,27,6,2081,409,0.8181818181818182,1672,0.8357429718875502
2017,3444,19,13,1388,819,0.59375,569,0.6289080199365654
2017,3447,3,25,219,1262,0.10714285714285714,-1043,0.14787305874409182
2017,3448,15,15,1039,871,0.5,168,0.543979057591623
2017,3449,27,5,2366,346,0.84375,2020,0.8724188790560472
2017,3450,12,19,934,1118,0.3870967741935484,-184,0.4551656920077973
2017,3451,11,18,801,1145,0.3793103448275862,-344,0.41161356628982526
2017,3452,23,10,1817,641,0.696969696969697,1176,0.7392188771358829
2017,3453,27,5,1905,323,0.84375,1582,0.8550269299820467
2017,3454,20,11,1566,700,0.6451612903225806,866,0.6910856134157105
2017,3455,15,16,1067,944,0.4838709677419355,123,0.530581800099453
2017,3456,20,11,1313,638,0.6451612903225806,675,0.6729882111737571
2017,3457,1,29,78,1435,0.03333333333333333,-1357,0.051553205551883675
2017,3458,9,22,616,1271,0.2903225806451613,-655,0.3264440911499735
2017,3459,11,17,735,931,0.39285714285714285,-196,0.4411764705882353
2017,3460,22,8,1551,476,0.7333333333333333,1075,0.7651702022693636
2017,3461,19,9,1317,464,0.6785714285714286,853,0.7394722066254913
2017,3462,12,18,802,1064,0.4,-262,0.42979635584137194
2017,3463,15,12,958,693,0.5555555555555556,265,0.5802543912780134
2017,3464,7,21,551,1305,0.25,-754,0.296875
2018,1101,12,15,915,993,0.4444444444444444,-78,0.47955974842767296
2018,1102,10,19,766,1168,0.3448275862068966,-402,0.3960703205791106
2018,1103,13,18,1005,1205,0.41935483870967744,-200,0.45475113122171945
2018,1104,19,15,1476,984,0.5588235294117647,492,0.6
2018,1105,3,28,202,1671,0.0967741935483871,-1469,0.10784837159636947
2018,1106,8,23,574,1555,0.25806451612903225,-981,0.2696101456082668
2018,1107,21,10,1646,627,0.6774193548387096,1019,0.7241531016278047
2018,1108,7,21,573,1319,0.25,-746,0.30285412262156447
2018,1110,6,24,422,1539,0.2,-1117,0.21519632840387556
2018,1111,13,18,978,1312,0.41935483870967744,-334,0.42707423580786025
2018,1112,27,7,2223,527,0.7941176470588235,1696,0.8083636363636364
2018,1113,20,11,1759,830,0.6451612903225806,929,0.6794129007338741
2018,1114,6,24,443,1422,0.2,-979,0.23753351206434317
2018,1115,14,21,1057,1250,0.4,-193,0.45817078456870397
2018,1116,23,11,1988,769,0.6764705882352942,1219,0.7210736307580704
2018,1117,9,21,733,1447,0.3,-714,0.33623853211009175
2018,1119,12,17,964,1174,0.41379310344827586,-210,0.45088868101029
2018,1120,25,7,2157,511,0.78125,1646,0.8084707646176912
2018,1122,16,14,1246,906,0.5333333333333333,340,0.578996282527881
2018,1123,18,13,1465,864,0.5806451612903226,601,0.6290253327608416
2018,1124,17,14,1364,945,0.5483870967741935,419,0.5907319185794716
2018,1125,24,9,1985,577,0.7272727272727273,1408,0.7747853239656518
2018,1126,16,14,1417,1001,0.5333333333333333,416,0.5860215053763441
2018,1127,9,20,654,1283,0.3103448275862069,-629,0.3376355188435725
2018,1129,22,8,1775,549,0.7333333333333333,1226,0.7637693631669535
2018,1130,19,15,1559,1052,0.5588235294117647,507,0.5970892378399081
2018,1131,14,16,1074,1029,0.4666666666666667,45,0.5106990014265336
2018,1132,14,16,1091,1132,0.4666666666666667,-41,0.4907782276203329
2018,1133,19,13,1367,777,0.59375,590,0.6375932835820896
2018,1135,10,16,841,1133,0.38461538461538464,-292,0.4260385005065856
2018,1136,3,28,236,1933,0.0967741935483871,-1697,0.10880590133702167
2018,1137,25,9,2068,691,0.7352941176470589,1377,0.7495469372961218
2018,1138,25,8,2191,604,0.7575757575757576,1587,0.7838998211091235
2018,1139,20,13,1674,937,0.6060606060606061,737,0.6411336652623516
2018,1140,24,10,1881,636,0.7058823529411765,1245,0.7473182359952324
2018,1141,16,14,1244,1026,0.5333333333333333,218,0.5480176211453744
2018,1142,7,22,546,1387,0.2413793103448276,-841,0.28246249353336783
2018,1143,8,23,637,1457,0.25806451612903225,-820,0.30420248328557786
2018,1144,13,15,1033,1021,0.4642857142857143,12,0.502921129503408
2018,1145,21,11,1687,754,0.65625,933,0.6911102007374027
2018,1146,16,16,1361,1208,0.5,153,0.5297781237835734
2018,1148,14,18,1040,1131,0.4375,-91,0.47904191616766467
2018,1149,12,16,926,999,0.42857142857142855,-73,0.48103896103896104
2018,1150,5,23,377,1573,0.17857142857142858,-1196,0.19333333333333333
2018,1151,8,23,606,1494,0.25806451612903225,-888,0.2885714285714286
2018,1152,1,29,96,1861,0.03333333333333333,-1765,0.04905467552376086
2018,1153,30,4,2262,270,0.8823529411764706,1992,0.8933649289099526
2018,1154,8,21,691,1613,0.27586206896551724,-922,0.2999131944444444
2018,1155,23,9,1789,556,0.71875,1233,0.7628997867803838
2018,1156,11,23,847,1466,0.3235294117647059,-619,0.36619109381755294
2018,1157,11,18,836,1207,0.3793103448275862,-371,0.40920215369554575
2018,1158,24,7,1832,499,0.7741935483870968,1333,0.7859287859287859
2018,1159,18,13,1362,861,0.5806451612903226,501,0.6126855600539811
2018,1160,17,15,1354,953,0.53125,401,0.5869094061551798
2018,1161,10,21,741,1486,0.3225806451612903,-745,0.33273462056578357
2018,1162,7,19,592,1383,0.2692307692307692,-791,0.299746835443038
2018,1163,14,18,1017,1164,0.4375,-147,0.46629986244841815
2018,1164,5,27,387,1558,0.15625,-1171,0.19897172236503857
2018,1165,11,16,913,1118,0.4074074074074074,-205,0.44953225012309206
2018,1166,20,11,1791,812,0.6451612903225806,979,0.6880522474068382
2018,1167,9,18,666,1068,0.3333333333333333,-402,0.38408304498269896
2018,1168,18,11,1399,708,0.6206896551724138,691,0.6639772187944946
2018,1169,4,24,294,1520,0.14285714285714285,-1226,0.16207276736493936
2018,1170,5,25,392,1594,0.16666666666666666,-1202,0.1973816717019134
2018,1171,6,20,430,1333,0.23076923076923078,-903,0.24390243902439024
2018,1172,21,11,1685,761,0.65625,924,0.6888798037612428
2018,1173,14,17,1125,1119,0.45161290322580644,6,0.5013368983957219
2018,1174,12,19,895,1262,0.3870967741935484,-367,0.41492814093648583
2018,1175,2,28,156,1739,0.06666666666666667,-1583,0.08232189973614776
2018,1176,13,15,989,1006,0.4642857142857143,-17,0.4957393483709273
2018,1177,11,20,883,1347,0.3548387096774194,-464,0.3959641255605381
2018,1178,6,24,534,1746,0.2,-1212,0.23421052631578948
2018,1179,15,16,1166,1087,0.4838709677419355,79,0.5175321793164669
2018,1180,12,20,945,1414,0.375,-469,0.40059347181008903
2018,1181,26,7,2276,519,0.7878787878787878,1757,0.8143112701252236
2018,1182,16,16,1242,1075,0.5,167,0.5360379801467414
2018,1183,10,19,715,1180,0.3448275862068966,-465,0.37730870712401055
2018,1184,9,20,703,1331,0.3103448275862069,-628,0.3456243854473943
2018,1185,17,12,1235,793,0.5862068965517241,442,0.6089743589743589
2018,1186,18,14,1419,959,0.5625,460,0.5967199327165685
2018,1187,10,20,776,1217,0.3333333333333333,-441,0.38936276969392875
2018,1188,9,21,708,1382,0.3,-674,0.33875598086124403
2018,1189,12,18,961,1205,0.4,-244,0.44367497691597413
2018,1190,23,9,1791,587,0.71875,1204,0.7531539108494533
2018,1191,15,15,1049,868,0.5,181,0.5472091810119979
2018,1192,11,18,889,1219,0.3793103448275862,-330,0.42172675521821634
2018,1193,17,16,1366,1140,0.5151515151515151,226,0.5450917797286512
2018,1194,9,19,697,1170,0.32142857142857145,-473,0.37332619175147297
2018,1195,20,11,1657,869,0.6451612903225806,788,0.6559778305621536
2018,1196,20,12,1636,798,0.625,838,0.6721446179129006
2018,1197,8,25,631,1635,0.24242424242424243,-1004,0.27846425419240955
2018,1198,11,18,831,1205,0.3793103448275862,-374,0.4081532416502947
2018,1199,20,11,1749,786,0.6451612903225806,963,0.6899408284023668
2018,1200,9,22,671,1260,0.2903225806451613,-589,0.3474883480062144
2018,1201,19,11,1509,761,0.6333333333333333,748,0.6647577092511013
2018,1202,21,10,1749,666,0.6774193548387096,1083,0.724223602484472
2018,1203,15,18,1136,1089,0.45454545454545453,47,0.510561797752809
2018,1204,19,12,1483,804,0.6129032258064516,679,0.6484477481416703
2018,1205,11,18,762,1182,0.3793103448275862,-420,0.39197530864197533
2018,1206,16,17,1254,1117,0.48484848484848486,137,0.5288907633909743
2018,1207,15,15,1242,1108,0.5,134,0.5285106382978724
2018,1208,18,15,1339,908,0.5454545454545454,431,0.5959056519804183
2018,1209,22,10,1653,728,0.6875,925,0.6942461150776984
2018,1210,13,19,877,1224,0.40625,-347,0.4174202760590195
2018,1211,30,4,2555,318,0.8823529411764706,2237,0.8893143056038983
2018,1212,16,14,1217,929,0.5333333333333333,288,0.5671015843429636
2018,1213,21,11,1645,698,0.65625,947,0.7020913358941528
2018,1214,15,15,1264,1102,0.5,162,0.5342349957734573
2018,1216,18,13,1362,812,0.5806451612903226,550,0.6264949402023919
2018,1217,17,13,1215,834,0.5666666666666667,381,0.5929721815519766
2018,1218,15,13,1094,841,0.5357142857142857,253,0.5653746770025839
2018,1219,11,16,824,1003,0.4074074074074074,-179,0.45101258894362345
2018,1220,18,12,1469,888,0.6,581,0.6232498939329656
2018,1221,12,19,850,1122,0.3870967741935484,-272,0.43103448275862066
2018,1222,26,7,2053,502,0.7878787878787878,1551,0.8035225048923679
2018,1223,3,25,250,1828,0.10714285714285714,-1578,0.12030798845043311
2018,1224,8,23,677,1615,0.25806451612903225,-938,0.29537521815008727
2018,1225,20,9,1543,613,0.6896551724137931,930,0.7156771799628943
2018,1226,12,16,916,1130,0.42857142857142855,-214,0.447702834799609
2018,1227,15,15,1236,1007,0.5,229,0.5510477039679001
2018,1228,13,18,1037,1293,0.41935483870967744,-256,0.4450643776824034
2018,1229,17,15,1312,966,0.53125,346,0.5759438103599649
2018,1230,3,21,229,1390,0.125,-1161,0.14144533662754788
2018,1231,16,15,1246,983,0.5161290322580645,263,0.5589950650515927
2018,1232,11,18,808,1286,0.3793103448275862,-478,0.3858643744030564
2018,1233,20,13,1644,991,0.6060606060606061,653,0.6239089184060721
2018,1234,14,19,1274,1356,0.42424242424242425,-82,0.4844106463878327
2018,1235,13,18,1042,1216,0.41935483870967744,-174,0.46147032772364927
2018,1236,14,14,1190,1033,0.5,157,0.5353126405757984
2018,1237,9,19,648,1237,0.32142857142857145,-589,0.3437665782493369
2018,1238,10,20,676,1171,0.3333333333333333,-495,0.36599891716296695
2018,1239,11,18,902,1140,0.3793103448275862,-238,0.44172380019588636
2018,1240,20,12,1507,752,0.625,755,0.6671093404161134
2018,1241,9,22,728,1533,0.2903225806451613,-805,0.3219814241486068
2018,1242,27,7,2261,510,0.7941176470588235,1751,0.8159509202453987
2018,1243,22,11,1688,700,0.6666666666666666,988,0.7068676716917923
2018,1244,8,20,685,1322,0.2857142857142857,-637,0.34130543099152966
2018,1245,16,17,1272,1120,0.48484848484848486,152,0.5317725752508361
2018,1246,24,10,1950,659,0.7058823529411765,1291,0.7474128018397853
2018,1247,13,19,996,1337,0.40625,-341,0.4269181311615945
2018,1248,9,21,713,1412,0.3,-699,0.3355294117647059
2018,1249,15,13,1175,876,0.5357142857142857,299,0.5728912725499756
2018,1250,15,14,1227,1014,0.5172413793103449,213,0.5475234270414994
2018,1251,17,14,1267,875,0.5483870967741935,392,0.5915032679738562
2018,1252,20,9,1682,663,0.6896551724137931,1019,0.71727078891258
2018,1253,13,18,1013,1300,0.41935483870967744,-287,0.43795936013834846
2018,1254,17,16,1348,1183,0.5151515151515151,165,0.5325958119320426
2018,1255,4,26,281,1555,0.13333333333333333,-1274,0.15305010893246188
2018,1256,15,16,1169,1081,0.4838709677419355,88,0.5195555555555555
2018,1257,20,13,1638,877,0.6060606060606061,761,0.6512922465208748
2018,1258,10,20,778,1361,0.3333333333333333,-583,0.3637213651238897
2018,1259,8,22,613,1444,0.26666666666666666,-831,0.2980068060281964
2018,1260,27,5,2002,292,0.84375,1710,0.8727114210985178
2018,1261,17,14,1424,980,0.5483870967741935,444,0.5923460898502496
2018,1262,11,18,921,1263,0.3793103448275862,-342,0.4217032967032967
2018,1263,4,26,304,1657,0.13333333333333333,-1353,0.15502294747577766
2018,1264,14,17,1045,1102,0.45161290322580644,-57,0.48672566371681414
2018,1265,6,25,467,1772,0.1935483870967742,-1305,0.2085752568110764
2018,1266,19,13,1626,972,0.59375,654,0.625866050808314
2018,1267,23,10,1951,808,0.696969696969697,1143,0.7071402682131207
2018,1268,18,13,1405,857,0.5806451612903226,548,0.621131741821397
2018,1269,13,20,1002,1372,0.3939393939393939,-370,0.42207245155855094
2018,1270,8,17,622,1189,0.32,-567,0.3434566537824406
2018,1271,5,25,353,1470,0.16666666666666666,-1117,0.1936368623148656
2018,1272,21,13,1621,787,0.6176470588235294,834,0.6731727574750831
2018,1273,16,14,1239,977,0.5333333333333333,262,0.5591155234657039
2018,1274,22,9,1719,580,0.7096774193548387,1139,0.7477163984341018
2018,1275,14,17,1037,1093,0.45161290322580644,-56,0.4868544600938967
2018,1276,27,7,2035,469,0.7941176470588235,1566,0.8126996805111821
2018,1277,29,4,2391,281,0.8787878787878788,2110,0.8948353293413174
2018,1278,15,17,1287,1118,0.46875,169,0.5351351351351351
2018,1279,12,20,968,1458,0.375,-490,0.39901071723000825
2018,1280,21,11,1646,692,0.65625,954,0.7040205303678357
2018,1281,19,12,1478,800,0.6129032258064516,678,0.6488147497805092
2018,1282,8,21,590,1388,0.27586206896551724,-798,0.2982810920121335
2018,1283,17,15,1255,978,0.53125,277,0.5620241827138379
2018,1284,11,20,889,1447,0.3548387096774194,-558,0.3805650684931507
2018,1285,24,7,1963,457,0.7741935483870968,1506,0.8111570247933885
2018,1286,11,19,894,1333,0.36666666666666664,-439,0.40143691064211945
2018,1287,6,21,469,1386,0.2222222222222222,-917,0.2528301886792453
2018,1288,11,18,855,1264,0.3793103448275862,-409,0.4034922133081642
2018,1290,4,28,304,1771,0.125,-1467,0.14650602409638555
2018,1291,16,14,1213,938,0.5333333333333333,275,0.5639237563923757
2018,1292,23,7,1720,496,0.7666666666666667,1224,0.776173285198556
2018,1293,24,5,1902,342,0.8275862068965517,1560,0.8475935828877005
2018,1294,19,12,1604,846,0.6129032258064516,758,0.6546938775510204
2018,1295,12,17,971,1124,0.41379310344827586,-153,0.46348448687350835
2018,1296,11,19,851,1293,0.36666666666666664,-442,0.3969216417910448
2018,1297,20,9,1583,640,0.6896551724137931,943,0.7121007647323436
2018,1298,19,12,1359,730,0.6129032258064516,629,0.6505505026328386
2018,1299,18,14,1344,1008,0.5625,336,0.5714285714285714
2018,1300,16,15,1154,1028,0.5161290322580645,126,0.5288725939505041
2018,1301,21,11,1827,772,0.65625,1055,0.7029626779530589
2018,1303,7,22,570,1604,0.2413793103448276,-1034,0.2621895124195032
2018,1304,22,10,1699,628,0.6875,1071,0.7301246239793726
2018,1305,27,7,2277,548,0.7941176470588235,1729,0.8060176991150443
2018,1306,8,21,548,1349,0.27586206896551724,-801,0.28887717448603056
2018,1307,18,15,1562,1086,0.5454545454545454,476,0.5898791540785498
2018,1308,25,5,1920,348,0.8333333333333334,1572,0.8465608465608465
2018,1309,12,16,888,995,0.42857142857142855,-107,0.47158789166224113
2018,1310,19,13,1631,1052,0.59375,579,0.6079016026835632
2018,1311,17,11,1415,807,0.6071428571428571,608,0.6368136813681368
2018,1312,12,16,940,1093,0.42857142857142855,-153,0.46237088047220853
2018,1313,13,17,1022,1118,0.43333333333333335,-96,0.47757009345794393
2018,1314,25,10,2167,702,0.7142857142857143,1465,0.7553154409201812
2018,1315,10,20,807,1459,0.3333333333333333,-652,0.3561341571050309
2018,1316,11,19,1004,1374,0.36666666666666664,-370,0.4222035323801514
2018,1317,13,17,991,1134,0.43333333333333335,-143,0.4663529411764706
2018,1318,22,10,1733,656,0.6875,1077,0.7254081205525325
2018,1319,4,26,278,1673,0.13333333333333333,-1395,0.1424910302409021
2018,1320,14,16,971,933,0.4666666666666667,38,0.5099789915966386
2018,1321,14,17,1077,1041,0.45161290322580644,36,0.5084985835694051
2018,1322,2,23,142,1403,0.08,-1261,0.09190938511326861
2018,1323,19,14,1528,940,0.5757575757575758,588,0.6191247974068071
2018,1324,19,14,1595,985,0.5757575757575758,610,0.6182170542635659
2018,1325,13,17,1085,1184,0.43333333333333335,-99,0.47818422212428385
2018,1326,24,8,1899,527,0.75,1372,0.782769991755977
2018,1328,18,13,1689,951,0.5806451612903226,738,0.6397727272727273
2018,1329,19,14,1560,962,0.5757575757575758,598,0.6185567010309279
2018,1330,25,7,1888,459,0.78125,1429,0.8044311887515978
2018,1331,8,20,630,1358,0.2857142857142857,-728,0.31690140845070425
2018,1332,22,12,1801,825,0.6470588235294118,976,0.6858339680121859
2018,1333,16,16,1275,1064,0.5,211,0.5451047456177853
2018,1334,13,18,956,1219,0.41935483870967744,-263,0.4395402298850575
2018,1335,23,8,1802,545,0.7419354838709677,1257,0.7677886663826161
2018,1336,21,13,1617,920,0.6176470588235294,697,0.6373669688608593
2018,1337,5,26,381,1795,0.16129032258064516,-1414,0.17509191176470587
2018,1338,8,24,588,1397,0.25,-809,0.29622166246851384
2018,1339,7,22,502,1432,0.2413793103448276,-930,0.2595656670113754
2018,1340,17,13,1485,996,0.5666666666666667,489,0.5985489721886336
2018,1341,15,18,1201,1248,0.45454545454545453,-47,0.4904042466312781
2018,1342,8,21,581,1255,0.27586206896551724,-674,0.3164488017429194
2018,1343,12,16,917,1103,0.42857142857142855,-186,0.453960396039604
2018,1344,21,13,1628,878,0.6176470588235294,750,0.6496408619313647
2018,1345,28,6,2364,395,0.8235294117647058,1969,0.8568321855744835
2018,1346,12,21,910,1454,0.36363636363636365,-544,0.3849407783417936
2018,1347,20,12,1391,751,0.625,640,0.6493930905695612
2018,1348,25,7,1998,440,0.78125,1558,0.8195242001640689
2018,1349,5,24,388,1565,0.1724137931034483,-1177,0.19866871479774706
2018,1350,12,20,916,1381,0.375,-465,0.39878101872006966
2018,1351,22,9,1869,665,0.7096774193548387,1204,0.7375690607734806
2018,1352,16,17,1217,1055,0.48484848484848486,162,0.5356514084507042
2018,1353,14,19,1012,1110,0.42424242424242425,-98,0.47690857681432614
2018,1354,8,22,660,1502,0.26666666666666666,-842,0.30527289546716
2018,1355,24,6,2063,438,0.8,1625,0.8248700519792083
2018,1356,19,13,1420,819,0.59375,601,0.6342117016525235
2018,1357,9,21,683,1362,0.3,-679,0.33398533007334963
2018,1358,15,14,1126,899,0.5172413793103449,227,0.5560493827160494
2018,1359,8,22,733,1553,0.26666666666666666,-820,0.3206474190726159
2018,1360,17,13,1233,828,0.5666666666666667,405,0.5982532751091703
2018,1361,21,10,1679,710,0.6774193548387096,969,0.7028045207199665
2018,1362,17,15,1240,948,0.53125,292,0.56672760511883
2018,1363,3,26,201,1676,0.10344827586206896,-1475,0.10708577517314864
2018,1364,21,9,1658,599,0.7,1059,0.7346034559149314
2018,1365,10,19,729,1126,0.3448275862068966,-397,0.3929919137466307
2018,1366,13,17,1274,1268,0.43333333333333335,6,0.5011801730920535
2018,1367,3,25,270,1827,0.10714285714285714,-1557,0.12875536480686695
2018,1368,19,11,1438,671,0.6333333333333333,767,0.6818397344713134
2018,1369,12,17,971,1220,0.41379310344827586,-249,0.44317663167503424
2018,1370,17,13,1360,831,0.5666666666666667,529,0.6207211319032405
2018,1371,21,11,1725,803,0.65625,922,0.6823575949367089
2018,1372,24,6,1915,430,0.8,1485,0.8166311300639659
2018,1373,8,24,593,1573,0.25,-980,0.2737765466297322
2018,1374,17,16,1330,963,0.5151515151515151,367,0.5800261665939817
2018,1375,12,18,844,1214,0.4,-370,0.4101068999028183
2018,1376,16,16,1230,1009,0.5,221,0.5493523894595802
2018,1377,22,8,1788,601,0.7333333333333333,1187,0.7484303055671829
2018,1378,10,22,733,1293,0.3125,-560,0.3617966436327739
2018,1379,12,18,939,1109,0.4,-170,0.45849609375
2018,1380,13,18,866,1223,0.41935483870967744,-357,0.4145524174246051
2018,1381,11,19,888,1356,0.36666666666666664,-468,0.39572192513368987
2018,1382,25,7,1973,520,0.78125,1453,0.7914159647011633
2018,1383,11,18,872,1196,0.3793103448275862,-324,0.42166344294003866
2018,1384,16,12,1356,824,0.5714285714285714,532,0.6220183486238532
2018,1385,15,17,1154,1187,0.46875,-33,0.4929517300299017
2018,1386,16,16,1241,1130,0.5,111,0.5234078447912274
2018,1387,16,16,1127,969,0.5,158,0.5376908396946565
2018,1388,28,5,2180,360,0.8484848484848485,1820,0.8582677165354331
2018,1389,14,18,983,1102,0.4375,-119,0.471462829736211
2018,1390,18,15,1471,1033,0.5454545454545454,438,0.5874600638977636
2018,1391,8,20,650,1398,0.2857142857142857,-748,0.3173828125
2018,1392,12,19,874,1230,0.3870967741935484,-356,0.41539923954372626
2018,1393,20,13,1433,796,0.6060606060606061,637,0.6428891879766712
2018,1394,8,18,599,1144,0.3076923076923077,-545,0.34366035570854847
2018,1395,21,11,1802,854,0.65625,948,0.6784638554216867
2018,1396,17,15,1264,987,0.53125,277,0.5615282096845846
2018,1397,25,8,1884,565,0.7575757575757576,1319,0.7692935892200898
2018,1398,13,15,888,950,0.4642857142857143,-62,0.48313384113166485
2018,1399,17,14,1341,872,0.5483870967741935,469,0.6059647537279711
2018,1400,19,14,1439,928,0.5757575757575758,511,0.6079425433037601
2018,1401,20,12,1593,807,0.625,786,0.66375
2018,1402,13,18,888,1117,0.41935483870967744,-229,0.4428927680798005
2018,1403,24,9,1892,591,0.7272727272727273,1301,0.7619814740233588
2018,1404,8,21,582,1342,0.27586206896551724,-760,0.3024948024948025
2018,1405,22,11,1818,797,0.6666666666666666,1021,0.6952198852772467
2018,1406,16,14,1286,981,0.5333333333333333,305,0.5672695191883547
2018,1407,14,17,1106,1183,0.45161290322580644,-77,0.4831804281345566
2018,1408,14,17,1132,1137,0.45161290322580644,-5,0.49889819303658
2018,1409,19,12,1473,804,0.6129032258064516,669,0.6469038208168643
2018,1410,13,17,1034,1200,0.43333333333333335,-166,0.4628469113697404
2018,1411,15,19,1298,1342,0.4411764705882353,-44,0.49166666666666664
2018,1412,18,13,1478,887,0.5806451612903226,591,0.6249471458773784
2018,1413,20,10,1476,678,0.6666666666666666,798,0.6852367688022284
2018,1414,16,17,1159,1078,0.48484848484848486,81,0.5181046043808673
2018,1415,7,22,488,1370,0.2413793103448276,-882,0.26264800861141013
2018,1416,19,13,1307,700,0.59375,607,0.6512207274539114
2018,1417,21,11,1788,833,0.65625,955,0.682182373140023
2018,1418,25,6,2124,418,0.8064516129032258,1706,0.8355625491738788
2018,1419,13,15,960,934,0.4642857142857143,26,0.5068637803590285
2018,1420,21,10,1629,618,0.6774193548387096,1011,0.7249666221628839
2018,1421,19,12,1473,797,0.6129032258064516,676,0.6488986784140969
2018,1422,24,7,1764,472,0.7741935483870968,1292,0.7889087656529516
2018,1423,9,21,772,1564,0.3,-792,0.3304794520547945
2018,1424,20,13,1784,969,0.6060606060606061,815,0.6480203414456956
2018,1425,23,11,1816,804,0.6764705882352942,1012,0.6931297709923664
2018,1426,20,13,1658,909,0.6060606060606061,749,0.6458901441371251
2018,1427,16,14,1235,1048,0.5333333333333333,187,0.5409548839246605
2018,1428,19,11,1471,734,0.6333333333333333,737,0.6671201814058957
2018,1429,16,17,1246,1147,0.48484848484848486,99,0.520685332218972
2018,1430,19,10,1566,644,0.6551724137931034,922,0.7085972850678733
2018,1431,10,20,759,1235,0.3333333333333333,-476,0.38064192577733197
2018,1433,18,15,1478,1029,0.5454545454545454,449,0.5895492620662146
2018,1434,13,17,1018,1063,0.43333333333333335,-45,0.4891878904372898
2018,1435,12,20,948,1368,0.375,-420,0.40932642487046633
2018,1436,26,7,1930,503,0.7878787878787878,1427,0.7932593505959721
2018,1437,30,4,2638,322,0.8823529411764706,2316,0.8912162162162162
2018,1438,31,2,2108,121,0.9393939393939394,1987,0.9457155675190668
2018,1439,21,11,1790,761,0.65625,1029,0.7016856134849079
2018,1440,7,21,536,1247,0.25,-711,0.30061693774537296
2018,1441,11,19,831,1175,0.36666666666666664,-344,0.41425722831505485
2018,1442,8,16,613,990,0.3333333333333333,-377,0.3824079850280724
2018,1443,23,10,1880,702,0.696969696969697,1178,0.7281177381874516
2018,1444,15,15,1158,1053,0.5,105,0.5237449118046132
2018,1447,21,9,1599,608,0.7,991,0.7245129134571817
2018,1448,11,20,879,1394,0.3548387096774194,-515,0.38671359436867575
2018,1449,20,12,1579,798,0.625,781,0.6642827092974337
2018,1450,12,19,961,1309,0.3870967741935484,-348,0.4233480176211454
2018,1451,17,11,1417,714,0.6071428571428571,703,0.664946034725481
2018,1452,24,10,1976,731,0.7058823529411765,1245,0.7299593646102697
2018,1453,10,20,837,1388,0.3333333333333333,-551,0.37617977528089885
2018,1454,15,16,1080,1041,0.4838709677419355,39,0.5091937765205092
2018,1455,25,7,2156,500,0.78125,1656,0.8117469879518072
2018,1456,17,12,1535,872,0.5862068965517241,663,0.6377233070211882
2018,1457,16,12,1294,853,0.5714285714285714,441,0.6027014438751747
2018,1458,15,18,1118,1088,0.45454545454545453,30,0.5067996373526745
2018,1459,18,12,1430,751,0.6,679,0.6556625401192113
2018,1460,23,9,1700,582,0.71875,1118,0.7449605609114811
2018,1461,19,13,1564,986,0.59375,578,0.6133333333333333
2018,1462,28,5,2407,374,0.8484848484848485,2033,0.8655160014383315
2018,1463,15,15,1238,967,0.5,271,0.5614512471655329
2018,1464,6,24,481,1704,0.2,-1223,0.22013729977116706
2018,3101,12,14,927,787,0.46153846153846156,140,0.5408401400233372
2018,3102,6,24,365,1297,0.2,-932,0.21961492178098677
2018,3103,8,21,545,1306,0.27586206896551724,-761,0.29443544030253915
2018,3104,17,13,1255,773,0.5666666666666667,482,0.618836291913215
2018,3105,11,18,749,887,0.3793103448275862,-138,0.4578239608801956
2018,3106,7,22,473,1095,0.2413793103448276,-622,0.30165816326530615
2018,3107,24,7,1697,429,0.7741935483870968,1268,0.7982126058325494
2018,3108,9,18,638,1071,0.3333333333333333,-433,0.37331772966647164
2018,3110,26,6,1745,314,0.8125,1431,0.8474987858183585
2018,3111,8,23,571,1189,0.25806451612903225,-618,0.32443181818181815
2018,3112,6,24,439,1299,0.2,-860,0.2525891829689298
2018,3113,21,12,1566,670,0.6363636363636364,896,0.7003577817531306
2018,3114,23,9,1459,461,0.71875,998,0.7598958333333333
2018,3115,6,21,382,1112,0.2222222222222222,-730,0.2556894243641232
2018,3116,13,18,987,1097,0.41935483870967744,-110,0.4736084452975048
2018,3117,15,15,1120,872,0.5,248,0.5622489959839357
2018,3119,16,14,1047,735,0.5333333333333333,312,0.5875420875420876
2018,3120,13,15,891,849,0.4642857142857143,42,0.5120689655172413
2018,3122,14,14,960,783,0.5,177,0.5507745266781411
2018,3123,23,6,1885,421,0.7931034482758621,1464,0.8174327840416306
2018,3124,31,1,2703,68,0.96875,2635,0.9754601226993865
2018,3125,30,3,2354,207,0.9090909090909091,2147,0.9191721983600156
2018,3126,22,6,1430,333,0.7857142857142857,1097,0.8111174134997164
2018,3127,18,11,1205,614,0.6206896551724138,591,0.662451896646509
2018,3129,21,9,1487,552,0.7,935,0.7292790583619422
2018,3130,7,23,482,1263,0.23333333333333334,-781,0.27621776504297996
2018,3131,10,19,682,1022,0.3448275862068966,-340,0.40023474178403756
2018,3132,10,19,714,1111,0.3448275862068966,-397,0.39123287671232876
2018,3133,12,18,920,1032,0.4,-112,0.4713114754098361
2018,3135,14,12,1140,793,0.5384615384615384,347,0.5897568546301086
2018,3136,9,21,615,1243,0.3,-628,0.3310010764262648
2018,3137,22,9,1469,503,0.7096774193548387,966,0.7449290060851927
2018,3138,27,5,2108,373,0.84375,1735,0.8496573962112052
2018,3139,15,17,1038,1027,0.46875,11,0.5026634382566586
2018,3140,16,14,1130,867,0.5333333333333333,263,0.5658487731597396
2018,3141,27,4,2262,282,0.8709677419354839,1980,0.8891509433962265
2018,3142,16,12,1197,798,0.5714285714285714,399,0.6
2018,3143,21,10,1592,555,0.6774193548387096,1037,0.7414997671169073
2018,3144,13,15,795,702,0.4642857142857143,93,0.531062124248497
2018,3145,10,20,636,1030,0.3333333333333333,-394,0.3817527010804322
2018,3146,18,9,1122,467,0.6666666666666666,655,0.7061044682190056
2018,3148,7,23,492,1286,0.23333333333333334,-794,0.27671541057367827
2018,3149,8,20,571,1109,0.2857142857142857,-538,0.3398809523809524
2018,3150,14,16,995,985,0.4666666666666667,10,0.5025252525252525
2018,3151,17,12,1080,634,0.5862068965517241,446,0.6301050175029171
2018,3152,1,29,84,1435,0.03333333333333333,-1351,0.055299539170506916
2018,3153,18,12,1289,678,0.6,611,0.6553126588713777
2018,3155,11,19,663,852,0.36666666666666664,-189,0.4376237623762376
2018,3156,19,11,1366,664,0.6333333333333333,702,0.6729064039408867
2018,3157,15,14,1069,792,0.5172413793103449,277,0.5744223535733477
2018,3158,7,24,529,1283,0.22580645161290322,-754,0.29194260485651213
2018,3159,7,23,478,1214,0.23333333333333334,-736,0.28250591016548465
2018,3160,14,16,1049,1001,0.4666666666666667,48,0.5117073170731707
2018,3161,19,11,1232,598,0.6333333333333333,634,0.673224043715847
2018,3162,8,21,605,1199,0.27586206896551724,-594,0.3353658536585366
2018,3163,32,0,2842,0,1.0,2842,1.0
2018,3164,6,23,376,1237,0.20689655172413793,-861,0.23310601363918165
2018,3165,7,20,425,1066,0.25925925925925924,-641,0.28504359490274983
2018,3166,18,12,1311,778,0.6,533,0.6275730014360938
2018,3167,16,13,1022,699,0.5517241379310345,323,0.5938407902382336
2018,3168,7,21,474,1188,0.25,-714,0.2851985559566787
2018,3169,18,15,1262,871,0.5454545454545454,391,0.5916549460853259
2018,3170,6,23,496,1570,0.20689655172413793,-1074,0.24007744433688286
2018,3171,15,12,1072,682,0.5555555555555556,390,0.6111744583808438
2018,3172,12,18,850,1043,0.4,-193,0.44902271526677234
2018,3173,23,6,1743,392,0.7931034482758621,1351,0.8163934426229508
2018,3174,19,12,1318,730,0.6129032258064516,588,0.6435546875
2018,3175,6,24,403,1345,0.2,-942,0.2305491990846682
2018,3176,15,14,1162,857,0.5172413793103449,305,0.5755324418028727
2018,3177,26,7,2186,547,0.7878787878787878,1639,0.7998536406878888
2018,3178,2,28,134,1660,0.06666666666666667,-1526,0.07469342251950947
2018,3179,25,7,2083,541,0.78125,1542,0.7938262195121951
2018,3180,26,7,1709,392,0.7878787878787878,1317,0.8134221799143265
2018,3181,22,8,1609,465,0.7333333333333333,1144,0.7757955641272902
2018,3182,23,7,1683,429,0.7666666666666667,1254,0.796875
2018,3183,3,26,221,1481,0.10344827586206896,-1260,0.1298472385428907
2018,3184,7,19,437,1031,0.2692307692307692,-594,0.29768392370572205
2018,3185,10,20,741,1347,0.3333333333333333,-606,0.35488505747126436
2018,3186,16,14,1163,847,0.5333333333333333,316,0.5786069651741294
2018,3187,16,15,1151,867,0.5161290322580645,284,0.570366699702676
2018,3188,17,14,1188,831,0.5483870967741935,357,0.5884101040118871
2018,3189,24,7,1777,433,0.7741935483870968,1344,0.8040723981900453
2018,3190,19,12,1350,723,0.6129032258064516,627,0.6512301013024602
2018,3191,1,27,89,1520,0.03571428571428571,-1431,0.05531385954008701
2018,3192,14,15,963,810,0.4827586206896552,153,0.5431472081218274
2018,3193,13,17,824,862,0.43333333333333335,-38,0.4887307236061684
2018,3194,13,15,1020,939,0.4642857142857143,81,0.5206738131699847
2018,3195,27,4,2146,261,0.8709677419354839,1885,0.891566265060241
2018,3196,11,19,852,1116,0.36666666666666664,-264,0.4329268292682927
2018,3197,7,24,505,1321,0.22580645161290322,-816,0.27656078860898137
2018,3198,8,21,579,1265,0.27586206896551724,-686,0.3139913232104121
2018,3199,25,6,2104,412,0.8064516129032258,1692,0.8362480127186009
2018,3200,22,9,1397,494,0.7096774193548387,903,0.738762559492332
2018,3201,16,14,1097,877,0.5333333333333333,220,0.5557244174265451
2018,3202,14,13,917,752,0.5185185185185185,165,0.5494307968843619
2018,3203,19,13,1172,753,0.59375,419,0.6088311688311688
2018,3204,3,25,209,1349,0.10714285714285714,-1140,0.13414634146341464
2018,3205,16,13,1068,680,0.5517241379310345,388,0.6109839816933639
2018,3206,23,9,1656,559,0.71875,1097,0.7476297968397291
2018,3207,15,15,1085,839,0.5,246,0.5639293139293139
2018,3208,25,6,1767,335,0.8064516129032258,1432,0.840627973358706
2018,3209,6,22,408,1290,0.21428571428571427,-882,0.24028268551236748
2018,3210,18,13,1277,782,0.5806451612903226,495,0.6202039825157843
2018,3211,27,5,2028,289,0.84375,1739,0.8752697453603798
2018,3212,19,13,1397,748,0.59375,649,0.6512820512820513
2018,3213,14,14,912,859,0.5,53,0.5149632975719932
2018,3214,18,14,1227,829,0.5625,398,0.5967898832684825
2018,3216,19,13,1334,733,0.59375,601,0.6453797774552491
2018,3217,18,10,1381,552,0.6428571428571429,829,0.7144335230212105
2018,3218,11,18,762,1061,0.3793103448275862,-299,0.41799232035106965
2018,3219,15,14,1050,754,0.5172413793103449,296,0.582039911308204
2018,3220,11,19,791,1014,0.36666666666666664,-223,0.43822714681440444
2018,3221,13,18,875,1099,0.41935483870967744,-224,0.4432624113475177
2018,3222,20,11,1580,721,0.6451612903225806,859,0.686657974793568
2018,3223,6,18,383,1035,0.25,-652,0.27009873060648804
2018,3224,12,18,873,1072,0.4,-199,0.4488431876606684
2018,3225,18,13,1485,839,0.5806451612903226,646,0.6389845094664371
2018,3226,19,11,1405,694,0.6333333333333333,711,0.6693663649356837
2018,3227,6,22,434,1146,0.21428571428571427,-712,0.2746835443037975
2018,3228,9,22,613,1289,0.2903225806451613,-676,0.32229232386961093
2018,3229,14,16,825,781,0.4666666666666667,44,0.5136986301369864
2018,3230,4,24,235,1188,0.14285714285714285,-953,0.1651440618411806
2018,3231,17,14,1258,899,0.5483870967741935,359,0.5832174316179879
2018,3232,10,19,648,1046,0.3448275862068966,-398,0.3825265643447462
2018,3233,2,28,107,1464,0.06666666666666667,-1357,0.06810948440483769
2018,3234,24,7,1921,527,0.7741935483870968,1394,0.7847222222222222
2018,3235,14,17,1041,1037,0.45161290322580644,4,0.5009624639076035
2018,3236,3,22,248,1123,0.12,-875,0.18088986141502553
2018,3237,21,9,1538,534,0.7,1004,0.7422779922779923
2018,3238,12,12,877,806,0.5,71,0.5210932857991681
2018,3239,21,8,1491,480,0.7241379310344828,1011,0.756468797564688
2018,3240,17,12,1120,589,0.5862068965517241,531,0.6553540081919251
2018,3241,21,10,1402,594,0.6774193548387096,808,0.7024048096192385
2018,3242,12,18,842,1019,0.4,-177,0.4524449220849006
2018,3243,16,15,1198,897,0.5161290322580645,301,0.571837708830549
2018,3244,6,19,398,994,0.24,-596,0.2859195402298851
2018,3245,13,19,884,1108,0.40625,-224,0.44377510040160645
2018,3246,15,17,1158,1020,0.46875,138,0.5316804407713499
2018,3247,8,22,554,1171,0.26666666666666666,-617,0.32115942028985506
2018,3248,11,19,685,971,0.36666666666666664,-286,0.4136473429951691
2018,3249,18,7,1418,436,0.72,982,0.7648327939590076
2018,3250,14,15,927,843,0.4827586206896552,84,0.523728813559322
2018,3251,22,9,1479,488,0.7096774193548387,991,0.7519064565327911
2018,3252,12,19,866,1114,0.3870967741935484,-248,0.43737373737373736
2018,3253,8,23,573,1390,0.25806451612903225,-817,0.29190015282730514
2018,3254,13,18,825,903,0.41935483870967744,-78,0.4774305555555556
2018,3255,6,23,439,1143,0.20689655172413793,-704,0.2774968394437421
2018,3256,18,11,1271,648,0.6206896551724138,623,0.662324127149557
2018,3257,32,2,2497,107,0.9411764705882353,2390,0.9589093701996928
2018,3258,18,11,1294,705,0.6206896551724138,589,0.6473236618309155
2018,3259,9,21,609,1178,0.3,-569,0.3407946278679351
2018,3260,7,23,440,1162,0.23333333333333334,-722,0.2746566791510612
2018,3261,19,9,1325,530,0.6785714285714286,795,0.7142857142857143
2018,3262,3,26,208,1451,0.10344827586206896,-1243,0.12537673297166968
2018,3263,21,9,1414,504,0.7,910,0.7372262773722628
2018,3264,13,18,835,983,0.41935483870967744,-148,0.4592959295929593
2018,3265,20,13,1463,799,0.6060606060606061,664,0.6467727674624226
2018,3266,23,9,1892,679,0.71875,1213,0.7359004278490859
2018,3267,7,20,510,1160,0.25925925925925924,-650,0.30538922155688625
2018,3268,25,7,2072,499,0.78125,1573,0.8059120964605212
2018,3269,12,16,863,946,0.42857142857142855,-83,0.47705914870093974
2018,3270,9,18,631,1053,0.3333333333333333,-422,0.3747030878859858
2018,3271,9,18,679,985,0.3333333333333333,-306,0.40805288461538464
2018,3272,10,20,697,1070,0.3333333333333333,-373,0.3944538766270515
2018,3273,30,2,2153,116,0.9375,2037,0.9488761568973116
2018,3274,21,10,1548,654,0.6774193548387096,894,0.7029972752043597
2018,3275,21,10,1532,629,0.6774193548387096,903,0.7089310504396112
2018,3276,22,9,1748,592,0.7096774193548387,1156,0.747008547008547
2018,3277,17,13,1384,861,0.5666666666666667,523,0.6164810690423163
2018,3278,23,8,2028,613,0.7419354838709677,1415,0.7678909503975767
2018,3279,12,19,909,1124,0.3870967741935484,-215,0.4471224790949336
2018,3280,32,1,2656,51,0.9696969696969697,2605,0.981159955670484
2018,3281,24,7,1760,402,0.7741935483870968,1358,0.8140610545790934
2018,3282,8,19,571,1160,0.2962962962962963,-589,0.3298671288272675
2018,3283,19,11,1441,665,0.6333333333333333,776,0.6842355175688509
2018,3284,10,21,642,1065,0.3225806451612903,-423,0.37609841827768015
2018,3285,13,17,907,1025,0.43333333333333335,-118,0.4694616977225673
2018,3286,14,15,992,957,0.4827586206896552,35,0.5089789635710621
2018,3287,19,11,1427,635,0.6333333333333333,792,0.6920465567410281
2018,3288,14,15,895,834,0.4827586206896552,61,0.5176402544823597
2018,3290,2,28,134,1592,0.06666666666666667,-1458,0.0776361529548088
2018,3291,9,20,620,1234,0.3103448275862069,-614,0.3344120819848975
2018,3292,18,12,1137,595,0.6,542,0.6564665127020786
2018,3293,10,19,770,1251,0.3448275862068966,-481,0.3809995051954478
2018,3294,26,6,1916,340,0.8125,1576,0.849290780141844
2018,3295,6,20,463,1235,0.23076923076923078,-772,0.27267373380447585
2018,3296,15,15,1233,1092,0.5,141,0.5303225806451612
2018,3297,8,22,524,1174,0.26666666666666666,-650,0.30859835100117783
2018,3298,24,7,1633,359,0.7741935483870968,1274,0.8197791164658634
2018,3299,21,8,1419,474,0.7241379310344828,945,0.7496038034865293
2018,3300,8,21,590,1232,0.27586206896551724,-642,0.3238199780461032
2018,3301,24,8,1684,460,0.75,1224,0.7854477611940298
2018,3303,9,16,637,908,0.36,-271,0.4122977346278317
2018,3304,21,10,1505,633,0.6774193548387096,872,0.7039289055191768
2018,3305,16,16,1241,980,0.5,261,0.5587573165240882
2018,3306,18,12,1167,624,0.6,543,0.6515912897822446
2018,3307,22,10,1834,705,0.6875,1129,0.7223316266246553
2018,3308,16,12,1147,694,0.5714285714285714,453,0.6230309614340033
2018,3309,14,15,1024,873,0.4827586206896552,151,0.5397996837111229
2018,3310,13,18,921,1112,0.41935483870967744,-191,0.45302508607968517
2018,3311,16,13,1144,725,0.5517241379310345,419,0.6120920278223649
2018,3312,3,26,214,1406,0.10344827586206896,-1192,0.13209876543209875
2018,3313,18,11,1233,565,0.6206896551724138,668,0.685761957730812
2018,3314,15,16,1197,1066,0.4838709677419355,131,0.5289438798055678
2018,3315,10,18,760,1039,0.35714285714285715,-279,0.4224569205113952
2018,3316,10,18,693,1018,0.35714285714285715,-325,0.40502630040911747
2018,3317,14,14,912,768,0.5,144,0.5428571428571428
2018,3318,16,14,1040,834,0.5333333333333333,206,0.5549626467449307
2018,3319,6,23,468,1502,0.20689655172413793,-1034,0.23756345177664975
2018,3320,18,13,1171,760,0.5806451612903226,411,0.6064215432418436
2018,3321,12,20,812,1166,0.375,-354,0.41051567239635994
2018,3322,3,22,185,1141,0.12,-956,0.13951734539969834
2018,3323,29,3,2501,210,0.90625,2291,0.9225378089265953
2018,3324,14,16,1069,1008,0.4666666666666667,61,0.5146846413095811
2018,3325,15,15,1091,901,0.5,190,0.5476907630522089
2018,3326,27,6,2361,448,0.8181818181818182,1913,0.8405126379494482
2018,3328,16,14,1303,975,0.5333333333333333,328,0.5719929762949956
2018,3329,20,10,1719,647,0.6666666666666666,1072,0.7265426880811496
2018,3330,8,23,522,1170,0.25806451612903225,-648,0.30851063829787234
2018,3331,15,13,1074,770,0.5357142857142857,304,0.5824295010845987
2018,3332,30,4,2502,284,0.8823529411764706,2218,0.8980617372577172
2018,3333,23,7,1794,413,0.7666666666666667,1381,0.8128681468056185
2018,3334,14,17,1133,1149,0.45161290322580644,-16,0.4964943032427695
2018,3335,20,8,1397,421,0.7142857142857143,976,0.7684268426842684
2018,3336,16,15,1171,966,0.5161290322580645,205,0.5479644361254095
2018,3337,10,20,770,1244,0.3333333333333333,-474,0.38232373386295926
2018,3338,10,20,695,1083,0.3333333333333333,-388,0.390888638920135
2018,3339,5,23,386,1362,0.17857142857142858,-976,0.2208237986270023
2018,3340,17,13,1290,873,0.5666666666666667,417,0.5963938973647711
2018,3341,13,16,956,1030,0.4482758620689655,-74,0.4813695871097684
2018,3342,12,18,858,944,0.4,-86,0.47613762486126526
2018,3343,24,5,1690,282,0.8275862068965517,1408,0.8569979716024341
2018,3344,10,21,677,1173,0.3225806451612903,-496,0.3659459459459459
2018,3345,18,13,1287,761,0.5806451612903226,526,0.62841796875
2018,3346,27,5,2028,282,0.84375,1746,0.8779220779220779
2018,3347,22,8,1424,385,0.7333333333333333,1039,0.7871752349364289
2018,3348,3,26,215,1456,0.10344827586206896,-1241,0.1286654697785757
2018,3349,22,9,1477,533,0.7096774193548387,944,0.7348258706467662
2018,3350,14,17,964,1060,0.45161290322580644,-96,0.4762845849802372
2018,3351,14,17,929,1024,0.45161290322580644,-95,0.4756784434203789
2018,3352,24,7,1576,346,0.7741935483870968,1230,0.8199791883454735
2018,3353,20,12,1394,684,0.625,710,0.670837343599615
2018,3354,10,18,708,886,0.35714285714285715,-178,0.44416562107904645
2018,3355,25,6,2047,384,0.8064516129032258,1663,0.842040312628548
2018,3356,16,14,1102,826,0.5333333333333333,276,0.5715767634854771
2018,3357,14,17,941,1007,0.45161290322580644,-66,0.4830595482546201
2018,3358,2,23,131,1238,0.08,-1107,0.09569028487947406
2018,3359,14,16,902,834,0.4666666666666667,68,0.5195852534562212
2018,3360,16,15,1086,895,0.5161290322580645,191,0.5482079757698132
2018,3361,10,19,749,1121,0.3448275862068966,-372,0.40053475935828875
2018,3362,16,15,1190,940,0.5161290322580645,250,0.5586854460093896
2018,3363,6,23,444,1522,0.20689655172413793,-1078,0.22583926754832145
2018,3364,12,17,900,1019,0.41379310344827586,-119,0.46899426784783743
2018,3365,8,21,448,1010,0.27586206896551724,-562,0.30727023319615915
2018,3366,3,25,187,1316,0.10714285714285714,-1129,0.12441783100465735
2018,3367,8,19,582,1107,0.2962962962962963,-525,0.34458259325044405
2018,3368,8,21,558,1256,0.27586206896551724,-698,0.30760749724366043
2018,3369,12,17,854,953,0.41379310344827586,-99,0.472606530160487
2018,3370,18,14,1295,910,0.5625,385,0.5873015873015873
2018,3371,16,15,1161,903,0.5161290322580645,258,0.5625
2018,3372,21,6,1519,343,0.7777777777777778,1176,0.8157894736842105
2018,3373,17,14,1088,810,0.5483870967741935,278,0.5732349841938883
2018,3374,10,20,627,1054,0.3333333333333333,-427,0.3729922665080309
2018,3375,18,12,1308,709,0.6,599,0.6484878532473971
2018,3376,26,6,2049,386,0.8125,1663,0.8414784394250513
2018,3377,23,6,1747,359,0.7931034482758621,1388,0.8295346628679962
2018,3378,26,7,2054,425,0.7878787878787878,1629,0.8285599031867689
2018,3379,13,15,911,908,0.4642857142857143,3,0.5008246289169873
2018,3380,16,13,1140,798,0.5517241379310345,342,0.5882352941176471
2018,3381,3,27,206,1556,0.1,-1350,0.11691259931895573
2018,3382,8,22,560,1331,0.26666666666666666,-771,0.29613960867266
2018,3383,13,17,888,998,0.43333333333333335,-110,0.4708377518557794
2018,3384,23,9,1950,614,0.71875,1336,0.7605304212168487
2018,3385,16,14,1170,821,0.5333333333333333,349,0.5876443997990959
2018,3386,18,14,1300,769,0.5625,531,0.6283228612856452
2018,3387,17,15,1309,1003,0.53125,306,0.5661764705882353
2018,3388,20,10,1505,632,0.6666666666666666,873,0.7042583060364997
2018,3389,4,26,280,1283,0.13333333333333333,-1003,0.17914267434420986
2018,3390,22,10,1542,633,0.6875,909,0.7089655172413794
2018,3391,15,14,1075,759,0.5172413793103449,316,0.5861504907306434
2018,3392,17,12,1113,688,0.5862068965517241,425,0.6179900055524709
2018,3393,22,8,1675,534,0.7333333333333333,1141,0.7582616568583069
2018,3394,15,12,1004,648,0.5555555555555556,356,0.6077481840193705
2018,3395,19,12,1529,778,0.6129032258064516,751,0.6627654963155614
2018,3396,12,19,865,1186,0.3870967741935484,-321,0.42174549000487566
2018,3397,24,7,1947,455,0.7741935483870968,1492,0.8105745212323064
2018,3398,5,21,361,1372,0.19230769230769232,-1011,0.20830929024812464
2018,3399,5,22,321,1258,0.18518518518518517,-937,0.2032932235592147
2018,3400,26,6,2148,435,0.8125,1713,0.8315911730545877
2018,3401,24,9,1959,584,0.7272727272727273,1375,0.7703499803381832
2018,3402,23,9,1746,517,0.71875,1229,0.7715422006186479
2018,3403,7,23,566,1316,0.23333333333333334,-750,0.3007438894792774
2018,3404,17,14,1279,922,0.5483870967741935,357,0.5810995002271695
2018,3405,17,14,1219,880,0.5483870967741935,339,0.5807527393997142
2018,3406,9,21,690,1199,0.3,-509,0.3652726310217046
2018,3407,16,13,1373,947,0.5517241379310345,426,0.5918103448275862
2018,3408,14,17,980,968,0.45161290322580644,12,0.5030800821355236
2018,3409,10,20,741,1124,0.3333333333333333,-383,0.39731903485254694
2018,3410,11,16,757,891,0.4074074074074074,-134,0.45934466019417475
2018,3411,17,12,1160,662,0.5862068965517241,498,0.6366630076838639
2018,3412,24,6,1758,376,0.8,1382,0.823805060918463
2018,3413,25,6,1868,352,0.8064516129032258,1516,0.8414414414414414
2018,3414,17,13,1314,839,0.5666666666666667,475,0.6103111936832327
2018,3415,11,22,844,1336,0.3333333333333333,-492,0.3871559633027523
2018,3416,21,10,1285,568,0.6774193548387096,717,0.6934700485698867
2018,3417,24,7,1849,478,0.7741935483870968,1371,0.7945853029651913
2018,3418,17,15,1162,779,0.53125,383,0.5986604842864502
2018,3419,2,26,139,1419,0.07142857142857142,-1280,0.08921694480102696
2018,3420,4,26,252,1294,0.13333333333333333,-1042,0.1630012936610608
2018,3421,16,15,1030,822,0.5161290322580645,208,0.5561555075593952
2018,3422,10,17,701,933,0.37037037037037035,-232,0.42900856793145653
2018,3423,10,19,698,1007,0.3448275862068966,-309,0.4093841642228739
2018,3424,19,11,1356,680,0.6333333333333333,676,0.6660117878192534
2018,3425,20,11,1405,695,0.6451612903225806,710,0.669047619047619
2018,3426,18,12,1160,714,0.6,446,0.6189967982924226
2018,3427,8,20,546,1117,0.2857142857142857,-571,0.32832230907997595
2018,3428,17,13,1322,822,0.5666666666666667,500,0.6166044776119403
2018,3429,6,23,420,1260,0.20689655172413793,-840,0.25
2018,3430,9,19,633,1072,0.32142857142857145,-439,0.3712609970674487
2018,3431,17,14,1211,801,0.5483870967741935,410,0.6018886679920478
2018,3433,7,22,481,1268,0.2413793103448276,-787,0.27501429388221843
2018,3434,11,18,802,1037,0.3793103448275862,-235,0.43610657966286026
2018,3435,7,24,535,1607,0.22580645161290322,-1072,0.24976657329598506
2018,3436,7,22,458,1171,0.2413793103448276,-713,0.28115408225905464
2018,3437,22,8,1509,498,0.7333333333333333,1011,0.7518684603886397
2018,3438,18,13,1233,693,0.5806451612903226,540,0.6401869158878505
2018,3439,18,13,1458,805,0.5806451612903226,653,0.6442775077330977
2018,3441,3,25,169,1286,0.10714285714285714,-1117,0.1161512027491409
2018,3442,19,9,1629,586,0.6785714285714286,1043,0.7354401805869074
2018,3443,23,8,1768,571,0.7419354838709677,1197,0.7558785805899957
2018,3444,15,15,1117,931,0.5,186,0.54541015625
2018,3447,5,23,306,1230,0.17857142857142858,-924,0.19921875
2018,3448,14,17,983,1069,0.45161290322580644,-86,0.4790448343079922
2018,3449,7,23,540,1472,0.23333333333333334,-932,0.268389662027833
2018,3450,10,20,753,1225,0.3333333333333333,-472,0.3806875631951466
2018,3451,18,10,1426,735,0.6428571428571429,691,0.6598796853308654
2018,3452,21,11,1651,696,0.65625,955,0.7034512143161483
2018,3453,29,3,1927,160,0.90625,1767,0.9233349305222808
2018,3454,20,11,1367,659,0.6451612903225806,708,0.6747285291214216
2018,3455,14,17,1004,1031,0.45161290322580644,-27,0.4933660933660934
2018,3456,16,14,1185,789,0.5333333333333333,396,0.6003039513677811
2018,3457,2,27,131,1299,0.06896551724137931,-1168,0.09160839160839161
2018,3458,9,21,651,1168,0.3,-517,0.35788894997251236
2018,3459,7,20,480,1113,0.25925925925925924,-633,0.3013182674199623
2018,3460,21,10,1577,630,0.6774193548387096,947,0.714544630720435
2018,3461,19,10,1244,520,0.6551724137931034,724,0.7052154195011338
2018,3462,10,20,663,1096,0.3333333333333333,-433,0.3769187038089824
2018,3463,15,13,1070,812,0.5357142857142857,258,0.5685441020191286
2018,3464,14,15,997,813,0.4827586206896552,184,0.550828729281768
2019,1101,23,6,1691,389,0.7931034482758621,1302,0.8129807692307692
2019,1102,13,18,1007,1082,0.41935483870967744,-75,0.4820488271900431
2019,1103,15,16,1107,1012,0.4838709677419355,95,0.5224162340726758
2019,1104,18,15,1390,979,0.5454545454545454,411,0.5867454622203462
2019,1105,5,27,349,1589,0.15625,-1240,0.18008255933952527
2019,1106,10,19,697,1206,0.3448275862068966,-509,0.36626379400945874
2019,1107,11,20,817,1254,0.3548387096774194,-437,0.3944954128440367
2019,1108,6,21,414,1215,0.2222222222222222,-801,0.2541436464088398
2019,1110,15,15,1147,1014,0.5,133,0.5307727903748265
2019,1111,8,21,698,1544,0.27586206896551724,-846,0.3113291703835861
2019,1112,17,15,1321,948,0.53125,373,0.5821947994711326
2019,1113,22,10,1800,690,0.6875,1110,0.7228915662650602
2019,1114,8,21,636,1497,0.27586206896551724,-861,0.2981715893108298
2019,1115,12,19,915,1109,0.3870967741935484,-194,0.45207509881422925
2019,1116,17,15,1383,1032,0.53125,351,0.5726708074534161
2019,1117,11,19,864,1319,0.36666666666666664,-455,0.39578561612459917
2019,1119,12,19,890,1287,0.3870967741935484,-397,0.4088194763435921
2019,1120,25,9,2045,637,0.7352941176470589,1408,0.7624906785980612
2019,1122,20,11,1650,832,0.6451612903225806,818,0.6647864625302176
2019,1123,15,17,1204,1166,0.46875,38,0.5080168776371308
2019,1124,19,13,1428,865,0.59375,563,0.6227649367640645
2019,1125,25,5,2234,372,0.8333333333333334,1862,0.8572524942440521
2019,1126,12,17,949,1140,0.41379310344827586,-191,0.4542843465773097
2019,1127,8,23,603,1353,0.25806451612903225,-750,0.30828220858895705
2019,1129,12,20,934,1348,0.375,-414,0.4092900964066608
2019,1130,14,17,1034,1162,0.45161290322580644,-128,0.470856102003643
2019,1131,14,18,1052,1239,0.4375,-187,0.4591881274552597
2019,1132,20,12,1667,828,0.625,839,0.6681362725450902
2019,1133,19,14,1318,872,0.5757575757575758,446,0.6018264840182649
2019,1135,17,11,1305,708,0.6071428571428571,597,0.6482861400894188
2019,1136,10,20,714,1374,0.3333333333333333,-660,0.34195402298850575
2019,1137,21,12,1717,817,0.6363636363636364,900,0.6775848460931334
2019,1138,30,3,2551,248,0.9090909090909091,2303,0.9113969274740978
2019,1139,16,16,1270,1028,0.5,242,0.5526544821583986
2019,1140,19,13,1563,964,0.59375,599,0.6185199841709537
2019,1141,20,11,1667,819,0.6451612903225806,848,0.670555108608206
2019,1142,4,23,314,1466,0.14814814814814814,-1152,0.17640449438202246
2019,1143,8,23,618,1503,0.25806451612903225,-885,0.2913719943422914
2019,1144,17,12,1293,859,0.5862068965517241,434,0.6008364312267658
2019,1145,15,17,1094,1156,0.46875,-62,0.4862222222222222
2019,1146,11,19,864,1265,0.36666666666666664,-401,0.40582433067167684
2019,1148,9,20,742,1296,0.3103448275862069,-554,0.36408243375858684
2019,1149,13,15,1059,985,0.4642857142857143,74,0.5181017612524462
2019,1150,8,21,498,1278,0.27586206896551724,-780,0.28040540540540543
2019,1151,9,20,672,1330,0.3103448275862069,-658,0.3356643356643357
2019,1152,1,29,80,1716,0.03333333333333333,-1636,0.044543429844097995
2019,1153,28,6,2070,368,0.8235294117647058,1702,0.8490566037735849
2019,1154,9,18,772,1369,0.3333333333333333,-597,0.36057916861279776
2019,1155,19,13,1371,838,0.59375,533,0.6206428248076052
2019,1156,8,21,659,1470,0.27586206896551724,-811,0.3095349929544387
2019,1157,13,16,1105,1080,0.4482758620689655,25,0.505720823798627
2019,1158,23,9,1739,627,0.71875,1112,0.7349957734573119
2019,1159,23,10,1808,684,0.696969696969697,1124,0.7255216693418941
2019,1160,21,12,1664,775,0.6363636363636364,889,0.6822468224682247
2019,1161,11,20,913,1380,0.3548387096774194,-467,0.3981683384212822
2019,1162,8,18,614,1258,0.3076923076923077,-644,0.327991452991453
2019,1163,16,17,1325,1111,0.48484848484848486,214,0.5439244663382594
2019,1164,8,25,591,1527,0.24242424242424243,-936,0.2790368271954674
2019,1165,13,15,950,948,0.4642857142857143,2,0.5005268703898841
2019,1166,17,14,1415,995,0.5483870967741935,420,0.5871369294605809
2019,1167,13,15,1004,948,0.4642857142857143,56,0.514344262295082
2019,1168,14,17,1093,1081,0.45161290322580644,12,0.5027598896044159
2019,1169,12,20,996,1445,0.375,-449,0.4080294961081524
2019,1170,12,16,883,1068,0.42857142857142855,-185,0.45258841619682216
2019,1171,9,19,711,1235,0.32142857142857145,-524,0.3653648509763618
2019,1172,23,9,1687,553,0.71875,1134,0.753125
2019,1173,21,11,1636,697,0.65625,939,0.7012430347192457
2019,1174,15,16,1156,1026,0.4838709677419355,130,0.5297891842346472
2019,1175,4,25,284,1490,0.13793103448275862,-1206,0.1600901916572717
2019,1176,7,22,521,1472,0.2413793103448276,-951,0.2614149523331661
2019,1177,15,15,1251,1055,0.5,196,0.5424978317432784
2019,1178,11,20,930,1349,0.3548387096774194,-419,0.40807371654234315
2019,1179,22,9,1713,581,0.7096774193548387,1132,0.7467306015693113
2019,1180,12,19,951,1356,0.3870967741935484,-405,0.41222366710013003
2019,1181,29,5,2447,392,0.8529411764705882,2055,0.8619232123987319
2019,1182,19,13,1513,838,0.59375,675,0.6435559336452573
2019,1183,13,18,1005,1204,0.41935483870967744,-199,0.45495699411498414
2019,1184,11,18,900,1410,0.3793103448275862,-510,0.38961038961038963
2019,1185,11,17,837,997,0.39285714285714285,-160,0.4563794983642312
2019,1186,15,18,1235,1133,0.45454545454545453,102,0.5215371621621622
2019,1187,10,21,764,1324,0.3225806451612903,-560,0.36590038314176243
2019,1188,8,21,675,1419,0.27586206896551724,-744,0.3223495702005731
2019,1189,9,21,671,1405,0.3,-734,0.32321772639691715
2019,1190,22,9,1807,590,0.7096774193548387,1217,0.7538589904046725
2019,1191,9,21,688,1389,0.3,-701,0.33124699085219067
2019,1192,18,13,1440,877,0.5806451612903226,563,0.6214933103150626
2019,1193,9,22,614,1458,0.2903225806451613,-844,0.29633204633204635
2019,1194,14,15,1001,1008,0.4827586206896552,-7,0.49825783972125437
2019,1195,12,18,926,1186,0.4,-260,0.4384469696969697
2019,1196,19,15,1405,916,0.5588235294117647,489,0.6053425247738043
2019,1197,10,19,698,1087,0.3448275862068966,-389,0.39103641456582633
2019,1198,15,13,1241,963,0.5357142857142857,278,0.5630671506352087
2019,1199,27,7,2091,456,0.7941176470588235,1635,0.8209658421672555
2019,1200,11,20,799,1203,0.3548387096774194,-404,0.3991008991008991
2019,1201,22,9,1753,604,0.7096774193548387,1149,0.7437420449724226
2019,1202,22,7,1764,445,0.7586206896551724,1319,0.7985513807152558
2019,1203,9,24,634,1463,0.2727272727272727,-829,0.3023366714353839
2019,1204,19,12,1590,896,0.6129032258064516,694,0.6395816572807723
2019,1205,20,11,1553,796,0.6451612903225806,757,0.6611323967645807
2019,1206,18,15,1354,960,0.5454545454545454,394,0.5851339671564391
2019,1207,19,13,1630,927,0.59375,703,0.6374657802111849
2019,1208,11,21,924,1350,0.34375,-426,0.40633245382585753
2019,1209,23,9,1800,626,0.71875,1174,0.7419620774938169
2019,1210,14,18,1057,1034,0.4375,23,0.5054997608799617
2019,1211,30,3,2722,210,0.9090909090909091,2512,0.9283765347885402
2019,1212,14,16,1024,1044,0.4666666666666667,-20,0.4951644100580271
2019,1213,19,13,1517,885,0.59375,632,0.6315570358034971
2019,1214,12,16,1019,1218,0.42857142857142855,-199,0.45552078676799285
2019,1216,17,15,1321,1063,0.53125,258,0.5541107382550335
2019,1217,17,11,1261,735,0.6071428571428571,526,0.6317635270541082
2019,1218,16,13,1245,824,0.5517241379310345,421,0.6017399710004834
2019,1219,14,15,980,944,0.4827586206896552,36,0.5093555093555093
2019,1220,26,7,2213,521,0.7878787878787878,1692,0.8094367227505487
2019,1221,16,17,1161,1055,0.48484848484848486,106,0.5239169675090253
2019,1222,31,3,2381,190,0.9117647058823529,2191,0.9260987942434851
2019,1223,10,18,884,1331,0.35714285714285715,-447,0.399097065462754
2019,1224,14,16,1098,1192,0.4666666666666667,-94,0.4794759825327511
2019,1225,3,26,235,1681,0.10344827586206896,-1446,0.12265135699373696
2019,1226,9,19,670,1339,0.32142857142857145,-669,0.33349925335988057
2019,1227,14,16,1080,1141,0.4666666666666667,-61,0.48626744709590275
2019,1228,12,21,975,1423,0.36363636363636365,-448,0.40658882402001667
2019,1229,16,16,1147,1031,0.5,116,0.5266299357208448
2019,1230,2,25,145,1618,0.07407407407407407,-1473,0.0822461712989223
2019,1231,17,15,1356,933,0.53125,423,0.5923984272608126
2019,1232,13,16,975,1014,0.4482758620689655,-39,0.49019607843137253
2019,1233,17,15,1349,1110,0.53125,239,0.5485969906466043
2019,1234,22,11,1830,754,0.6666666666666666,1076,0.708204334365325
2019,1235,23,11,1839,794,0.6764705882352942,1045,0.6984428408659324
2019,1236,15,15,1329,1070,0.5,259,0.5539808253438933
2019,1237,14,16,1076,1147,0.4666666666666667,-71,0.4840305892937472
2019,1238,11,19,725,1111,0.36666666666666664,-386,0.394880174291939
2019,1239,10,20,812,1350,0.3333333333333333,-538,0.3755781683626272
2019,1240,22,9,1750,614,0.7096774193548387,1136,0.7402707275803723
2019,1241,12,19,933,1221,0.3870967741935484,-288,0.4331476323119777
2019,1242,25,9,1974,589,0.7352941176470589,1385,0.7701911822083496
2019,1243,25,8,1726,446,0.7575757575757576,1280,0.7946593001841621
2019,1244,4,26,300,1572,0.13333333333333333,-1272,0.16025641025641027
2019,1245,20,10,1562,681,0.6666666666666666,881,0.6963887650468124
2019,1246,27,6,2089,443,0.8181818181818182,1646,0.8250394944707741
2019,1247,10,21,712,1379,0.3225806451612903,-667,0.3405069344811095
2019,1248,9,20,693,1421,0.3103448275862069,-728,0.32781456953642385
2019,1249,16,13,1277,893,0.5517241379310345,384,0.588479262672811
2019,1250,20,11,1687,792,0.6451612903225806,895,0.6805163372327552
2019,1251,25,6,1820,418,0.8064516129032258,1402,0.8132260947274352
2019,1252,23,7,1967,487,0.7666666666666667,1480,0.8015484922575387
2019,1253,13,19,989,1354,0.40625,-365,0.422108408023901
2019,1254,15,16,1182,1082,0.4838709677419355,100,0.5220848056537103
2019,1255,12,17,879,1116,0.41379310344827586,-237,0.4406015037593985
2019,1256,18,13,1359,851,0.5806451612903226,508,0.6149321266968326
2019,1257,20,13,1583,877,0.6060606060606061,706,0.6434959349593496
2019,1258,18,11,1268,645,0.6206896551724138,623,0.6628332462101412
2019,1259,11,21,874,1458,0.34375,-584,0.3747855917667238
2019,1260,19,13,1395,700,0.59375,695,0.665871121718377
2019,1261,26,6,2136,468,0.8125,1668,0.8202764976958525
2019,1262,13,17,1112,1146,0.43333333333333335,-34,0.4924712134632418
2019,1263,4,27,281,1609,0.12903225806451613,-1328,0.14867724867724869
2019,1264,11,21,709,1124,0.34375,-415,0.386797599563557
2019,1265,12,19,878,1208,0.3870967741935484,-330,0.42090124640460214
2019,1266,24,9,1938,627,0.7272727272727273,1311,0.7555555555555555
2019,1267,19,14,1651,996,0.5757575757575758,655,0.623724971666037
2019,1268,22,10,1659,624,0.6875,1035,0.7266754270696452
2019,1269,11,21,894,1369,0.34375,-475,0.39505081749889526
2019,1270,6,21,497,1329,0.2222222222222222,-832,0.27217962760131437
2019,1271,5,25,333,1355,0.16666666666666666,-1022,0.19727488151658767
2019,1272,21,13,1794,947,0.6176470588235294,847,0.6545056548704852
2019,1273,9,20,712,1341,0.3103448275862069,-629,0.3468095470043838
2019,1274,14,18,1086,1211,0.4375,-125,0.4727905964301263
2019,1275,13,17,968,1120,0.43333333333333335,-152,0.46360153256704983
2019,1276,28,6,2018,375,0.8235294117647058,1643,0.8432929377350606
2019,1277,28,6,2241,439,0.8235294117647058,1802,0.8361940298507463
2019,1278,21,13,1637,770,0.6176470588235294,867,0.6800997091815538
2019,1279,20,12,1583,830,0.625,753,0.6560298383754662
2019,1280,23,10,1832,720,0.696969696969697,1112,0.7178683385579937
2019,1281,15,17,1061,1089,0.46875,-28,0.49348837209302326
2019,1282,10,21,795,1331,0.3225806451612903,-536,0.37394167450611476
2019,1283,15,16,1070,1026,0.4838709677419355,44,0.5104961832061069
2019,1284,14,21,986,1300,0.4,-314,0.43132108486439197
2019,1285,24,8,1923,528,0.75,1395,0.784577723378213
2019,1286,14,17,1193,1226,0.45161290322580644,-33,0.49317899958660605
2019,1287,11,20,850,1376,0.3548387096774194,-526,0.38185085354896675
2019,1288,8,20,609,1390,0.2857142857142857,-781,0.3046523261630815
2019,1290,5,26,347,1609,0.16129032258064516,-1262,0.17740286298568508
2019,1291,7,22,504,1431,0.2413793103448276,-927,0.26046511627906976
2019,1292,9,21,664,1284,0.3,-620,0.3408624229979466
2019,1293,25,4,2072,294,0.8620689655172413,1778,0.8757396449704142
2019,1294,19,11,1464,742,0.6333333333333333,722,0.6636446056210336
2019,1295,16,15,1218,1023,0.5161290322580645,195,0.5435073627844712
2019,1296,15,17,1200,1140,0.46875,60,0.5128205128205128
2019,1297,24,8,1925,564,0.75,1361,0.7734029730815588
2019,1298,12,19,877,1184,0.3870967741935484,-307,0.4255215914604561
2019,1299,17,13,1232,813,0.5666666666666667,419,0.6024449877750612
2019,1300,15,15,1127,904,0.5,223,0.5548990645002462
2019,1301,22,11,1873,754,0.6666666666666666,1119,0.7129805862200228
2019,1303,20,11,1654,775,0.6451612903225806,879,0.6809386578839028
2019,1304,17,16,1320,1035,0.5151515151515151,285,0.5605095541401274
2019,1305,29,4,2415,247,0.8787878787878788,2168,0.9072126220886552
2019,1306,3,24,190,1344,0.1111111111111111,-1154,0.12385919165580182
2019,1307,13,18,1064,1276,0.41935483870967744,-212,0.4547008547008547
2019,1308,28,4,2228,257,0.875,1971,0.896579476861167
2019,1309,15,13,1132,794,0.5357142857142857,338,0.5877466251298027
2019,1310,13,19,1019,1299,0.40625,-280,0.43960310612597064
2019,1311,10,17,771,1146,0.37037037037037035,-375,0.40219092331768386
2019,1312,20,12,1507,730,0.625,777,0.6736700938757264
2019,1313,18,13,1388,845,0.5806451612903226,543,0.6215853112404837
2019,1314,27,6,2416,424,0.8181818181818182,1992,0.8507042253521127
2019,1315,8,18,625,1207,0.3076923076923077,-582,0.3411572052401747
2019,1316,14,17,1093,1193,0.45161290322580644,-100,0.4781277340332458
2019,1317,18,12,1314,704,0.6,610,0.6511397423191279
2019,1318,23,10,1827,684,0.696969696969697,1143,0.7275985663082437
2019,1319,10,21,818,1444,0.3225806451612903,-626,0.3616268788682582
2019,1320,14,18,942,1101,0.4375,-159,0.461086637298091
2019,1321,13,19,976,1132,0.40625,-156,0.4629981024667932
2019,1322,8,20,575,1204,0.2857142857142857,-629,0.32321528948847666
2019,1323,14,19,1099,1167,0.42424242424242425,-68,0.4849955869373345
2019,1324,15,17,1254,1187,0.46875,67,0.51372388365424
2019,1325,13,17,1025,1052,0.43333333333333335,-27,0.49350024073182475
2019,1326,19,14,1459,839,0.5757575757575758,620,0.6348999129677981
2019,1328,19,13,1480,797,0.59375,683,0.6499780412823891
2019,1329,12,20,917,1261,0.375,-344,0.42102846648301195
2019,1330,26,8,1762,488,0.7647058823529411,1274,0.7831111111111111
2019,1331,9,21,714,1412,0.3,-698,0.33584195672624645
2019,1332,23,12,1690,777,0.6571428571428571,913,0.6850425618159708
2019,1333,18,13,1413,862,0.5806451612903226,551,0.6210989010989011
2019,1334,12,18,893,1080,0.4,-187,0.45261023821591484
2019,1335,18,12,1403,735,0.6,668,0.6562207670720299
2019,1336,14,18,1054,1175,0.4375,-121,0.4728577837595334
2019,1337,15,18,1197,1275,0.45454545454545453,-78,0.4842233009708738
2019,1338,14,19,1109,1197,0.42424242424242425,-88,0.48091934084995663
2019,1339,5,25,355,1535,0.16666666666666666,-1180,0.18783068783068782
2019,1340,13,16,1035,1101,0.4482758620689655,-66,0.4845505617977528
2019,1341,21,12,1641,829,0.6363636363636364,812,0.6643724696356276
2019,1342,15,15,1212,1091,0.5,121,0.5262700825010855
2019,1343,14,12,987,785,0.5384615384615384,202,0.5569977426636569
2019,1344,18,15,1363,993,0.5454545454545454,370,0.5785229202037352
2019,1345,23,9,1821,617,0.71875,1204,0.7469237079573421
2019,1346,16,14,1267,946,0.5333333333333333,321,0.5725259828287392
2019,1347,19,11,1463,704,0.6333333333333333,759,0.6751269035532995
2019,1348,18,15,1403,890,0.5454545454545454,513,0.6118621892716964
2019,1349,11,19,850,1359,0.36666666666666664,-509,0.3847894975101856
2019,1350,13,20,1035,1279,0.3939393939393939,-244,0.44727744165946415
2019,1351,16,15,1270,1111,0.5161290322580645,159,0.5333893322133557
2019,1352,15,16,1025,1043,0.4838709677419355,-18,0.49564796905222436
2019,1353,14,17,980,1125,0.45161290322580644,-145,0.4655581947743468
2019,1354,6,26,432,1767,0.1875,-1335,0.19645293315143247
2019,1355,23,8,2002,628,0.7419354838709677,1374,0.7612167300380228
2019,1356,17,15,1301,893,0.53125,408,0.5929808568824065
2019,1357,14,17,1146,1298,0.45161290322580644,-152,0.46890343698854337
2019,1358,18,11,1393,751,0.6206896551724138,642,0.6497201492537313
2019,1359,16,16,1327,1190,0.5,137,0.5272149384187524
2019,1360,20,14,1477,959,0.5882352941176471,518,0.6063218390804598
2019,1361,20,13,1530,808,0.6060606060606061,722,0.6544054747647562
2019,1362,20,10,1534,736,0.6666666666666666,798,0.6757709251101321
2019,1363,3,27,235,1718,0.1,-1483,0.12032770097286226
2019,1364,20,10,1525,628,0.6666666666666666,897,0.7083139804923363
2019,1365,15,15,1135,898,0.5,237,0.558288243974422
2019,1366,10,20,829,1426,0.3333333333333333,-597,0.36762749445676274
2019,1367,3,26,239,1670,0.10344827586206896,-1431,0.1251964379256155
2019,1368,15,16,1112,948,0.4838709677419355,164,0.5398058252427185
2019,1369,8,21,603,1439,0.27586206896551724,-836,0.29529872673849167
2019,1370,16,14,1258,892,0.5333333333333333,366,0.5851162790697675
2019,1371,20,13,1556,884,0.6060606060606061,672,0.6377049180327868
2019,1372,10,16,721,1063,0.38461538461538464,-342,0.40414798206278024
2019,1373,17,16,1118,1013,0.5151515151515151,105,0.5246363209760676
2019,1374,15,17,1201,1102,0.46875,99,0.5214937038645245
2019,1375,15,17,1138,1148,0.46875,-10,0.4978127734033246
2019,1376,15,16,1181,1049,0.4838709677419355,132,0.5295964125560538
2019,1377,11,17,817,1140,0.39285714285714285,-323,0.4174757281553398
2019,1378,18,13,1316,901,0.5806451612903226,415,0.593594948128101
2019,1379,17,11,1287,669,0.6071428571428571,618,0.6579754601226994
2019,1380,6,25,432,1571,0.1935483870967742,-1139,0.21567648527209185
2019,1381,14,16,1106,1100,0.4666666666666667,6,0.5013599274705349
2019,1382,18,16,1260,990,0.5294117647058824,270,0.56
2019,1383,15,15,1133,944,0.5,189,0.5454983148772268
2019,1384,16,14,1256,980,0.5333333333333333,276,0.5617173524150268
2019,1385,21,12,1739,819,0.6363636363636364,920,0.6798279906176701
2019,1386,14,19,1051,1277,0.42424242424242425,-226,0.45146048109965636
2019,1387,23,12,1589,758,0.6571428571428571,831,0.6770345121431615
2019,1388,22,11,1685,721,0.6666666666666666,964,0.700332502078138
2019,1389,10,22,726,1286,0.3125,-560,0.36083499005964215
2019,1390,15,16,1249,1006,0.4838709677419355,243,0.553880266075388
2019,1391,5,24,370,1593,0.1724137931034483,-1223,0.18848700967906265
2019,1392,23,8,1692,496,0.7419354838709677,1196,0.773308957952468
2019,1393,20,13,1474,827,0.6060606060606061,647,0.6405910473707084
2019,1394,10,18,717,1073,0.35714285714285715,-356,0.4005586592178771
2019,1395,20,13,1580,865,0.6060606060606061,715,0.6462167689161554
2019,1396,23,9,1803,592,0.71875,1211,0.7528183716075156
2019,1397,28,5,2321,374,0.8484848484848485,1947,0.8612244897959184
2019,1398,7,21,528,1449,0.25,-921,0.26707132018209406
2019,1399,6,23,468,1421,0.20689655172413793,-953,0.24775013234515617
2019,1400,16,16,1234,1030,0.5,204,0.5450530035335689
2019,1401,14,18,1054,1199,0.4375,-145,0.467820683533067
2019,1402,22,9,1602,585,0.7096774193548387,1017,0.7325102880658436
2019,1403,26,6,1973,366,0.8125,1607,0.8435228730226593
2019,1404,10,19,805,1352,0.3448275862068966,-547,0.3732035234121465
2019,1405,24,7,1844,530,0.7741935483870968,1314,0.776748104465038
2019,1406,9,22,689,1388,0.2903225806451613,-699,0.33172845450168514
2019,1407,10,18,805,1191,0.35714285714285715,-386,0.4033066132264529
2019,1408,4,27,329,1753,0.12903225806451613,-1424,0.1580211335254563
2019,1409,18,14,1379,917,0.5625,462,0.600609756097561
2019,1410,17,16,1257,1042,0.5151515151515151,215,0.5467594606350588
2019,1411,19,13,1567,964,0.59375,603,0.6191228763334651
2019,1412,18,14,1325,915,0.5625,410,0.5915178571428571
2019,1413,9,20,632,1233,0.3103448275862069,-601,0.3388739946380697
2019,1414,29,5,2140,324,0.8529411764705882,1816,0.8685064935064936
2019,1415,7,23,503,1388,0.23333333333333334,-885,0.2659968270756214
2019,1416,23,8,1731,505,0.7419354838709677,1226,0.7741502683363148
2019,1417,17,16,1448,1132,0.5151515151515151,316,0.5612403100775194
2019,1418,17,13,1420,974,0.5666666666666667,446,0.5931495405179615
2019,1419,17,15,1394,1096,0.53125,298,0.5598393574297189
2019,1420,18,13,1240,779,0.5806451612903226,461,0.6141654284299158
2019,1421,2,26,128,1493,0.07142857142857142,-1365,0.07896360271437385
2019,1422,26,6,2009,360,0.8125,1649,0.848037146475306
2019,1423,9,23,778,1624,0.28125,-846,0.32389675270607826
2019,1424,17,14,1324,952,0.5483870967741935,372,0.5817223198594025
2019,1425,16,17,1320,1198,0.48484848484848486,122,0.5242255758538522
2019,1426,16,16,1211,983,0.5,228,0.5519598906107566
2019,1427,14,14,1160,970,0.5,190,0.5446009389671361
2019,1428,17,14,1420,923,0.5483870967741935,497,0.6060606060606061
2019,1429,27,6,2207,401,0.8181818181818182,1806,0.8462423312883436
2019,1430,22,9,1767,603,0.7096774193548387,1164,0.7455696202531645
2019,1431,6,21,428,1275,0.2222222222222222,-847,0.25132119788608337
2019,1433,25,7,1828,458,0.78125,1370,0.799650043744532
2019,1434,13,18,917,1070,0.41935483870967744,-153,0.4614997483643684
2019,1435,9,23,797,1383,0.28125,-586,0.36559633027522936
2019,1436,26,6,1927,390,0.8125,1537,0.8316788951230039
2019,1437,25,9,1940,592,0.7352941176470589,1348,0.7661927330173776
2019,1438,29,3,2099,200,0.90625,1899,0.9130056546324489
2019,1439,24,8,1865,503,0.75,1362,0.7875844594594594
2019,1440,8,21,689,1451,0.27586206896551724,-762,0.3219626168224299
2019,1441,6,25,526,1684,0.1935483870967742,-1158,0.23800904977375564
2019,1442,8,21,618,1401,0.27586206896551724,-783,0.3060921248142645
2019,1443,20,14,1509,920,0.5882352941176471,589,0.6212433100041169
2019,1444,7,24,580,1567,0.22580645161290322,-987,0.2701443875174662
2019,1447,11,17,785,994,0.39285714285714285,-209,0.4412591343451377
2019,1448,11,20,826,1293,0.3548387096774194,-467,0.389806512505899
2019,1449,26,8,1871,503,0.7647058823529411,1368,0.7881213142375737
2019,1450,11,21,947,1446,0.34375,-499,0.39573756790639364
2019,1451,16,15,1384,1010,0.5161290322580645,374,0.5781119465329991
2019,1452,14,20,1164,1323,0.4117647058823529,-159,0.4680337756332931
2019,1453,15,16,1260,1171,0.4838709677419355,89,0.5183052241875771
2019,1454,8,22,602,1457,0.26666666666666666,-855,0.2923749392909179
2019,1455,19,14,1443,890,0.5757575757575758,553,0.6185169309901415
2019,1456,13,17,1013,1202,0.43333333333333335,-189,0.45733634311512417
2019,1457,15,12,1264,876,0.5555555555555556,388,0.5906542056074766
2019,1458,23,10,1657,622,0.696969696969697,1035,0.7270732777534006
2019,1459,26,4,2171,265,0.8666666666666667,1906,0.8912151067323482
2019,1460,19,13,1510,833,0.59375,677,0.6444728979940247
2019,1461,7,24,529,1511,0.22580645161290322,-982,0.2593137254901961
2019,1462,18,15,1385,987,0.5454545454545454,398,0.5838954468802698
2019,1463,21,7,1759,506,0.75,1253,0.7766004415011037
2019,1464,10,20,781,1424,0.3333333333333333,-643,0.35419501133786846
2019,1465,12,14,961,1001,0.46153846153846156,-40,0.48980632008154945
2019,1466,7,22,497,1406,0.2413793103448276,-909,0.2611665790856542
2019,3101,19,9,1474,547,0.6785714285714286,927,0.7293419099455715
2019,3102,7,22,530,1202,0.2413793103448276,-672,0.30600461893764436
2019,3103,15,14,1070,853,0.5172413793103449,217,0.5564222568902756
2019,3104,14,17,1000,974,0.45161290322580644,26,0.5065856129685917
2019,3105,13,17,862,924,0.43333333333333335,-62,0.4826427771556551
2019,3106,10,19,687,982,0.3448275862068966,-295,0.4116237267825045
2019,3107,13,18,821,893,0.41935483870967744,-72,0.4789964994165694
2019,3108,3,24,207,1322,0.1111111111111111,-1115,0.1353826030085023
2019,3110,22,10,1474,589,0.6875,885,0.7144934561318468
2019,3111,18,14,1287,892,0.5625,395,0.5906379072969252
2019,3112,18,13,1301,835,0.5806451612903226,466,0.6090823970037453
2019,3113,20,10,1402,587,0.6666666666666666,815,0.7048768225238814
2019,3114,21,10,1381,532,0.6774193548387096,849,0.7219027705175117
2019,3115,2,19,125,923,0.09523809523809523,-798,0.11927480916030535
2019,3116,20,14,1538,932,0.5882352941176471,606,0.622672064777328
2019,3117,12,18,871,1159,0.4,-288,0.429064039408867
2019,3119,10,19,622,1003,0.3448275862068966,-381,0.38276923076923075
2019,3120,21,9,1569,582,0.7,987,0.7294281729428173
2019,3122,13,15,953,929,0.4642857142857143,24,0.5063761955366631
2019,3123,7,23,510,1377,0.23333333333333334,-867,0.2702702702702703
2019,3124,31,1,2512,63,0.96875,2449,0.9755339805825243
2019,3125,26,6,2013,409,0.8125,1604,0.8311312964492156
2019,3126,19,10,1267,535,0.6551724137931034,732,0.7031076581576027
2019,3127,10,18,661,984,0.35714285714285715,-323,0.40182370820668695
2019,3129,26,4,1973,246,0.8666666666666667,1727,0.8891392519152772
2019,3130,14,16,1141,1064,0.4666666666666667,77,0.5174603174603175
2019,3131,15,14,918,789,0.5172413793103449,129,0.5377855887521968
2019,3132,8,21,620,1385,0.27586206896551724,-765,0.3092269326683292
2019,3133,19,10,1419,621,0.6551724137931034,798,0.6955882352941176
2019,3135,7,21,561,1360,0.25,-799,0.2920353982300885
2019,3136,11,19,787,1153,0.36666666666666664,-366,0.4056701030927835
2019,3137,28,5,2114,281,0.8484848484848485,1833,0.8826722338204593
2019,3138,23,9,1824,611,0.71875,1213,0.7490759753593429
2019,3139,21,9,1448,530,0.7,918,0.7320525783619818
2019,3140,25,6,1765,381,0.8064516129032258,1384,0.8224603914259087
2019,3141,25,7,2097,474,0.78125,1623,0.8156359393232205
2019,3142,5,21,329,1195,0.19230769230769232,-866,0.2158792650918635
2019,3143,19,12,1420,824,0.6129032258064516,596,0.6327985739750446
2019,3144,19,12,1152,648,0.6129032258064516,504,0.64
2019,3145,11,19,662,1066,0.36666666666666664,-404,0.38310185185185186
2019,3146,8,18,571,986,0.3076923076923077,-415,0.36673089274245346
2019,3148,7,21,450,1206,0.25,-756,0.2717391304347826
2019,3149,11,18,782,1016,0.3793103448275862,-234,0.43492769744160176
2019,3150,18,12,1201,657,0.6,544,0.6463939720129172
2019,3151,13,17,915,947,0.43333333333333335,-32,0.49140708915145004
2019,3152,2,27,114,1495,0.06896551724137931,-1381,0.07085146053449347
2019,3153,21,10,1498,580,0.6774193548387096,918,0.7208854667949952
2019,3155,19,12,1405,735,0.6129032258064516,670,0.6565420560747663
2019,3156,8,20,584,1155,0.2857142857142857,-571,0.3358251868890167
2019,3157,15,14,1139,832,0.5172413793103449,307,0.5778792491121258
2019,3158,6,23,434,1295,0.20689655172413793,-861,0.25101214574898784
2019,3159,12,17,857,1008,0.41379310344827586,-151,0.45951742627345843
2019,3160,12,18,893,1040,0.4,-147,0.4619762027935851
2019,3161,6,22,373,1105,0.21428571428571427,-732,0.2523680649526387
2019,3162,8,19,611,1141,0.2962962962962963,-530,0.3487442922374429
2019,3163,31,2,2600,126,0.9393939393939394,2474,0.9537784299339692
2019,3164,5,25,333,1383,0.16666666666666666,-1050,0.19405594405594406
2019,3165,12,14,761,747,0.46153846153846156,14,0.5046419098143236
2019,3166,15,16,1085,931,0.4838709677419355,154,0.5381944444444444
2019,3167,12,17,844,957,0.41379310344827586,-113,0.46862853970016655
2019,3168,13,16,853,949,0.4482758620689655,-96,0.4733629300776915
2019,3169,16,15,1054,834,0.5161290322580645,220,0.5582627118644068
2019,3170,9,19,707,1210,0.32142857142857145,-503,0.3688054251434533
2019,3171,13,14,846,806,0.48148148148148145,40,0.5121065375302664
2019,3172,16,14,1143,825,0.5333333333333333,318,0.5807926829268293
2019,3173,17,13,1240,732,0.5666666666666667,508,0.6288032454361054
2019,3174,16,15,1114,792,0.5161290322580645,322,0.5844700944386149
2019,3175,5,21,323,1215,0.19230769230769232,-892,0.21001300390117036
2019,3176,17,13,1532,887,0.5666666666666667,645,0.6333195535345184
2019,3177,26,7,2154,526,0.7878787878787878,1628,0.8037313432835821
2019,3178,3,25,162,1307,0.10714285714285714,-1145,0.1102791014295439
2019,3179,26,6,2115,456,0.8125,1659,0.822637106184364
2019,3180,24,8,1518,411,0.75,1107,0.7869362363919129
2019,3181,15,15,1047,862,0.5,185,0.5484546883184913
2019,3182,19,13,1394,694,0.59375,700,0.6676245210727969
2019,3183,8,18,550,1053,0.3076923076923077,-503,0.3431066749844042
2019,3185,13,17,850,1040,0.43333333333333335,-190,0.4497354497354497
2019,3186,12,20,867,1148,0.375,-281,0.430272952853598
2019,3187,16,15,1069,827,0.5161290322580645,242,0.5638185654008439
2019,3188,12,16,798,922,0.42857142857142855,-124,0.46395348837209305
2019,3189,8,21,586,1191,0.27586206896551724,-605,0.3297692740574001
2019,3190,10,21,775,1328,0.3225806451612903,-553,0.36852116024726583
2019,3191,4,26,259,1439,0.13333333333333333,-1180,0.1525323910482921
2019,3192,6,22,404,1158,0.21428571428571427,-754,0.2586427656850192
2019,3193,11,20,714,1020,0.3548387096774194,-306,0.4117647058823529
2019,3194,5,25,355,1355,0.16666666666666666,-1000,0.20760233918128654
2019,3195,26,4,1987,228,0.8666666666666667,1759,0.8970654627539504
2019,3196,8,23,525,1358,0.25806451612903225,-833,0.2788104089219331
2019,3197,3,25,174,1248,0.10714285714285714,-1074,0.12236286919831224
2019,3198,5,23,318,1319,0.17857142857142858,-1001,0.19425778863775198
2019,3199,23,8,1645,481,0.7419354838709677,1164,0.7737535277516463
2019,3200,25,8,1585,413,0.7575757575757576,1172,0.7932932932932933
2019,3201,17,12,1218,764,0.5862068965517241,454,0.6145307769929365
2019,3202,18,12,1195,727,0.6,468,0.6217481789802289
2019,3203,10,20,603,935,0.3333333333333333,-332,0.3920676202860858
2019,3204,6,22,436,1301,0.21428571428571427,-865,0.2510074841681059
2019,3205,13,15,885,932,0.4642857142857143,-47,0.4870665932856357
2019,3206,16,14,1120,817,0.5333333333333333,303,0.5782137325761487
2019,3207,16,15,1074,833,0.5161290322580645,241,0.563188253801783
2019,3208,18,12,1353,698,0.6,655,0.6596782057532911
2019,3209,17,13,1197,707,0.5666666666666667,490,0.6286764705882353
2019,3210,17,13,1228,798,0.5666666666666667,430,0.6061204343534057
2019,3211,28,4,2093,265,0.875,1828,0.8876166242578456
2019,3212,16,16,1119,915,0.5,204,0.5501474926253688
2019,3213,7,20,490,1031,0.25925925925925924,-541,0.32215647600262987
2019,3214,15,14,1106,850,0.5172413793103449,256,0.565439672801636
2019,3216,23,10,1553,559,0.696969696969697,994,0.7353219696969697
2019,3217,16,12,1244,747,0.5714285714285714,497,0.6248116524359618
2019,3218,14,16,916,881,0.4666666666666667,35,0.5097384529771842
2019,3219,20,8,1510,484,0.7142857142857143,1026,0.757271815446339
2019,3220,10,21,639,1186,0.3225806451612903,-547,0.35013698630136986
2019,3221,18,13,1191,773,0.5806451612903226,418,0.6064154786150713
2019,3222,15,15,1088,946,0.5,142,0.5349065880039331
2019,3223,5,19,352,1114,0.20833333333333334,-762,0.24010914051841747
2019,3224,18,13,1364,839,0.5806451612903226,525,0.6191556967771221
2019,3225,20,11,1663,741,0.6451612903225806,922,0.6917637271214643
2019,3226,19,10,1302,596,0.6551724137931034,706,0.6859852476290832
2019,3227,3,26,206,1222,0.10344827586206896,-1016,0.14425770308123248
2019,3228,10,20,760,1275,0.3333333333333333,-515,0.37346437346437344
2019,3229,18,12,1192,683,0.6,509,0.6357333333333334
2019,3230,5,24,402,1250,0.1724137931034483,-848,0.24334140435835352
2019,3231,20,12,1506,705,0.625,801,0.6811397557666214
2019,3232,10,19,681,1127,0.3448275862068966,-446,0.3766592920353982
2019,3233,5,26,298,1163,0.16129032258064516,-865,0.20396988364134155
2019,3234,26,6,2136,419,0.8125,1717,0.8360078277886497
2019,3235,25,8,2102,502,0.7575757575757576,1600,0.8072196620583717
2019,3236,4,22,264,1270,0.15384615384615385,-1006,0.17209908735332463
2019,3237,19,11,1309,638,0.6333333333333333,671,0.672316384180791
2019,3238,16,14,1197,829,0.5333333333333333,368,0.5908193484698914
2019,3239,11,16,759,933,0.4074074074074074,-174,0.44858156028368795
2019,3240,14,15,893,818,0.4827586206896552,75,0.5219170075978959
2019,3241,25,5,1712,290,0.8333333333333334,1422,0.8551448551448552
2019,3242,13,18,937,1066,0.41935483870967744,-129,0.4677983025461807
2019,3243,21,11,1504,570,0.65625,934,0.7251687560270009
2019,3244,8,22,583,1241,0.26666666666666666,-658,0.3196271929824561
2019,3245,18,12,1210,745,0.6,465,0.618925831202046
2019,3246,24,7,1764,459,0.7741935483870968,1305,0.7935222672064778
2019,3247,6,25,404,1294,0.1935483870967742,-890,0.23792697290930506
2019,3248,8,23,519,1153,0.25806451612903225,-634,0.3104066985645933
2019,3249,20,6,1535,417,0.7692307692307693,1118,0.7863729508196722
2019,3250,20,10,1372,547,0.6666666666666666,825,0.7149557060969255
2019,3251,15,16,1034,894,0.4838709677419355,140,0.5363070539419087
2019,3252,4,25,259,1298,0.13793103448275862,-1039,0.16634553628773283
2019,3253,9,22,538,1199,0.2903225806451613,-661,0.3097294185377087
2019,3254,4,25,270,1357,0.13793103448275862,-1087,0.16594960049170251
2019,3255,3,27,248,1533,0.1,-1285,0.13924761370016844
2019,3256,13,16,1083,959,0.4482758620689655,124,0.5303623898139079
2019,3257,29,3,2309,220,0.90625,2089,0.9130090945037564
2019,3258,18,14,1243,827,0.5625,416,0.6004830917874396
2019,3259,7,24,434,1234,0.22580645161290322,-800,0.26019184652278177
2019,3260,13,18,868,1062,0.41935483870967744,-194,0.44974093264248705
2019,3261,16,13,1094,696,0.5517241379310345,398,0.6111731843575419
2019,3262,6,22,373,1091,0.21428571428571427,-718,0.2547814207650273
2019,3263,25,7,1777,374,0.78125,1403,0.8261273826127382
2019,3264,12,19,697,980,0.3870967741935484,-283,0.41562313655336913
2019,3265,23,10,1659,587,0.696969696969697,1072,0.738646482635797
2019,3266,26,7,2267,469,0.7878787878787878,1798,0.8285818713450293
2019,3267,15,14,1124,810,0.5172413793103449,314,0.5811789038262668
2019,3268,28,4,2124,274,0.875,1850,0.8857381150959133
2019,3269,16,16,1128,889,0.5,239,0.5592464055528011
2019,3270,5,21,359,1206,0.19230769230769232,-847,0.22939297124600638
2019,3271,15,14,1052,802,0.5172413793103449,250,0.5674217907227616
2019,3272,11,20,685,1084,0.3548387096774194,-399,0.38722442057659695
2019,3273,25,7,1766,399,0.78125,1367,0.8157043879907622
2019,3274,24,8,1839,538,0.75,1301,0.7736642827092974
2019,3275,22,8,1519,492,0.7333333333333333,1027,0.7553455992043759
2019,3276,21,11,1597,706,0.65625,891,0.6934433347807208
2019,3277,20,11,1619,709,0.6451612903225806,910,0.695446735395189
2019,3278,20,10,1470,599,0.6666666666666666,871,0.7104881585306911
2019,3279,9,22,622,1210,0.2903225806451613,-588,0.3395196506550218
2019,3280,30,2,2614,141,0.9375,2473,0.9488203266787659
2019,3281,23,10,1630,547,0.696969696969697,1083,0.7487367937528709
2019,3282,14,15,1156,1009,0.4827586206896552,147,0.5339491916859123
2019,3283,23,9,1742,602,0.71875,1140,0.7431740614334471
2019,3284,14,17,938,863,0.45161290322580644,75,0.5208217656857301
2019,3285,13,16,967,909,0.4482758620689655,58,0.5154584221748401
2019,3286,15,15,1059,898,0.5,161,0.541134389371487
2019,3287,21,10,1622,669,0.6774193548387096,953,0.7079877782627674
2019,3288,9,20,590,989,0.3103448275862069,-399,0.3736542115262825
2019,3290,6,24,436,1405,0.2,-969,0.23682781097229766
2019,3291,14,16,1018,972,0.4666666666666667,46,0.5115577889447236
2019,3292,22,10,1535,553,0.6875,982,0.7351532567049809
2019,3293,11,17,839,1034,0.39285714285714285,-195,0.44794447410571275
2019,3294,21,10,1519,616,0.6774193548387096,903,0.7114754098360656
2019,3295,6,22,369,1240,0.21428571428571427,-871,0.2293349906774394
2019,3296,19,13,1537,807,0.59375,730,0.6557167235494881
2019,3297,10,18,694,936,0.35714285714285715,-242,0.42576687116564416
2019,3298,9,19,547,921,0.32142857142857145,-374,0.3726158038147139
2019,3299,19,10,1248,521,0.6551724137931034,727,0.7054833239118146
2019,3300,8,22,551,1243,0.26666666666666666,-692,0.3071348940914158
2019,3301,26,5,1896,323,0.8387096774193549,1573,0.854438936457864
2019,3303,6,21,405,1156,0.2222222222222222,-751,0.25944907110826393
2019,3304,14,16,1085,1086,0.4666666666666667,-1,0.4997696913864578
2019,3305,11,19,762,1193,0.36666666666666664,-431,0.389769820971867
2019,3306,5,24,317,1187,0.1724137931034483,-870,0.21077127659574468
2019,3307,24,6,1873,389,0.8,1484,0.828028293545535
2019,3308,24,6,1810,336,0.8,1474,0.8434296365330848
2019,3309,9,16,590,851,0.36,-261,0.40943789035392086
2019,3310,12,19,841,1058,0.3870967741935484,-217,0.44286466561348076
2019,3311,18,11,1316,628,0.6206896551724138,688,0.676954732510288
2019,3312,6,24,437,1189,0.2,-752,0.2687576875768758
2019,3313,15,15,989,760,0.5,229,0.5654659805603202
2019,3314,18,14,1418,983,0.5625,435,0.5905872553102873
2019,3315,11,19,798,1152,0.36666666666666664,-354,0.40923076923076923
2019,3316,13,14,892,834,0.48148148148148145,58,0.5168018539976825
2019,3317,12,15,893,797,0.4444444444444444,96,0.5284023668639053
2019,3318,20,11,1468,696,0.6451612903225806,772,0.678373382624769
2019,3319,13,18,995,1120,0.41935483870967744,-125,0.47044917257683216
2019,3320,19,12,1341,711,0.6129032258064516,630,0.6535087719298246
2019,3321,16,14,1193,795,0.5333333333333333,398,0.6001006036217303
2019,3322,7,18,508,1154,0.28,-646,0.3056558363417569
2019,3323,30,3,2729,209,0.9090909090909091,2520,0.9288631722260041
2019,3324,4,24,295,1401,0.14285714285714285,-1106,0.17393867924528303
2019,3325,27,5,2195,285,0.84375,1910,0.8850806451612904
2019,3326,14,14,930,810,0.5,120,0.5344827586206896
2019,3328,8,22,624,1537,0.26666666666666666,-913,0.2887552059231837
2019,3329,14,16,1036,951,0.4666666666666667,85,0.521389028686462
2019,3330,21,10,1539,571,0.6774193548387096,968,0.7293838862559242
2019,3331,16,13,1189,849,0.5517241379310345,340,0.5834151128557409
2019,3332,28,4,2455,270,0.875,2185,0.9009174311926605
2019,3333,24,7,1893,460,0.7741935483870968,1433,0.8045048873778156
2019,3334,18,12,1391,803,0.6,588,0.6340018231540565
2019,3335,22,6,1509,330,0.7857142857142857,1179,0.8205546492659054
2019,3336,12,18,886,1145,0.4,-259,0.4362383062530773
2019,3337,19,11,1487,663,0.6333333333333333,824,0.6916279069767441
2019,3338,11,20,776,1012,0.3548387096774194,-236,0.43400447427293065
2019,3339,11,17,846,1193,0.39285714285714285,-347,0.4149092692496322
2019,3340,24,7,1735,458,0.7741935483870968,1277,0.7911536707706338
2019,3341,15,13,1136,696,0.5357142857142857,440,0.6200873362445415
2019,3342,7,24,477,1282,0.22580645161290322,-805,0.2711768050028425
2019,3343,22,9,1626,567,0.7096774193548387,1059,0.7414500683994528
2019,3344,17,15,1153,861,0.53125,292,0.5724925521350546
2019,3345,19,15,1291,890,0.5588235294117647,401,0.5919303071985328
2019,3346,26,6,1785,303,0.8125,1482,0.8548850574712644
2019,3347,25,6,1641,344,0.8064516129032258,1297,0.8267002518891687
2019,3348,8,21,526,1213,0.27586206896551724,-687,0.3024726854514089
2019,3349,28,3,1902,154,0.9032258064516129,1748,0.9250972762645915
2019,3350,9,21,534,1031,0.3,-497,0.3412140575079872
2019,3351,19,12,1267,678,0.6129032258064516,589,0.651413881748072
2019,3352,21,10,1427,513,0.6774193548387096,914,0.7355670103092784
2019,3353,22,9,1489,492,0.7096774193548387,997,0.7516405855628471
2019,3354,14,16,900,778,0.4666666666666667,122,0.5363528009535161
2019,3355,26,6,2141,420,0.8125,1721,0.8360015618898867
2019,3356,15,15,1060,917,0.5,143,0.5361659079413252
2019,3357,19,12,1315,665,0.6129032258064516,650,0.6641414141414141
2019,3358,13,13,975,890,0.5,85,0.5227882037533512
2019,3359,8,20,570,1039,0.2857142857142857,-469,0.35425730267246736
2019,3360,8,21,557,1222,0.27586206896551724,-665,0.31309724564362
2019,3361,14,18,949,1130,0.4375,-181,0.45646945646945647
2019,3362,7,24,512,1500,0.22580645161290322,-988,0.2544731610337972
2019,3363,6,23,450,1402,0.20689655172413793,-952,0.24298056155507558
2019,3364,8,22,488,1184,0.26666666666666666,-696,0.291866028708134
2019,3365,13,17,954,935,0.43333333333333335,19,0.5050291159343568
2019,3366,5,19,316,1060,0.20833333333333334,-744,0.22965116279069767
2019,3367,4,23,288,1343,0.14814814814814814,-1055,0.17657878602084612
2019,3368,8,19,504,1034,0.2962962962962963,-530,0.32769830949284784
2019,3369,11,17,739,1017,0.39285714285714285,-278,0.42084282460136674
2019,3370,3,27,228,1615,0.1,-1387,0.12371134020618557
2019,3371,15,15,1259,975,0.5,284,0.563563115487914
2019,3372,22,6,1614,308,0.7857142857142857,1306,0.8397502601456815
2019,3373,12,18,822,921,0.4,-99,0.47160068846815834
2019,3374,11,19,660,1002,0.36666666666666664,-342,0.3971119133574007
2019,3375,22,10,1600,531,0.6875,1069,0.7508212106992023
2019,3376,21,9,1626,646,0.7,980,0.715669014084507
2019,3377,26,5,1992,372,0.8387096774193549,1620,0.8426395939086294
2019,3378,18,15,1246,809,0.5454545454545454,437,0.6063260340632604
2019,3379,15,13,1021,700,0.5357142857142857,321,0.5932597327135386
2019,3380,17,11,1103,538,0.6071428571428571,565,0.6721511273613651
2019,3381,8,23,570,1350,0.25806451612903225,-780,0.296875
2019,3382,8,22,592,1123,0.26666666666666666,-531,0.34518950437317786
2019,3383,17,13,1329,898,0.5666666666666667,431,0.5967669510552313
2019,3384,15,17,1228,1054,0.46875,174,0.5381244522348817
2019,3385,15,16,1013,992,0.4838709677419355,21,0.5052369077306733
2019,3386,12,19,714,951,0.3870967741935484,-237,0.42882882882882883
2019,3387,15,16,1015,903,0.4838709677419355,112,0.5291970802919708
2019,3388,20,11,1639,722,0.6451612903225806,917,0.6941973739940703
2019,3389,6,24,430,1258,0.2,-828,0.254739336492891
2019,3390,28,4,2124,269,0.875,1855,0.8875888006686168
2019,3391,14,15,952,788,0.4827586206896552,164,0.5471264367816092
2019,3392,22,8,1516,416,0.7333333333333333,1100,0.7846790890269151
2019,3393,24,8,1966,525,0.75,1441,0.7892412685668406
2019,3394,13,16,839,932,0.4482758620689655,-93,0.47374364765669114
2019,3395,20,10,1433,625,0.6666666666666666,808,0.6963070942662779
2019,3396,11,19,797,1158,0.36666666666666664,-361,0.40767263427109973
2019,3397,19,12,1494,817,0.6129032258064516,677,0.6464733881436607
2019,3398,5,25,314,1461,0.16666666666666666,-1147,0.17690140845070423
2019,3399,19,10,1380,595,0.6551724137931034,785,0.6987341772151898
2019,3400,23,9,1700,563,0.71875,1137,0.7512152010605391
2019,3401,24,7,1708,422,0.7741935483870968,1286,0.8018779342723005
2019,3402,12,17,819,937,0.41379310344827586,-118,0.4664009111617312
2019,3403,14,17,1162,1071,0.45161290322580644,91,0.5203761755485894
2019,3404,21,9,1652,632,0.7,1020,0.723292469352014
2019,3405,20,11,1410,609,0.6451612903225806,801,0.6983655274888558
2019,3406,20,12,1438,718,0.625,720,0.6669758812615956
2019,3407,21,8,1803,569,0.7241379310344828,1234,0.7601180438448567
2019,3408,15,15,1023,819,0.5,204,0.5553745928338762
2019,3409,13,18,868,925,0.41935483870967744,-57,0.4841048522030117
2019,3410,16,14,1063,837,0.5333333333333333,226,0.5594736842105263
2019,3411,13,15,823,838,0.4642857142857143,-15,0.4954846478025286
2019,3412,24,6,1845,345,0.8,1500,0.8424657534246576
2019,3413,24,6,1790,342,0.8,1448,0.8395872420262664
2019,3414,19,11,1304,663,0.6333333333333333,641,0.6629384850025419
2019,3415,17,15,1172,812,0.53125,360,0.5907258064516129
2019,3416,26,6,1651,322,0.8125,1329,0.8367967562088191
2019,3417,20,12,1561,785,0.625,776,0.66538789428815
2019,3418,7,22,434,1355,0.2413793103448276,-921,0.24259362772498602
2019,3419,8,19,524,931,0.2962962962962963,-407,0.36013745704467354
2019,3420,7,20,447,990,0.25925925925925924,-543,0.31106471816283926
2019,3421,16,14,1045,739,0.5333333333333333,306,0.5857623318385651
2019,3422,7,19,419,1173,0.2692307692307692,-754,0.26319095477386933
2019,3423,15,12,1076,685,0.5555555555555556,391,0.6110164679159569
2019,3424,12,18,783,1001,0.4,-218,0.43890134529147984
2019,3425,17,13,1296,801,0.5666666666666667,495,0.6180257510729614
2019,3426,23,7,1734,411,0.7666666666666667,1323,0.8083916083916084
2019,3427,5,21,341,1135,0.19230769230769232,-794,0.231029810298103
2019,3428,20,10,1562,665,0.6666666666666666,897,0.7013920071845532
2019,3429,15,15,1002,808,0.5,194,0.5535911602209945
2019,3430,11,16,715,975,0.4074074074074074,-260,0.4230769230769231
2019,3431,9,22,617,1198,0.2903225806451613,-581,0.3399449035812672
2019,3433,23,9,1442,491,0.71875,951,0.7459906880496637
2019,3434,8,24,613,1433,0.25,-820,0.29960899315738027
2019,3435,7,23,559,1376,0.23333333333333334,-817,0.28888888888888886
2019,3436,10,18,579,860,0.35714285714285715,-281,0.40236275191104937
2019,3437,18,12,1204,722,0.6,482,0.6251298026998962
2019,3438,12,19,789,1029,0.3870967741935484,-240,0.43399339933993397
2019,3439,20,11,1519,703,0.6451612903225806,816,0.6836183618361836
2019,3441,2,26,133,1342,0.07142857142857142,-1209,0.09016949152542372
2019,3442,10,18,854,1194,0.35714285714285715,-340,0.4169921875
2019,3443,16,14,1241,929,0.5333333333333333,312,0.571889400921659
2019,3444,9,20,617,1161,0.3103448275862069,-544,0.34701912260967377
2019,3447,9,20,679,1139,0.3103448275862069,-460,0.3734873487348735
2019,3448,10,20,625,1096,0.3333333333333333,-471,0.3631609529343405
2019,3449,11,21,783,1255,0.34375,-472,0.3842001962708538
2019,3450,9,21,759,1237,0.3,-478,0.3802605210420842
2019,3451,5,25,332,1497,0.16666666666666666,-1165,0.1815199562602515
2019,3452,20,10,1524,610,0.6666666666666666,914,0.7141518275538894
2019,3453,21,9,1380,510,0.7,870,0.7301587301587301
2019,3454,15,15,995,891,0.5,104,0.5275715800636267
2019,3455,12,18,776,930,0.4,-154,0.4548651817116061
2019,3456,15,16,1029,985,0.4838709677419355,44,0.5109235352532274
2019,3457,10,19,627,976,0.3448275862068966,-349,0.3911416094822208
2019,3458,15,18,1074,1043,0.45454545454545453,31,0.507321681624941
2019,3459,13,15,1007,928,0.4642857142857143,79,0.5204134366925065
2019,3460,26,6,1851,395,0.8125,1456,0.8241317898486198
2019,3461,20,8,1363,494,0.7142857142857143,869,0.7339795368874529
2019,3462,10,19,710,1055,0.3448275862068966,-345,0.40226628895184136
2019,3463,16,13,1091,746,0.5517241379310345,345,0.5939031028851388
2019,3464,20,9,1484,492,0.6896551724137931,992,0.7510121457489879
2019,3465,14,11,1158,747,0.56,411,0.6078740157480315
2019,3466,15,8,1126,473,0.6521739130434783,653,0.7041901188242652
2020,1101,16,11,1220,745,0.5925925925925926,475,0.6208651399491094
2020,1102,11,20,889,1350,0.3548387096774194,-461,0.3970522554711925
2020,1103,22,7,1650,517,0.7586206896551724,1133,0.7614213197969543
2020,1104,16,15,1408,1134,0.5161290322580645,274,0.5538945712037766
2020,1105,8,22,551,1294,0.26666666666666666,-743,0.2986449864498645
2020,1106,8,24,549,1416,0.25,-867,0.27938931297709924
2020,1107,13,18,961,1088,0.41935483870967744,-127,0.4690092728160078
2020,1108,11,15,893,925,0.4230769230769231,-32,0.4911991199119912
2020,1110,16,14,1222,927,0.5333333333333333,295,0.5686365751512331
2020,1111,16,15,1117,966,0.5161290322580645,151,0.5362457993278925
2020,1112,21,11,1738,707,0.65625,1031,0.710838445807771
2020,1113,20,11,1598,690,0.6451612903225806,908,0.6984265734265734
2020,1114,20,10,1576,617,0.6666666666666666,959,0.7186502507979936
2020,1115,3,26,215,1325,0.10344827586206896,-1110,0.1396103896103896
2020,1116,20,12,1547,879,0.625,668,0.6376751854905194
2020,1117,14,16,1073,1040,0.4666666666666667,33,0.5078088026502603
2020,1119,14,15,1083,965,0.4827586206896552,118,0.52880859375
2020,1120,25,6,2039,380,0.8064516129032258,1659,0.8429102935097148
2020,1122,19,12,1545,784,0.6129032258064516,761,0.6633748389866896
2020,1123,17,13,1238,830,0.5666666666666667,408,0.5986460348162476
2020,1124,26,4,1873,261,0.8666666666666667,1612,0.8776944704779757
2020,1125,25,7,2019,503,0.78125,1516,0.8005551149881047
2020,1126,13,14,1039,916,0.48148148148148145,123,0.5314578005115089
2020,1127,8,19,649,1177,0.2962962962962963,-528,0.35542168674698793
2020,1129,19,12,1516,788,0.6129032258064516,728,0.6579861111111112
2020,1130,13,19,905,1162,0.40625,-257,0.4378326076439284
2020,1131,20,13,1523,796,0.6060606060606061,727,0.6567485985338508
2020,1132,19,10,1446,682,0.6551724137931034,764,0.6795112781954887
2020,1133,22,11,1661,686,0.6666666666666666,975,0.7077119727311462
2020,1135,14,12,1030,700,0.5384615384615384,330,0.5953757225433526
2020,1136,14,17,990,1165,0.45161290322580644,-175,0.4593967517401392
2020,1137,14,20,1027,1272,0.4117647058823529,-245,0.44671596346237497
2020,1138,19,12,1558,849,0.6129032258064516,709,0.6472787702534275
2020,1139,22,9,1561,564,0.7096774193548387,997,0.7345882352941177
2020,1140,23,8,1875,575,0.7419354838709677,1300,0.7653061224489796
2020,1141,11,18,958,1225,0.3793103448275862,-267,0.4388456252863033
2020,1142,5,23,416,1437,0.17857142857142858,-1021,0.22450080949811116
2020,1143,14,18,989,1034,0.4375,-45,0.4888779041028176
2020,1144,13,16,886,1061,0.4482758620689655,-175,0.45505906522855677
2020,1145,12,20,909,1287,0.375,-378,0.4139344262295082
2020,1146,9,21,733,1512,0.3,-779,0.3265033407572383
2020,1148,3,27,237,1633,0.1,-1396,0.1267379679144385
2020,1149,12,18,916,1080,0.4,-164,0.4589178356713427
2020,1150,16,13,1111,811,0.5517241379310345,300,0.5780437044745057
2020,1151,18,13,1427,812,0.5806451612903226,615,0.637338097364895
2020,1152,1,25,89,1421,0.038461538461538464,-1332,0.05894039735099338
2020,1153,20,10,1507,675,0.6666666666666666,832,0.6906507791017416
2020,1154,3,24,255,1662,0.1111111111111111,-1407,0.13302034428794993
2020,1155,16,15,1215,847,0.5161290322580645,368,0.5892337536372454
2020,1156,10,21,689,1285,0.3225806451612903,-596,0.34903748733535966
2020,1157,14,17,1186,1171,0.45161290322580644,15,0.5031820110309716
2020,1158,16,14,1218,882,0.5333333333333333,336,0.58
2020,1159,24,9,1877,622,0.7272727272727273,1255,0.7511004401760705
2020,1160,21,11,1555,713,0.65625,842,0.685626102292769
2020,1161,19,12,1574,756,0.6129032258064516,818,0.6755364806866953
2020,1162,5,24,369,1533,0.1724137931034483,-1164,0.19400630914826497
2020,1163,19,12,1430,828,0.6129032258064516,602,0.633303808680248
2020,1164,11,20,849,1260,0.3548387096774194,-411,0.40256045519203415
2020,1165,5,20,367,1281,0.2,-914,0.22269417475728157
2020,1166,23,7,1893,444,0.7666666666666667,1449,0.810012836970475
2020,1167,9,19,632,1196,0.32142857142857145,-564,0.34573304157549234
2020,1168,9,20,668,1274,0.3103448275862069,-606,0.34397528321318227
2020,1169,13,17,1046,1195,0.43333333333333335,-149,0.4667559125390451
2020,1170,14,14,931,816,0.5,115,0.5329135661133372
2020,1171,11,17,775,1011,0.39285714285714285,-236,0.4339305711086226
2020,1172,16,14,1247,935,0.5333333333333333,312,0.571494042163153
2020,1173,29,2,2320,160,0.9354838709677419,2160,0.9354838709677419
2020,1174,21,11,1629,726,0.65625,903,0.6917197452229299
2020,1175,5,25,397,1787,0.16666666666666666,-1390,0.18177655677655677
2020,1176,6,24,466,1597,0.2,-1131,0.2258846340281144
2020,1177,15,16,1143,1035,0.4838709677419355,108,0.5247933884297521
2020,1178,8,23,638,1537,0.25806451612903225,-899,0.29333333333333333
2020,1179,18,14,1337,832,0.5625,505,0.6164130935915169
2020,1180,13,19,952,1218,0.40625,-266,0.43870967741935485
2020,1181,25,6,2113,445,0.8064516129032258,1668,0.8260359655981235
2020,1182,21,9,1550,596,0.7,954,0.7222739981360671
2020,1183,15,15,1159,1017,0.5,142,0.5326286764705882
2020,1184,14,17,1120,1116,0.45161290322580644,4,0.5008944543828264
2020,1185,12,16,782,942,0.42857142857142855,-160,0.45359628770301624
2020,1186,21,8,1686,570,0.7241379310344828,1116,0.7473404255319149
2020,1187,11,20,819,1292,0.3548387096774194,-473,0.3879677877783041
2020,1188,6,23,469,1447,0.20689655172413793,-978,0.24478079331941544
2020,1189,10,21,716,1345,0.3225806451612903,-629,0.34740417273168367
2020,1190,27,4,2058,242,0.8709677419354839,1816,0.8947826086956522
2020,1191,8,23,672,1388,0.25806451612903225,-716,0.3262135922330097
2020,1192,10,19,801,1265,0.3448275862068966,-464,0.3877057115198451
2020,1193,12,20,739,1118,0.375,-379,0.3979536887452881
2020,1194,14,15,1053,962,0.4827586206896552,91,0.5225806451612903
2020,1195,8,22,540,1282,0.26666666666666666,-742,0.29637760702524696
2020,1196,19,12,1467,761,0.6129032258064516,706,0.6584380610412927
2020,1197,12,15,895,929,0.4444444444444444,-34,0.4906798245614035
2020,1198,16,13,1290,869,0.5517241379310345,421,0.5974988420565076
2020,1199,26,5,2021,315,0.8387096774193549,1706,0.865154109589041
2020,1200,9,22,571,1245,0.2903225806451613,-674,0.31442731277533037
2020,1201,10,19,757,1226,0.3448275862068966,-469,0.3817448310640444
2020,1202,22,7,1729,465,0.7586206896551724,1264,0.7880583409298085
2020,1203,12,20,911,1175,0.375,-264,0.4367209971236817
2020,1204,18,13,1405,880,0.5806451612903226,525,0.6148796498905909
2020,1205,14,16,1074,1077,0.4666666666666667,-3,0.499302649930265
2020,1206,17,15,1214,934,0.53125,280,0.5651769087523277
2020,1207,15,17,1256,1133,0.46875,123,0.5257429886982001
2020,1208,15,16,1234,1114,0.4838709677419355,120,0.5255536626916525
2020,1209,17,13,1360,952,0.5666666666666667,408,0.5882352941176471
2020,1210,16,14,1157,887,0.5333333333333333,270,0.5660469667318982
2020,1211,31,2,2743,142,0.9393939393939394,2601,0.9507798960138648
2020,1212,13,15,905,965,0.4642857142857143,-60,0.4839572192513369
2020,1213,13,16,987,1056,0.4482758620689655,-69,0.4831130690161527
2020,1214,12,19,985,1350,0.3870967741935484,-365,0.42184154175588867
2020,1216,16,15,1112,925,0.5161290322580645,187,0.5459008345606283
2020,1217,20,8,1473,557,0.7142857142857143,916,0.725615763546798
2020,1218,16,13,1195,804,0.5517241379310345,391,0.5977988994497249
2020,1219,7,23,502,1426,0.23333333333333334,-924,0.2603734439834025
2020,1220,25,8,1965,520,0.7575757575757576,1445,0.7907444668008048
2020,1221,3,28,240,1800,0.0967741935483871,-1560,0.11764705882352941
2020,1222,23,8,1724,517,0.7419354838709677,1207,0.7692994199018296
2020,1223,4,25,360,1963,0.13793103448275862,-1603,0.15497201894102453
2020,1224,3,28,226,1907,0.0967741935483871,-1681,0.10595405532114392
2020,1225,6,24,437,1461,0.2,-1024,0.23024236037934667
2020,1226,6,22,439,1472,0.21428571428571427,-1033,0.22972265829408686
2020,1227,17,17,1293,1044,0.5,249,0.5532734274711169
2020,1228,20,10,1484,638,0.6666666666666666,846,0.6993402450518379
2020,1229,9,21,637,1337,0.3,-700,0.32269503546099293
2020,1230,6,22,443,1352,0.21428571428571427,-909,0.2467966573816156
2020,1231,20,12,1567,719,0.625,848,0.6854768153980753
2020,1232,17,12,1216,774,0.5862068965517241,442,0.6110552763819096
2020,1233,12,17,872,1158,0.41379310344827586,-286,0.4295566502463054
2020,1234,20,11,1581,829,0.6451612903225806,752,0.6560165975103734
2020,1235,12,20,990,1314,0.375,-324,0.4296875
2020,1236,11,19,800,1220,0.36666666666666664,-420,0.39603960396039606
2020,1237,5,25,397,1707,0.16666666666666666,-1310,0.18868821292775664
2020,1238,13,17,934,1034,0.43333333333333335,-100,0.47459349593495936
2020,1239,12,18,873,1090,0.4,-217,0.4447274579724911
2020,1240,11,19,827,1222,0.36666666666666664,-395,0.4036115178135676
2020,1241,8,21,639,1422,0.27586206896551724,-783,0.31004366812227074
2020,1242,27,3,2043,176,0.9,1867,0.9206849932401983
2020,1243,11,21,770,1284,0.34375,-514,0.3748782862706913
2020,1244,1,28,85,1517,0.034482758620689655,-1432,0.05305867665418227
2020,1245,18,12,1462,794,0.6,668,0.6480496453900709
2020,1246,25,6,1895,412,0.8064516129032258,1483,0.8214130905938448
2020,1247,15,15,1095,945,0.5,150,0.5367647058823529
2020,1248,18,12,1313,765,0.6,548,0.6318575553416746
2020,1249,14,15,1138,909,0.4827586206896552,229,0.5559355153883733
2020,1250,9,21,663,1354,0.3,-691,0.32870599900842834
2020,1251,28,4,1916,241,0.875,1675,0.8882707464070468
2020,1252,14,16,1029,1026,0.4666666666666667,3,0.5007299270072992
2020,1253,9,21,585,1403,0.3,-818,0.2942655935613682
2020,1254,14,18,1134,1245,0.4375,-111,0.4766708701134931
2020,1255,12,18,864,1133,0.4,-269,0.43264897346019027
2020,1256,20,8,1488,562,0.7142857142857143,926,0.7258536585365853
2020,1257,24,7,1863,433,0.7741935483870968,1430,0.811411149825784
2020,1258,10,21,701,1251,0.3225806451612903,-550,0.35911885245901637
2020,1259,14,17,1127,1149,0.45161290322580644,-22,0.4951669595782074
2020,1260,20,11,1441,667,0.6451612903225806,774,0.6835863377609108
2020,1261,21,10,1710,785,0.6774193548387096,925,0.685370741482966
2020,1262,12,19,945,1355,0.3870967741935484,-410,0.4108695652173913
2020,1263,8,22,642,1172,0.26666666666666666,-530,0.3539140022050717
2020,1264,13,18,893,1031,0.41935483870967744,-138,0.46413721413721415
2020,1265,7,23,501,1315,0.23333333333333334,-814,0.2758810572687225
2020,1266,18,12,1473,860,0.6,613,0.6313759108444064
2020,1267,16,15,1302,1041,0.5161290322580645,261,0.5556978233034571
2020,1268,24,7,1801,425,0.7741935483870968,1376,0.8090745732255166
2020,1269,14,17,1035,1089,0.45161290322580644,-54,0.4872881355932203
2020,1270,11,17,925,1192,0.39285714285714285,-267,0.43693906471421823
2020,1271,4,27,293,1463,0.12903225806451613,-1170,0.16685649202733485
2020,1272,21,10,1589,643,0.6774193548387096,946,0.7119175627240143
2020,1273,15,15,1159,947,0.5,212,0.550332383665717
2020,1274,15,16,1182,1025,0.4838709677419355,157,0.5355686452197553
2020,1275,11,19,829,1241,0.36666666666666664,-412,0.4004830917874396
2020,1276,19,12,1542,784,0.6129032258064516,758,0.6629406706792778
2020,1277,22,9,1784,569,0.7096774193548387,1215,0.7581810454738631
2020,1278,15,16,1206,999,0.4838709677419355,207,0.5469387755102041
2020,1279,15,17,1157,1051,0.46875,106,0.5240036231884058
2020,1280,20,11,1546,729,0.6451612903225806,817,0.6795604395604395
2020,1281,15,16,1112,969,0.4838709677419355,143,0.5343584814992792
2020,1282,13,14,929,853,0.48148148148148145,76,0.521324354657688
2020,1283,16,17,1186,1144,0.48484848484848486,42,0.5090128755364807
2020,1284,18,13,1381,828,0.5806451612903226,553,0.625169760072431
2020,1285,17,12,1270,789,0.5862068965517241,481,0.6168042739193783
2020,1286,14,15,950,941,0.4827586206896552,9,0.5023796932839767
2020,1287,11,19,833,1181,0.36666666666666664,-348,0.41360476663356505
2020,1288,12,16,865,1062,0.42857142857142855,-197,0.4488842760768033
2020,1290,3,27,213,1835,0.1,-1622,0.10400390625
2020,1291,10,21,714,1264,0.3225806451612903,-550,0.3609706774519717
2020,1292,5,23,347,1545,0.17857142857142858,-1198,0.18340380549682875
2020,1293,21,9,1626,592,0.7,1034,0.7330928764652841
2020,1294,20,9,1525,582,0.6896551724137931,943,0.7237778832463218
2020,1295,23,8,1762,515,0.7419354838709677,1247,0.7738252086078173
2020,1296,17,13,1207,768,0.5666666666666667,439,0.6111392405063291
2020,1297,21,9,1579,547,0.7,1032,0.7427093132643462
2020,1298,13,16,865,956,0.4482758620689655,-91,0.47501372872048325
2020,1299,16,15,1268,920,0.5161290322580645,348,0.5795246800731262
2020,1300,15,13,1115,762,0.5357142857142857,353,0.594033031433138
2020,1301,20,12,1571,817,0.625,754,0.6578726968174204
2020,1303,15,16,1208,1072,0.4838709677419355,136,0.5298245614035088
2020,1304,7,25,558,1677,0.21875,-1119,0.24966442953020135
2020,1305,19,12,1580,811,0.6129032258064516,769,0.6608113759933082
2020,1306,13,15,966,921,0.4642857142857143,45,0.5119236883942766
2020,1307,18,14,1479,960,0.5625,519,0.6063960639606396
2020,1308,23,6,1658,360,0.7931034482758621,1298,0.821605550049554
2020,1309,5,21,437,1404,0.19230769230769232,-967,0.23737099402498643
2020,1310,12,20,885,1217,0.375,-332,0.42102759276879165
2020,1311,17,10,1320,647,0.6296296296296297,673,0.6710726995424504
2020,1312,8,21,576,1254,0.27586206896551724,-678,0.31475409836065577
2020,1313,13,14,1003,823,0.48148148148148145,180,0.5492880613362541
2020,1314,14,19,1121,1262,0.42424242424242425,-141,0.47041544271926145
2020,1315,12,18,937,1223,0.4,-286,0.4337962962962963
2020,1316,19,12,1532,847,0.6129032258064516,685,0.6439680538041194
2020,1317,18,11,1355,667,0.6206896551724138,688,0.6701285855588526
2020,1318,17,16,1308,1039,0.5151515151515151,269,0.5573072006817213
2020,1319,14,14,1037,893,0.5,144,0.5373056994818652
2020,1320,23,6,1748,384,0.7931034482758621,1364,0.8198874296435272
2020,1321,8,23,597,1415,0.25806451612903225,-818,0.2967196819085487
2020,1322,12,15,994,1019,0.4444444444444444,-25,0.49379036264282167
2020,1323,20,12,1577,799,0.625,778,0.6637205387205387
2020,1324,13,19,957,1188,0.40625,-231,0.4461538461538462
2020,1325,15,15,1144,964,0.5,180,0.5426944971537002
2020,1326,21,10,1601,633,0.6774193548387096,968,0.7166517457475381
2020,1328,19,12,1443,734,0.6129032258064516,709,0.6628387689480937
2020,1329,18,14,1323,840,0.5625,483,0.6116504854368932
2020,1330,13,19,937,1161,0.40625,-224,0.4466158245948522
2020,1331,13,14,1145,1004,0.48148148148148145,141,0.532805956258725
2020,1332,24,7,1895,457,0.7741935483870968,1438,0.8056972789115646
2020,1333,18,13,1395,812,0.5806451612903226,583,0.632079746261894
2020,1334,21,10,1493,652,0.6774193548387096,841,0.696037296037296
2020,1335,15,11,1136,750,0.5769230769230769,386,0.6023329798515377
2020,1336,21,10,1678,649,0.6774193548387096,1029,0.721100128921358
2020,1337,16,16,1276,1165,0.5,111,0.5227365833674723
2020,1338,16,17,1123,1029,0.48484848484848486,94,0.5218401486988847
2020,1339,7,23,504,1459,0.23333333333333334,-955,0.25674987264391236
2020,1340,16,14,1326,997,0.5333333333333333,329,0.5708136030994404
2020,1341,17,13,1272,838,0.5666666666666667,434,0.6028436018957346
2020,1342,8,22,604,1383,0.26666666666666666,-779,0.30397584297936586
2020,1343,13,13,976,868,0.5,108,0.5292841648590022
2020,1344,19,12,1461,753,0.6129032258064516,708,0.6598915989159891
2020,1345,16,15,1202,912,0.5161290322580645,290,0.5685903500473037
2020,1346,15,15,1115,973,0.5,142,0.5340038314176245
2020,1347,19,11,1426,695,0.6333333333333333,731,0.6723243752946724
2020,1348,21,9,1584,616,0.7,968,0.72
2020,1349,13,17,1062,1133,0.43333333333333335,-71,0.4838268792710706
2020,1350,24,7,1858,477,0.7741935483870968,1381,0.7957173447537473
2020,1351,18,12,1370,782,0.6,588,0.6366171003717472
2020,1352,19,14,1401,870,0.5757575757575758,531,0.6169088507265522
2020,1353,19,11,1377,697,0.6333333333333333,680,0.6639344262295082
2020,1354,9,18,727,1128,0.3333333333333333,-401,0.39191374663072776
2020,1355,20,10,1645,696,0.6666666666666666,949,0.7026911576249466
2020,1356,15,16,1022,904,0.4838709677419355,118,0.5306334371754933
2020,1357,19,13,1492,827,0.59375,665,0.6433807675722294
2020,1358,14,13,1135,922,0.5185185185185185,213,0.5517744287797763
2020,1359,7,23,560,1621,0.23333333333333334,-1061,0.2567629527739569
2020,1360,8,23,579,1429,0.25806451612903225,-850,0.28834661354581675
2020,1361,29,2,2184,119,0.9354838709677419,2065,0.9483282674772037
2020,1362,21,12,1661,784,0.6363636363636364,877,0.6793456032719837
2020,1363,6,24,493,1589,0.2,-1096,0.2367915465898175
2020,1364,19,10,1360,660,0.6551724137931034,700,0.6732673267326733
2020,1365,18,13,1405,895,0.5806451612903226,510,0.6108695652173913
2020,1367,11,20,872,1219,0.3548387096774194,-347,0.4170253467240555
2020,1368,5,23,394,1542,0.17857142857142858,-1148,0.20351239669421486
2020,1369,5,24,370,1538,0.1724137931034483,-1168,0.19392033542976939
2020,1370,12,15,963,1001,0.4444444444444444,-38,0.49032586558044805
2020,1371,21,9,1633,608,0.7,1025,0.7286925479696564
2020,1372,25,3,2005,197,0.8928571428571429,1808,0.9105358764759309
2020,1373,20,10,1471,696,0.6666666666666666,775,0.6788186432856483
2020,1374,19,11,1457,731,0.6333333333333333,726,0.6659049360146252
2020,1375,17,11,1212,741,0.6071428571428571,471,0.620583717357911
2020,1376,18,13,1398,877,0.5806451612903226,521,0.6145054945054945
2020,1377,17,12,1416,835,0.5862068965517241,581,0.6290537538871612
2020,1378,14,17,952,991,0.45161290322580644,-39,0.489963973237262
2020,1379,6,22,454,1324,0.21428571428571427,-870,0.25534308211473566
2020,1380,15,15,1132,894,0.5,238,0.558736426456071
2020,1381,15,15,1150,943,0.5,207,0.5494505494505495
2020,1382,18,12,1302,766,0.6,536,0.6295938104448743
2020,1383,12,18,929,1117,0.4,-188,0.45405669599217985
2020,1384,21,10,1672,698,0.6774193548387096,974,0.7054852320675106
2020,1385,17,15,1389,998,0.53125,391,0.5819019689987432
2020,1386,6,26,499,1709,0.1875,-1210,0.2259963768115942
2020,1387,22,8,1624,517,0.7333333333333333,1107,0.7585240541802896
2020,1388,25,8,1879,573,0.7575757575757576,1306,0.7663132137030995
2020,1389,18,12,1272,718,0.6,554,0.6391959798994975
2020,1390,20,12,1467,756,0.625,711,0.659919028340081
2020,1391,14,17,899,1048,0.45161290322580644,-149,0.4617360041088855
2020,1392,19,13,1379,813,0.59375,566,0.6291058394160584
2020,1393,18,14,1406,972,0.5625,434,0.5912531539108494
2020,1394,12,18,850,1112,0.4,-262,0.4332313965341488
2020,1395,15,16,1070,940,0.4838709677419355,130,0.5323383084577115
2020,1396,14,17,1067,1050,0.45161290322580644,17,0.5040151157298063
2020,1397,17,14,1212,867,0.5483870967741935,345,0.5829725829725829
2020,1398,16,15,1219,951,0.5161290322580645,268,0.5617511520737327
2020,1399,7,22,490,1374,0.2413793103448276,-884,0.2628755364806867
2020,1400,19,12,1315,674,0.6129032258064516,641,0.6611362493715435
2020,1401,16,14,1094,800,0.5333333333333333,294,0.5776135163674763
2020,1402,19,11,1417,702,0.6333333333333333,715,0.6687116564417178
2020,1403,18,13,1415,815,0.5806451612903226,600,0.6345291479820628
2020,1404,7,20,581,1415,0.25925925925925924,-834,0.2910821643286573
2020,1405,16,15,1284,1002,0.5161290322580645,282,0.5616797900262467
2020,1406,17,13,1289,798,0.5666666666666667,491,0.6176329659798754
2020,1407,7,22,514,1429,0.2413793103448276,-915,0.2645393721049923
2020,1408,12,18,901,1149,0.4,-248,0.4395121951219512
2020,1409,21,10,1456,647,0.6774193548387096,809,0.6923442700903472
2020,1410,10,16,797,1035,0.38461538461538464,-238,0.43504366812227074
2020,1411,15,16,1199,1051,0.4838709677419355,148,0.5328888888888889
2020,1412,17,13,1218,779,0.5666666666666667,439,0.6099148723084626
2020,1413,12,18,935,1185,0.4,-250,0.4410377358490566
2020,1414,19,11,1443,706,0.6333333333333333,737,0.6714751046998604
2020,1415,14,15,957,863,0.4827586206896552,94,0.5258241758241758
2020,1416,16,14,1194,873,0.5333333333333333,321,0.5776487663280117
2020,1417,18,12,1291,788,0.6,503,0.620971620971621
2020,1418,13,19,1063,1258,0.40625,-195,0.45799224472210254
2020,1419,7,20,521,1160,0.25925925925925924,-639,0.30993456276026177
2020,1420,12,17,846,1047,0.41379310344827586,-201,0.4469096671949287
2020,1421,13,16,1028,1114,0.4482758620689655,-86,0.47992530345471524
2020,1422,21,9,1531,626,0.7,905,0.7097821047751507
2020,1423,7,22,509,1339,0.2413793103448276,-830,0.2754329004329004
2020,1424,17,15,1340,967,0.53125,373,0.5808409189423493
2020,1425,22,9,1597,582,0.7096774193548387,1015,0.7329050022946305
2020,1426,12,18,881,1209,0.4,-328,0.4215311004784689
2020,1427,10,19,823,1351,0.3448275862068966,-528,0.3785648574057038
2020,1428,16,15,1282,917,0.5161290322580645,365,0.5829922692132787
2020,1429,24,8,1844,533,0.75,1311,0.7757677745056795
2020,1430,8,19,606,1246,0.2962962962962963,-640,0.32721382289416845
2020,1431,14,15,975,927,0.4827586206896552,48,0.5126182965299685
2020,1433,18,13,1366,827,0.5806451612903226,539,0.622891016871865
2020,1434,18,16,1384,1048,0.5294117647058824,336,0.569078947368421
2020,1435,11,21,942,1353,0.34375,-411,0.41045751633986927
2020,1436,25,7,1827,441,0.78125,1386,0.8055555555555556
2020,1437,24,7,1825,444,0.7741935483870968,1381,0.8043190832966064
2020,1438,23,7,1330,381,0.7666666666666667,949,0.7773232028053769
2020,1439,16,16,1198,996,0.5,202,0.5460346399270738
2020,1440,6,24,510,1598,0.2,-1088,0.24193548387096775
2020,1441,17,12,1421,837,0.5862068965517241,584,0.629317980513729
2020,1442,3,21,237,1493,0.125,-1256,0.13699421965317918
2020,1443,19,10,1496,692,0.6551724137931034,804,0.6837294332723949
2020,1444,11,19,824,1210,0.36666666666666664,-386,0.4051130776794494
2020,1447,7,21,511,1374,0.25,-863,0.2710875331564987
2020,1448,13,18,1030,1246,0.41935483870967744,-216,0.45254833040421794
2020,1449,15,17,1141,1118,0.46875,23,0.5050907481186365
2020,1450,16,16,1219,1016,0.5,203,0.545413870246085
2020,1451,9,20,679,1221,0.3103448275862069,-542,0.35736842105263156
2020,1452,21,10,1563,616,0.6774193548387096,947,0.7173015144561725
2020,1453,15,16,1275,1178,0.4838709677419355,97,0.5197717081125153
2020,1454,10,19,733,1308,0.3448275862068966,-575,0.3591376776090152
2020,1455,23,8,1760,467,0.7419354838709677,1293,0.7903008531656938
2020,1456,20,11,1508,690,0.6451612903225806,818,0.6860782529572339
2020,1457,22,10,1826,709,0.6875,1117,0.7203155818540434
2020,1458,21,10,1508,574,0.6774193548387096,934,0.7243035542747358
2020,1459,17,16,1315,1010,0.5151515151515151,305,0.5655913978494623
2020,1460,23,7,1891,505,0.7666666666666667,1386,0.7892320534223706
2020,1461,8,24,574,1414,0.25,-840,0.2887323943661972
2020,1462,19,13,1379,882,0.59375,497,0.6099071207430341
2020,1463,21,7,1621,466,0.75,1155,0.7767129851461428
2020,1464,16,15,1190,1017,0.5161290322580645,173,0.539193475305845
2020,1465,17,10,1384,674,0.6296296296296297,710,0.6724975704567542
2020,1466,11,17,786,1103,0.39285714285714285,-317,0.41609317098994175
2020,1467,19,11,1222,616,0.6333333333333333,606,0.6648531011969532
2020,3101,20,5,1587,311,0.8,1276,0.8361433087460485
2020,3102,9,21,592,1229,0.3,-637,0.32509610104338277
2020,3103,15,15,1094,905,0.5,189,0.5472736368184092
2020,3104,18,12,1374,776,0.6,598,0.6390697674418605
2020,3105,17,13,1176,754,0.5666666666666667,422,0.6093264248704663
2020,3106,7,21,508,1169,0.25,-661,0.30292188431723316
2020,3107,8,21,526,1031,0.27586206896551724,-505,0.3378291586384072
2020,3108,11,18,754,1043,0.3793103448275862,-289,0.41958820255982193
2020,3110,13,17,810,920,0.43333333333333335,-110,0.4682080924855491
2020,3111,11,19,771,1025,0.36666666666666664,-254,0.4292873051224944
2020,3112,24,7,1744,397,0.7741935483870968,1347,0.8145726296123307
2020,3113,20,11,1386,643,0.6451612903225806,743,0.6830951207491375
2020,3114,12,19,774,943,0.3870967741935484,-169,0.4507862550960978
2020,3115,6,22,469,1202,0.21428571428571427,-733,0.28067025733093953
2020,3116,24,8,2082,586,0.75,1496,0.780359820089955
2020,3117,10,19,698,1153,0.3448275862068966,-455,0.37709346299297675
2020,3119,9,22,637,1315,0.2903225806451613,-678,0.32633196721311475
2020,3120,11,18,810,1148,0.3793103448275862,-338,0.4136874361593463
2020,3122,16,12,1187,684,0.5714285714285714,503,0.6344200962052379
2020,3123,20,10,1391,607,0.6666666666666666,784,0.6961961961961962
2020,3124,28,2,2341,115,0.9333333333333333,2226,0.9531758957654723
2020,3125,22,9,1512,486,0.7096774193548387,1026,0.7567567567567568
2020,3126,21,6,1487,340,0.7777777777777778,1147,0.8139025725232621
2020,3127,21,9,1484,511,0.7,973,0.743859649122807
2020,3129,22,9,1663,614,0.7096774193548387,1049,0.730346947738252
2020,3130,20,12,1596,762,0.625,834,0.6768447837150128
2020,3131,18,12,1086,646,0.6,440,0.6270207852193995
2020,3132,8,21,647,1415,0.27586206896551724,-768,0.3137730358874879
2020,3133,21,7,1522,421,0.75,1101,0.7833247555326814
2020,3135,8,19,581,1085,0.2962962962962963,-504,0.3487394957983193
2020,3136,10,20,618,1108,0.3333333333333333,-490,0.35805330243337197
2020,3137,24,6,1572,361,0.8,1211,0.8132436627004656
2020,3138,19,12,1339,813,0.6129032258064516,526,0.6222118959107806
2020,3139,19,11,1268,632,0.6333333333333333,636,0.6673684210526316
2020,3140,17,11,1103,553,0.6071428571428571,550,0.6660628019323671
2020,3141,23,7,1807,484,0.7666666666666667,1323,0.7887385421213444
2020,3142,10,18,607,972,0.35714285714285715,-365,0.3844205193160228
2020,3143,12,19,909,1141,0.3870967741935484,-232,0.44341463414634147
2020,3144,19,8,1173,412,0.7037037037037037,761,0.7400630914826498
2020,3145,5,25,357,1474,0.16666666666666666,-1117,0.1949754232659749
2020,3146,10,16,598,806,0.38461538461538464,-208,0.42592592592592593
2020,3148,4,25,273,1387,0.13793103448275862,-1114,0.1644578313253012
2020,3149,2,26,116,1365,0.07142857142857142,-1249,0.07832545577312626
2020,3150,21,9,1392,510,0.7,882,0.7318611987381703
2020,3151,11,18,746,882,0.3793103448275862,-136,0.4582309582309582
2020,3152,1,27,60,1571,0.03571428571428571,-1511,0.03678724708767627
2020,3153,22,10,1660,562,0.6875,1098,0.7470747074707471
2020,3155,8,23,574,1291,0.25806451612903225,-717,0.30777479892761395
2020,3156,19,11,1338,645,0.6333333333333333,693,0.6747352496217852
2020,3157,23,4,1765,285,0.8518518518518519,1480,0.8609756097560975
2020,3158,12,17,896,984,0.41379310344827586,-88,0.4765957446808511
2020,3159,19,11,1460,612,0.6333333333333333,848,0.7046332046332047
2020,3160,16,14,1117,807,0.5333333333333333,310,0.5805613305613305
2020,3161,10,18,641,1019,0.35714285714285715,-378,0.386144578313253
2020,3162,17,10,1230,625,0.6296296296296297,605,0.6630727762803235
2020,3163,29,3,2353,166,0.90625,2187,0.9341008336641524
2020,3164,3,26,184,1248,0.10344827586206896,-1064,0.12849162011173185
2020,3165,10,16,718,912,0.38461538461538464,-194,0.4404907975460123
2020,3166,19,11,1326,674,0.6333333333333333,652,0.663
2020,3167,13,13,834,705,0.5,129,0.5419103313840156
2020,3168,17,14,1253,836,0.5483870967741935,417,0.5998085208233604
2020,3169,11,19,714,1003,0.36666666666666664,-289,0.4158415841584158
2020,3170,6,22,454,1474,0.21428571428571427,-1020,0.2354771784232365
2020,3171,10,17,650,822,0.37037037037037035,-172,0.44157608695652173
2020,3172,15,15,1116,832,0.5,284,0.5728952772073922
2020,3173,25,8,1663,461,0.7575757575757576,1202,0.7829566854990584
2020,3174,12,17,858,973,0.41379310344827586,-115,0.468596395412343
2020,3175,10,18,706,1015,0.35714285714285715,-309,0.41022661243463104
2020,3176,14,15,1154,1085,0.4827586206896552,69,0.5154086645824029
2020,3177,28,5,2451,353,0.8484848484848485,2098,0.8741084165477889
2020,3178,3,27,198,1531,0.1,-1333,0.11451706188548294
2020,3179,21,8,1780,596,0.7241379310344828,1184,0.7491582491582491
2020,3180,23,7,1459,363,0.7666666666666667,1096,0.8007683863885839
2020,3181,18,12,1324,708,0.6,616,0.6515748031496063
2020,3182,20,11,1474,668,0.6451612903225806,806,0.6881419234360411
2020,3183,18,12,1261,708,0.6,553,0.6404266124936516
2020,3184,10,18,630,954,0.35714285714285715,-324,0.3977272727272727
2020,3185,15,15,1074,913,0.5,161,0.5405133366884751
2020,3186,3,26,220,1456,0.10344827586206896,-1236,0.13126491646778043
2020,3187,9,21,543,1132,0.3,-589,0.32417910447761195
2020,3188,3,25,218,1382,0.10714285714285714,-1164,0.13625
2020,3189,13,16,933,895,0.4482758620689655,38,0.5103938730853391
2020,3190,8,21,528,1160,0.27586206896551724,-632,0.3127962085308057
2020,3191,2,26,142,1468,0.07142857142857142,-1326,0.08819875776397515
2020,3192,13,17,830,880,0.43333333333333335,-50,0.4853801169590643
2020,3193,16,14,1026,743,0.5333333333333333,283,0.5799886941775014
2020,3194,13,17,942,1046,0.43333333333333335,-104,0.4738430583501006
2020,3195,27,3,2143,171,0.9,1972,0.9261019878997407
2020,3196,15,15,1068,837,0.5,231,0.5606299212598426
2020,3197,4,21,240,1160,0.16,-920,0.17142857142857143
2020,3198,6,23,382,1142,0.20689655172413793,-760,0.25065616797900264
2020,3199,24,8,1814,507,0.75,1307,0.7815596725549332
2020,3200,21,11,1319,615,0.65625,704,0.6820062047569804
2020,3201,23,7,1774,458,0.7666666666666667,1316,0.7948028673835126
2020,3202,16,12,1111,686,0.5714285714285714,425,0.6182526432943796
2020,3203,14,16,863,820,0.4666666666666667,43,0.5127748068924539
2020,3204,10,20,774,1215,0.3333333333333333,-441,0.3891402714932127
2020,3205,18,11,1260,635,0.6206896551724138,625,0.6649076517150396
2020,3206,9,21,621,1196,0.3,-575,0.34177215189873417
2020,3207,5,25,312,1396,0.16666666666666666,-1084,0.18266978922716628
2020,3208,17,14,1183,777,0.5483870967741935,406,0.6035714285714285
2020,3209,8,21,516,1119,0.27586206896551724,-603,0.3155963302752294
2020,3210,20,11,1356,561,0.6451612903225806,795,0.7073552425665102
2020,3211,28,3,1913,199,0.9032258064516129,1714,0.9057765151515151
2020,3212,4,24,280,1393,0.14285714285714285,-1113,0.16736401673640167
2020,3213,13,12,820,660,0.52,160,0.5540540540540541
2020,3214,18,11,1231,636,0.6206896551724138,595,0.659346545259775
2020,3216,1,28,70,1457,0.034482758620689655,-1387,0.045841519318926
2020,3217,15,12,966,625,0.5555555555555556,341,0.6071653048397234
2020,3218,15,14,1035,763,0.5172413793103449,272,0.5756395995550612
2020,3219,16,13,1250,746,0.5517241379310345,504,0.62625250501002
2020,3220,3,27,152,1417,0.1,-1265,0.09687699171446781
2020,3221,19,11,1299,648,0.6333333333333333,651,0.6671802773497689
2020,3222,12,19,869,1044,0.3870967741935484,-175,0.45426032409827494
2020,3223,6,21,400,1217,0.2222222222222222,-817,0.24737167594310452
2020,3224,16,15,1216,889,0.5161290322580645,327,0.5776722090261283
2020,3225,22,9,1519,516,0.7096774193548387,1003,0.7464373464373464
2020,3226,16,13,1139,775,0.5517241379310345,364,0.5950888192267503
2020,3227,3,27,202,1288,0.1,-1086,0.13557046979865772
2020,3228,11,19,791,1070,0.36666666666666664,-279,0.4250403009134874
2020,3229,18,10,1300,649,0.6428571428571429,651,0.6670087224217548
2020,3230,10,15,686,732,0.4,-46,0.4837799717912553
2020,3231,24,8,1790,532,0.75,1258,0.7708871662360034
2020,3232,5,25,323,1470,0.16666666666666666,-1147,0.18014500836586725
2020,3233,9,21,573,1011,0.3,-438,0.36174242424242425
2020,3234,23,7,1924,460,0.7666666666666667,1464,0.8070469798657718
2020,3235,18,11,1336,764,0.6206896551724138,572,0.6361904761904762
2020,3236,3,24,186,1323,0.1111111111111111,-1137,0.12326043737574553
2020,3237,22,8,1634,484,0.7333333333333333,1150,0.7714825306893296
2020,3238,19,10,1396,578,0.6551724137931034,818,0.707193515704154
2020,3239,16,12,1214,703,0.5714285714285714,511,0.6332811684924361
2020,3240,12,16,764,891,0.42857142857142855,-127,0.461631419939577
2020,3241,25,4,1820,240,0.8620689655172413,1580,0.883495145631068
2020,3242,15,14,1171,839,0.5172413793103449,332,0.5825870646766169
2020,3243,16,13,1233,763,0.5517241379310345,470,0.6177354709418837
2020,3244,11,16,817,1013,0.4074074074074074,-196,0.446448087431694
2020,3245,18,11,1365,654,0.6206896551724138,711,0.6760772659732541
2020,3246,22,8,1650,525,0.7333333333333333,1125,0.7586206896551724
2020,3247,13,17,879,964,0.43333333333333335,-85,0.4769397721106891
2020,3248,15,14,933,704,0.5172413793103449,229,0.5699450213805742
2020,3249,8,19,555,994,0.2962962962962963,-439,0.35829567462879275
2020,3250,18,11,1283,612,0.6206896551724138,671,0.6770448548812665
2020,3251,20,11,1475,664,0.6451612903225806,811,0.6895745675549322
2020,3252,6,23,416,1386,0.20689655172413793,-970,0.23085460599334073
2020,3253,12,17,761,882,0.41379310344827586,-121,0.46317711503347536
2020,3254,8,22,558,1252,0.26666666666666666,-694,0.3082872928176796
2020,3255,12,18,858,1180,0.4,-322,0.4210009813542689
2020,3256,13,15,924,922,0.4642857142857143,2,0.5005417118093174
2020,3257,28,4,2099,230,0.875,1869,0.901245169600687
2020,3258,6,25,443,1482,0.1935483870967742,-1039,0.23012987012987013
2020,3259,8,22,509,1254,0.26666666666666666,-745,0.288712422007941
2020,3260,15,14,1081,860,0.5172413793103449,221,0.5569294178258629
2020,3261,20,10,1346,597,0.6666666666666666,749,0.6927431806484817
2020,3262,16,15,1020,780,0.5161290322580645,240,0.5666666666666667
2020,3263,17,14,1157,734,0.5483870967741935,423,0.6118455843469064
2020,3264,15,14,1020,755,0.5172413793103449,265,0.5746478873239437
2020,3265,26,4,1975,224,0.8666666666666667,1751,0.8981355161437017
2020,3266,24,8,1716,493,0.75,1223,0.7768220914440923
2020,3267,11,17,773,939,0.39285714285714285,-166,0.45151869158878505
2020,3268,28,4,2416,232,0.875,2184,0.9123867069486404
2020,3269,19,11,1323,636,0.6333333333333333,687,0.6753445635528331
2020,3270,3,24,221,1424,0.1111111111111111,-1203,0.13434650455927052
2020,3271,8,21,537,1074,0.27586206896551724,-537,0.3333333333333333
2020,3272,14,17,1004,1022,0.45161290322580644,-18,0.49555774925962487
2020,3273,7,23,421,1336,0.23333333333333334,-915,0.2396129766647695
2020,3274,15,15,1084,842,0.5,242,0.5628245067497404
2020,3275,10,20,761,1394,0.3333333333333333,-633,0.3531322505800464
2020,3276,21,11,1587,679,0.65625,908,0.7003530450132391
2020,3277,16,14,1220,852,0.5333333333333333,368,0.5888030888030888
2020,3278,16,15,1251,937,0.5161290322580645,314,0.5717550274223034
2020,3279,7,23,524,1175,0.23333333333333334,-651,0.3084167157151265
2020,3280,27,6,2219,394,0.8181818181818182,1825,0.8492154611557596
2020,3281,9,22,685,1375,0.2903225806451613,-690,0.3325242718446602
2020,3282,19,10,1341,570,0.6551724137931034,771,0.7017268445839875
2020,3283,25,4,1964,255,0.8620689655172413,1709,0.8850833708877873
2020,3284,9,22,541,1038,0.2903225806451613,-497,0.34262191260291325
2020,3285,15,13,1123,798,0.5357142857142857,325,0.5845913586673608
2020,3286,23,6,1855,364,0.7931034482758621,1491,0.8359621451104101
2020,3287,8,20,565,1150,0.2857142857142857,-585,0.3294460641399417
2020,3288,15,13,963,739,0.5357142857142857,224,0.5658049353701528
2020,3290,2,27,139,1591,0.06896551724137931,-1452,0.08034682080924856
2020,3291,19,11,1357,625,0.6333333333333333,732,0.6846619576185671
2020,3292,21,9,1613,517,0.7,1096,0.7572769953051643
2020,3293,12,16,902,910,0.42857142857142855,-8,0.4977924944812362
2020,3294,13,18,901,1003,0.41935483870967744,-102,0.4732142857142857
2020,3295,9,19,671,1183,0.32142857142857145,-512,0.36192017259978426
2020,3296,11,19,830,1191,0.36666666666666664,-361,0.4106877783275606
2020,3297,20,12,1424,683,0.625,741,0.6758424299952539
2020,3298,6,23,378,1131,0.20689655172413793,-753,0.2504970178926441
2020,3299,17,10,1146,549,0.6296296296296297,597,0.6761061946902654
2020,3300,12,16,842,989,0.42857142857142855,-147,0.4598580010922993
2020,3301,28,4,2046,245,0.875,1801,0.8930597992143169
2020,3303,5,23,330,1294,0.17857142857142858,-964,0.20320197044334976
2020,3304,17,13,1258,830,0.5666666666666667,428,0.6024904214559387
2020,3305,14,16,1020,1028,0.4666666666666667,-8,0.498046875
2020,3306,9,19,565,999,0.32142857142857145,-434,0.3612531969309463
2020,3307,14,17,1130,1175,0.45161290322580644,-45,0.49023861171366595
2020,3308,11,18,798,1031,0.3793103448275862,-233,0.4363039912520503
2020,3309,15,12,1070,636,0.5555555555555556,434,0.6271981242672919
2020,3310,10,21,735,1272,0.3225806451612903,-537,0.3662182361733931
2020,3311,11,16,759,925,0.4074074074074074,-166,0.4507125890736342
2020,3312,4,25,285,1307,0.13793103448275862,-1022,0.17902010050251257
2020,3313,18,11,1252,622,0.6206896551724138,630,0.6680896478121665
2020,3314,16,14,1258,935,0.5333333333333333,323,0.5736434108527132
2020,3315,13,15,968,920,0.4642857142857143,48,0.5127118644067796
2020,3316,14,15,962,822,0.4827586206896552,140,0.5392376681614349
2020,3317,10,18,718,1074,0.35714285714285715,-356,0.40066964285714285
2020,3318,13,16,851,943,0.4482758620689655,-92,0.47435897435897434
2020,3319,16,15,1252,987,0.5161290322580645,265,0.5591782045556052
2020,3320,17,11,1247,682,0.6071428571428571,565,0.6464489372731985
2020,3321,26,4,1887,239,0.8666666666666667,1648,0.8875823142050799
2020,3322,5,21,316,1145,0.19230769230769232,-829,0.216290212183436
2020,3323,13,18,910,1100,0.41935483870967744,-190,0.4527363184079602
2020,3324,9,19,673,1152,0.32142857142857145,-479,0.36876712328767125
2020,3325,19,11,1472,757,0.6333333333333333,715,0.6603858232391207
2020,3326,21,12,1639,722,0.6363636363636364,917,0.6941973739940703
2020,3328,12,18,1000,1291,0.4,-291,0.43649061545176776
2020,3329,15,15,1048,886,0.5,162,0.5418821096173733
2020,3330,24,6,1633,357,0.8,1276,0.8206030150753769
2020,3331,13,16,1005,969,0.4482758620689655,36,0.5091185410334347
2020,3332,31,2,2709,128,0.9393939393939394,2581,0.9548819175185055
2020,3333,23,9,1754,541,0.71875,1213,0.7642701525054466
2020,3334,17,14,1253,875,0.5483870967741935,378,0.5888157894736842
2020,3335,19,7,1331,384,0.7307692307692307,947,0.7760932944606413
2020,3336,7,23,557,1442,0.23333333333333334,-885,0.2786393196598299
2020,3337,14,15,999,863,0.4827586206896552,136,0.5365198711063373
2020,3338,5,26,328,1453,0.16129032258064516,-1125,0.18416619876473891
2020,3339,19,11,1387,677,0.6333333333333333,710,0.6719961240310077
2020,3340,15,16,1140,999,0.4838709677419355,141,0.5329593267882188
2020,3341,9,19,597,947,0.32142857142857145,-350,0.3866580310880829
2020,3342,10,18,698,910,0.35714285714285715,-212,0.43407960199004975
2020,3343,26,1,1848,75,0.9629629629629629,1773,0.9609984399375975
2020,3344,13,19,828,1085,0.40625,-257,0.4328280188186095
2020,3345,18,14,1275,783,0.5625,492,0.619533527696793
2020,3346,15,14,1080,851,0.5172413793103449,229,0.559295701708959
2020,3347,17,12,1117,617,0.5862068965517241,500,0.6441753171856978
2020,3348,13,16,913,914,0.4482758620689655,-1,0.4997263273125342
2020,3349,21,8,1523,405,0.7241379310344828,1118,0.7899377593360996
2020,3350,15,17,1007,951,0.46875,56,0.5143003064351379
2020,3351,26,4,1813,231,0.8666666666666667,1582,0.886986301369863
2020,3352,22,7,1472,413,0.7586206896551724,1059,0.7809018567639258
2020,3353,22,9,1535,525,0.7096774193548387,1010,0.7451456310679612
2020,3354,3,27,212,1370,0.1,-1158,0.13400758533501897
2020,3355,22,10,1654,608,0.6875,1046,0.731211317418214
2020,3356,16,13,1196,804,0.5517241379310345,392,0.598
2020,3357,12,17,800,900,0.41379310344827586,-100,0.47058823529411764
2020,3358,16,10,1262,625,0.6153846153846154,637,0.6687864334923158
2020,3359,17,14,1189,847,0.5483870967741935,342,0.5839882121807466
2020,3360,19,11,1208,598,0.6333333333333333,610,0.6688815060908084
2020,3361,13,17,858,1040,0.43333333333333335,-182,0.4520547945205479
2020,3362,12,19,877,1121,0.3870967741935484,-244,0.4389389389389389
2020,3363,18,12,1365,823,0.6,542,0.6238574040219378
2020,3364,13,15,842,858,0.4642857142857143,-16,0.49529411764705883
2020,3365,11,19,860,1152,0.36666666666666664,-292,0.4274353876739563
2020,3367,8,20,539,991,0.2857142857142857,-452,0.35228758169934643
2020,3368,11,17,738,972,0.39285714285714285,-234,0.43157894736842106
2020,3369,23,7,1762,446,0.7666666666666667,1316,0.7980072463768116
2020,3370,10,16,740,1013,0.38461538461538464,-273,0.42213348545350826
2020,3371,19,12,1404,823,0.6129032258064516,581,0.6304445442299057
2020,3372,20,6,1408,338,0.7692307692307693,1070,0.8064146620847652
2020,3373,11,20,683,1061,0.3548387096774194,-378,0.3916284403669725
2020,3374,13,16,819,897,0.4482758620689655,-78,0.4772727272727273
2020,3375,14,16,1030,1015,0.4666666666666667,15,0.5036674816625917
2020,3376,32,1,2650,57,0.9696969696969697,2593,0.9789434798670115
2020,3377,29,2,2370,126,0.9354838709677419,2244,0.9495192307692307
2020,3378,19,13,1359,686,0.59375,673,0.6645476772616137
2020,3379,13,15,839,928,0.4642857142857143,-89,0.4748160724391624
2020,3380,14,14,969,708,0.5,261,0.5778175313059034
2020,3381,18,13,1349,837,0.5806451612903226,512,0.6171088746569076
2020,3382,7,23,461,1283,0.23333333333333334,-822,0.2643348623853211
2020,3383,7,21,518,1251,0.25,-733,0.2928208027133974
2020,3384,11,19,722,965,0.36666666666666664,-243,0.42797866034380555
2020,3385,19,12,1434,806,0.6129032258064516,628,0.6401785714285714
2020,3386,9,20,584,944,0.3103448275862069,-360,0.38219895287958117
2020,3387,19,13,1216,721,0.59375,495,0.6277749096541043
2020,3388,12,19,947,1182,0.3870967741935484,-235,0.44480976984499765
2020,3389,9,21,677,1388,0.3,-711,0.3278450363196126
2020,3390,27,6,2038,382,0.8181818181818182,1656,0.8421487603305785
2020,3391,9,18,576,980,0.3333333333333333,-404,0.37017994858611825
2020,3392,27,3,1752,187,0.9,1565,0.9035585353274884
2020,3393,16,15,1171,941,0.5161290322580645,230,0.5544507575757576
2020,3394,20,7,1247,366,0.7407407407407407,881,0.7730936143831371
2020,3395,22,7,1587,483,0.7586206896551724,1104,0.7666666666666667
2020,3396,16,15,1185,938,0.5161290322580645,247,0.5581723975506359
2020,3397,21,10,1565,611,0.6774193548387096,954,0.7192095588235294
2020,3398,2,24,163,1332,0.07692307692307693,-1169,0.10903010033444815
2020,3399,15,13,1104,807,0.5357142857142857,297,0.5777080062794349
2020,3400,19,11,1441,643,0.6333333333333333,798,0.6914587332053743
2020,3401,22,8,1630,462,0.7333333333333333,1168,0.7791586998087954
2020,3402,11,17,713,987,0.39285714285714285,-274,0.4194117647058824
2020,3403,18,11,1563,718,0.6206896551724138,845,0.6852257781674704
2020,3404,22,10,1715,552,0.6875,1163,0.7565063961182179
2020,3405,14,17,1000,1071,0.45161290322580644,-71,0.48285852245292127
2020,3406,13,15,960,914,0.4642857142857143,46,0.512273212379936
2020,3407,23,4,1810,343,0.8518518518518519,1467,0.8406874129122155
2020,3408,14,17,874,954,0.45161290322580644,-80,0.47811816192560175
2020,3409,9,21,602,1102,0.3,-500,0.3532863849765258
2020,3410,9,17,691,1019,0.34615384615384615,-328,0.404093567251462
2020,3411,20,10,1582,580,0.6666666666666666,1002,0.7317298797409806
2020,3412,18,11,1394,706,0.6206896551724138,688,0.6638095238095238
2020,3413,16,12,1068,780,0.5714285714285714,288,0.577922077922078
2020,3414,12,18,892,1081,0.4,-189,0.45210339584389253
2020,3415,8,22,526,1226,0.26666666666666666,-700,0.3002283105022831
2020,3416,20,10,1390,530,0.6666666666666666,860,0.7239583333333334
2020,3417,26,5,1933,319,0.8387096774193549,1614,0.8583481349911191
2020,3418,17,12,1169,724,0.5862068965517241,445,0.6175382989963022
2020,3419,3,26,195,1405,0.10344827586206896,-1210,0.121875
2020,3420,9,18,565,974,0.3333333333333333,-409,0.36712150747238464
2020,3421,14,14,906,752,0.5,154,0.5464414957780458
2020,3422,20,9,1278,501,0.6896551724137931,777,0.718381112984823
2020,3423,9,19,619,1024,0.32142857142857145,-405,0.3767498478393183
2020,3424,13,17,864,940,0.43333333333333335,-76,0.4789356984478936
2020,3425,17,14,1168,842,0.5483870967741935,326,0.5810945273631841
2020,3426,21,11,1516,624,0.65625,892,0.708411214953271
2020,3427,3,23,205,1266,0.11538461538461539,-1061,0.13936097892590074
2020,3428,14,17,1058,1052,0.45161290322580644,6,0.5014218009478673
2020,3429,7,23,453,1241,0.23333333333333334,-788,0.26741440377804016
2020,3430,10,16,674,922,0.38461538461538464,-248,0.4223057644110276
2020,3431,16,14,1252,877,0.5333333333333333,375,0.588069516204791
2020,3433,20,12,1235,657,0.625,578,0.6527484143763214
2020,3434,17,12,1241,743,0.5862068965517241,498,0.6255040322580645
2020,3435,14,16,1057,947,0.4666666666666667,110,0.5274451097804391
2020,3436,11,18,695,1028,0.3793103448275862,-333,0.4033662217063262
2020,3437,18,13,1169,717,0.5806451612903226,452,0.61983032873807
2020,3438,13,17,903,939,0.43333333333333335,-36,0.49022801302931596
2020,3439,21,9,1551,578,0.7,973,0.728511038046031
2020,3441,3,25,181,1339,0.10714285714285714,-1158,0.11907894736842105
2020,3442,12,15,1005,938,0.4444444444444444,67,0.5172413793103449
2020,3443,22,7,1682,466,0.7586206896551724,1216,0.7830540037243948
2020,3444,17,13,1253,832,0.5666666666666667,421,0.6009592326139088
2020,3447,9,20,605,1089,0.3103448275862069,-484,0.35714285714285715
2020,3448,16,16,1145,955,0.5,190,0.5452380952380952
2020,3449,13,17,942,1048,0.43333333333333335,-106,0.4733668341708543
2020,3450,11,20,867,1157,0.3548387096774194,-290,0.42835968379446643
2020,3451,4,26,284,1461,0.13333333333333333,-1177,0.16275071633237823
2020,3452,17,12,1191,664,0.5862068965517241,527,0.6420485175202156
2020,3453,19,13,1399,733,0.59375,666,0.6561913696060038
2020,3454,14,16,966,840,0.4666666666666667,126,0.5348837209302325
2020,3455,16,15,1153,804,0.5161290322580645,349,0.5891670924885029
2020,3456,21,8,1538,492,0.7241379310344828,1046,0.7576354679802956
2020,3457,11,19,699,1013,0.36666666666666664,-314,0.40829439252336447
2020,3458,12,19,858,1144,0.3870967741935484,-286,0.42857142857142855
2020,3459,12,15,862,908,0.4444444444444444,-46,0.48700564971751414
2020,3460,18,12,1324,723,0.6,601,0.646800195407914
2020,3461,16,12,1137,662,0.5714285714285714,475,0.632017787659811
2020,3462,3,27,216,1586,0.1,-1370,0.11986681465038845
2020,3463,19,8,1400,459,0.7037037037037037,941,0.7530930607853685
2020,3464,11,17,807,965,0.39285714285714285,-158,0.4554176072234763
2020,3465,13,15,1023,999,0.4642857142857143,24,0.5059347181008902
2020,3466,19,9,1491,603,0.6785714285714286,888,0.7120343839541547
2020,3467,18,9,1251,519,0.6666666666666666,732,0.7067796610169491
2021,1101,19,4,1500,255,0.8260869565217391,1245,0.8547008547008547
2021,1102,5,20,327,1141,0.2,-814,0.22275204359673023
2021,1103,13,8,1038,570,0.6190476190476191,468,0.6455223880597015
2021,1104,24,6,2004,383,0.8,1621,0.8395475492249685
2021,1105,6,9,458,492,0.4,-34,0.48210526315789476
2021,1106,4,14,275,881,0.2222222222222222,-606,0.2378892733564014
2021,1107,7,9,536,574,0.4375,-38,0.4828828828828829
2021,1108,6,13,413,843,0.3157894736842105,-430,0.3288216560509554
2021,1110,4,6,311,380,0.4,-69,0.45007235890014474
2021,1111,13,11,983,653,0.5416666666666666,330,0.6008557457212714
2021,1112,17,9,1346,615,0.6538461538461539,731,0.6863844977052524
2021,1113,11,14,879,979,0.44,-100,0.4730893433799785
2021,1114,10,15,754,954,0.4,-200,0.4414519906323185
2021,1115,4,21,340,1209,0.16,-869,0.21949644932214332
2021,1116,22,6,1882,425,0.7857142857142857,1457,0.8157780667533593
2021,1117,8,13,630,825,0.38095238095238093,-195,0.4329896907216495
2021,1119,11,9,835,583,0.55,252,0.5888575458392101
2021,1120,13,14,1070,1014,0.48148148148148145,56,0.5134357005758158
2021,1122,12,13,894,929,0.48,-35,0.49040043883708173
2021,1123,10,13,839,880,0.43478260869565216,-41,0.48807446189645143
2021,1124,22,2,1893,132,0.9166666666666666,1761,0.9348148148148148
2021,1125,25,4,2063,303,0.8620689655172413,1760,0.8719357565511412
2021,1127,4,14,288,890,0.2222222222222222,-602,0.24448217317487267
2021,1129,17,8,1377,518,0.68,859,0.7266490765171504
2021,1130,4,16,325,1102,0.2,-777,0.22775052557813594
2021,1131,7,11,536,713,0.3888888888888889,-177,0.4291433146517214
2021,1132,13,11,1088,787,0.5416666666666666,301,0.5802666666666667
2021,1133,10,16,734,1014,0.38461538461538464,-280,0.41990846681922195
2021,1136,14,6,1135,488,0.7,647,0.6993222427603204
2021,1137,5,7,420,479,0.4166666666666667,-59,0.4671857619577308
2021,1138,15,8,1268,612,0.6521739130434783,656,0.674468085106383
2021,1139,10,15,684,904,0.4,-220,0.43073047858942065
2021,1140,19,6,1525,414,0.76,1111,0.7864878803506963
2021,1141,5,15,406,1069,0.25,-663,0.2752542372881356
2021,1142,3,20,236,1139,0.13043478260869565,-903,0.17163636363636364
2021,1143,8,20,592,1219,0.2857142857142857,-627,0.3268912203202651
2021,1144,15,10,1042,668,0.6,374,0.6093567251461989
2021,1145,7,6,533,382,0.5384615384615384,151,0.5825136612021858
2021,1146,4,19,336,1273,0.17391304347826086,-937,0.20882535736482288
2021,1148,5,16,405,1034,0.23809523809523808,-629,0.28144544822793605
2021,1149,2,18,147,1134,0.1,-987,0.11475409836065574
2021,1150,9,15,633,882,0.375,-249,0.4178217821782178
2021,1151,16,8,1159,549,0.6666666666666666,610,0.6785714285714286
2021,1153,12,11,865,720,0.5217391304347826,145,0.5457413249211357
2021,1154,9,12,760,872,0.42857142857142855,-112,0.46568627450980393
2021,1155,16,7,1095,407,0.6956521739130435,688,0.7290279627163782
2021,1156,19,7,1410,448,0.7307692307692307,962,0.7588805166846071
2021,1157,12,7,960,457,0.631578947368421,503,0.6774876499647142
2021,1158,7,10,517,639,0.4117647058823529,-122,0.4472318339100346
2021,1159,14,1,1222,73,0.9333333333333333,1149,0.9436293436293436
2021,1160,22,8,1668,523,0.7333333333333333,1145,0.761296211775445
2021,1161,17,6,1331,371,0.7391304347826086,960,0.782021151586369
2021,1163,15,7,1138,458,0.6818181818181818,680,0.7130325814536341
2021,1164,9,13,753,849,0.4090909090909091,-96,0.4700374531835206
2021,1166,20,8,1607,548,0.7142857142857143,1059,0.745707656612529
2021,1167,13,11,931,699,0.5416666666666666,232,0.5711656441717792
2021,1168,5,10,400,738,0.3333333333333333,-338,0.351493848857645
2021,1169,8,13,639,850,0.38095238095238093,-211,0.42914707857622564
2021,1170,6,12,453,804,0.3333333333333333,-351,0.360381861575179
2021,1172,12,8,912,505,0.6,407,0.6436132674664785
2021,1173,14,9,1016,598,0.6086956521739131,418,0.6294919454770755
2021,1174,6,8,420,514,0.42857142857142855,-94,0.44967880085653106
2021,1175,1,16,82,1107,0.058823529411764705,-1025,0.06896551724137931
2021,1176,1,19,85,1299,0.05,-1214,0.06141618497109826
2021,1177,5,14,394,856,0.2631578947368421,-462,0.3152
2021,1178,12,10,960,723,0.5454545454545454,237,0.5704099821746881
2021,1179,23,4,1821,237,0.8518518518518519,1584,0.8848396501457726
2021,1180,12,7,906,452,0.631578947368421,454,0.6671575846833578
2021,1181,13,11,1008,816,0.5416666666666666,192,0.5526315789473685
2021,1182,9,9,650,555,0.5,95,0.5394190871369294
2021,1183,9,18,724,1150,0.3333333333333333,-426,0.3863393810032017
2021,1184,20,7,1662,511,0.7407407407407407,1151,0.7648412333179936
2021,1185,3,12,226,785,0.2,-559,0.22354104846686448
2021,1186,15,7,1220,495,0.6818181818181818,725,0.7113702623906706
2021,1187,7,11,513,665,0.3888888888888889,-152,0.43548387096774194
2021,1188,8,17,587,1042,0.32,-455,0.3603437691835482
2021,1189,9,9,653,514,0.5,139,0.5595544130248501
2021,1190,11,12,817,761,0.4782608695652174,56,0.517743979721166
2021,1191,9,16,610,1009,0.36,-399,0.37677578752316243
2021,1192,9,15,731,1070,0.375,-339,0.4058856191004997
2021,1193,10,17,667,1001,0.37037037037037035,-334,0.3998800959232614
2021,1194,9,10,694,672,0.47368421052631576,22,0.5080527086383602
2021,1195,8,8,574,515,0.5,59,0.527089072543618
2021,1196,14,9,1112,589,0.6086956521739131,523,0.6537330981775427
2021,1197,8,12,539,775,0.4,-236,0.4101978691019787
2021,1198,5,17,405,1141,0.22727272727272727,-736,0.26196636481241914
2021,1199,16,6,1312,424,0.7272727272727273,888,0.7557603686635944
2021,1200,2,12,131,594,0.14285714285714285,-463,0.18068965517241378
2021,1201,10,12,724,702,0.45454545454545453,22,0.5077138849929874
2021,1202,13,9,1073,647,0.5909090909090909,426,0.6238372093023256
2021,1203,5,12,362,796,0.29411764705882354,-434,0.3126079447322971
2021,1204,9,13,656,805,0.4090909090909091,-149,0.4490075290896646
2021,1205,11,15,856,981,0.4230769230769231,-125,0.46597713663581924
2021,1206,12,9,929,574,0.5714285714285714,355,0.6180971390552229
2021,1207,13,12,984,800,0.52,184,0.5515695067264574
2021,1208,13,12,1031,899,0.52,132,0.5341968911917099
2021,1209,14,6,1130,410,0.7,720,0.7337662337662337
2021,1210,17,8,1325,563,0.68,762,0.7018008474576272
2021,1211,26,0,2395,0,1.0,2395,1.0
2021,1212,11,12,842,707,0.4782608695652174,135,0.5435765009683667
2021,1213,14,6,1052,373,0.7,679,0.7382456140350877
2021,1214,11,14,804,917,0.44,-113,0.4671702498547356
2021,1216,15,8,1068,447,0.6521739130434783,621,0.7049504950495049
2021,1218,9,10,696,635,0.47368421052631576,61,0.5229151014274981
2021,1219,9,15,645,955,0.375,-310,0.403125
2021,1220,13,10,1006,677,0.5652173913043478,329,0.5977421271538919
2021,1221,5,11,373,757,0.3125,-384,0.33008849557522124
2021,1222,23,3,1784,200,0.8846153846153846,1584,0.8991935483870968
2021,1223,5,19,404,1279,0.20833333333333334,-875,0.24004753416518124
2021,1224,1,3,81,211,0.25,-130,0.2773972602739726
2021,1225,1,21,74,1269,0.045454545454545456,-1195,0.055100521221146684
2021,1226,8,11,542,633,0.42105263157894735,-91,0.46127659574468083
2021,1227,9,13,630,859,0.4090909090909091,-229,0.4231027535258563
2021,1228,23,6,1910,451,0.7931034482758621,1459,0.8089792460821685
2021,1229,6,18,485,1137,0.25,-652,0.29901356350184954
2021,1230,5,14,355,883,0.2631578947368421,-528,0.2867528271405493
2021,1231,12,15,945,937,0.4444444444444444,8,0.502125398512221
2021,1232,14,10,964,618,0.5833333333333334,346,0.6093552465233881
2021,1233,12,5,900,328,0.7058823529411765,572,0.7328990228013029
2021,1234,21,8,1824,605,0.7241379310344828,1219,0.7509263071222725
2021,1235,2,22,140,1434,0.08333333333333333,-1294,0.08894536213468869
2021,1236,8,15,664,1064,0.34782608695652173,-400,0.38425925925925924
2021,1237,8,10,610,671,0.4444444444444444,-61,0.47619047619047616
2021,1238,12,6,833,348,0.6666666666666666,485,0.7053344623200677
2021,1239,9,13,633,812,0.4090909090909091,-179,0.4380622837370242
2021,1240,16,9,1201,615,0.64,586,0.6613436123348018
2021,1241,10,7,772,503,0.5882352941176471,269,0.6054901960784314
2021,1242,19,8,1390,568,0.7037037037037037,822,0.7099080694586313
2021,1243,9,19,598,1126,0.32142857142857145,-528,0.3468677494199536
2021,1244,2,19,163,1143,0.09523809523809523,-980,0.12480857580398162
2021,1245,14,8,1130,544,0.6363636363636364,586,0.6750298685782556
2021,1246,9,16,720,1041,0.36,-321,0.4088586030664395
2021,1247,8,16,626,996,0.3333333333333333,-370,0.38594327990135635
2021,1248,9,6,724,441,0.6,283,0.6214592274678111
2021,1249,10,18,685,1158,0.35714285714285715,-473,0.3716766142159523
2021,1250,4,11,323,702,0.26666666666666666,-379,0.3151219512195122
2021,1251,19,5,1452,305,0.7916666666666666,1147,0.8264086511098463
2021,1252,11,12,823,759,0.4782608695652174,64,0.5202275600505689
2021,1253,6,12,475,853,0.3333333333333333,-378,0.35768072289156627
2021,1254,9,9,745,587,0.5,158,0.5593093093093093
2021,1255,12,15,840,950,0.4444444444444444,-110,0.4692737430167598
2021,1256,20,7,1535,425,0.7407407407407407,1110,0.7831632653061225
2021,1257,13,7,956,403,0.65,553,0.70345842531273
2021,1258,13,9,968,561,0.5909090909090909,407,0.6330935251798561
2021,1259,6,11,441,785,0.35294117647058826,-344,0.35970636215334423
2021,1260,22,4,1577,257,0.8461538461538461,1320,0.8598691384950927
2021,1261,18,9,1550,667,0.6666666666666666,883,0.6991429860171403
2021,1262,11,12,831,744,0.4782608695652174,87,0.5276190476190477
2021,1263,2,7,104,374,0.2222222222222222,-270,0.2175732217573222
2021,1264,7,13,459,809,0.35,-350,0.36198738170347006
2021,1265,12,9,780,552,0.5714285714285714,228,0.5855855855855856
2021,1266,13,14,997,886,0.48148148148148145,111,0.52947424322889
2021,1267,15,7,1249,509,0.6818181818181818,740,0.7104664391353811
2021,1268,15,13,1104,791,0.5357142857142857,313,0.5825857519788918
2021,1269,8,7,642,509,0.5333333333333333,133,0.5577758470894874
2021,1270,4,14,334,948,0.2222222222222222,-614,0.26053042121684866
2021,1272,16,8,1222,508,0.6666666666666666,714,0.7063583815028902
2021,1273,15,11,1199,763,0.5769230769230769,436,0.6111111111111112
2021,1274,10,17,735,1059,0.37037037037037035,-324,0.4096989966555184
2021,1275,11,11,868,716,0.5,152,0.547979797979798
2021,1276,20,4,1589,241,0.8333333333333334,1348,0.8683060109289618
2021,1277,15,12,1151,713,0.5555555555555556,438,0.6174892703862661
2021,1278,14,15,1131,972,0.4827586206896552,159,0.5378031383737518
2021,1279,16,11,1144,722,0.5925925925925926,422,0.6130760986066452
2021,1280,15,14,1146,851,0.5172413793103449,295,0.5738607911867801
2021,1281,16,9,1236,605,0.64,631,0.6713742531233026
2021,1282,7,13,472,775,0.35,-303,0.3785084202085004
2021,1283,15,7,1158,437,0.6818181818181818,721,0.7260188087774294
2021,1284,12,8,933,588,0.6,345,0.6134122287968442
2021,1285,10,13,689,856,0.43478260869565216,-167,0.4459546925566343
2021,1286,11,10,805,688,0.5238095238095238,117,0.5391828533154722
2021,1287,21,7,1512,395,0.75,1117,0.7928683796539067
2021,1288,12,7,996,491,0.631578947368421,505,0.6698049764626766
2021,1290,2,22,135,1229,0.08333333333333333,-1094,0.09897360703812316
2021,1291,12,10,835,567,0.5454545454545454,268,0.5955777460770328
2021,1292,4,18,284,1066,0.18181818181818182,-782,0.21037037037037037
2021,1293,11,13,879,844,0.4583333333333333,35,0.51015670342426
2021,1294,8,11,599,693,0.42105263157894735,-94,0.46362229102167185
2021,1295,15,12,1093,790,0.5555555555555556,303,0.5804567180031864
2021,1296,3,16,210,974,0.15789473684210525,-764,0.17736486486486486
2021,1297,14,11,1061,723,0.56,338,0.5947309417040358
2021,1298,15,3,1089,198,0.8333333333333334,891,0.8461538461538461
2021,1299,9,10,655,659,0.47368421052631576,-4,0.4984779299847793
2021,1300,4,9,314,534,0.3076923076923077,-220,0.37028301886792453
2021,1301,13,10,1018,666,0.5652173913043478,352,0.6045130641330166
2021,1303,5,20,357,1326,0.2,-969,0.21212121212121213
2021,1304,6,20,469,1310,0.23076923076923078,-841,0.26363125351320965
2021,1305,15,10,1140,690,0.6,450,0.6229508196721312
2021,1306,9,9,625,560,0.5,65,0.5274261603375527
2021,1307,4,16,284,958,0.2,-674,0.2286634460547504
2021,1308,9,8,675,502,0.5294117647058824,173,0.5734919286321155
2021,1309,9,15,770,1055,0.375,-285,0.42191780821917807
2021,1310,9,11,644,649,0.45,-5,0.4980665119876257
2021,1311,17,7,1422,433,0.7083333333333334,989,0.7665768194070081
2021,1312,7,12,508,748,0.3684210526315789,-240,0.40445859872611467
2021,1313,14,7,1107,471,0.6666666666666666,636,0.7015209125475285
2021,1314,18,10,1450,669,0.6428571428571429,781,0.684285040113261
2021,1315,9,17,700,1087,0.34615384615384615,-387,0.39171796306659207
2021,1316,7,14,520,917,0.3333333333333333,-397,0.3618649965205289
2021,1317,16,9,1173,532,0.64,641,0.6879765395894428
2021,1318,10,9,713,564,0.5263157894736842,149,0.5583398590446359
2021,1319,6,16,436,954,0.2727272727272727,-518,0.31366906474820144
2021,1320,8,15,610,960,0.34782608695652173,-350,0.3885350318471338
2021,1321,8,15,633,953,0.34782608695652173,-320,0.3991172761664565
2021,1322,10,18,776,1253,0.35714285714285715,-477,0.3824544110399211
2021,1323,11,15,866,1024,0.4230769230769231,-158,0.4582010582010582
2021,1324,12,18,980,1260,0.4,-280,0.4375
2021,1325,15,7,1258,510,0.6818181818181818,748,0.7115384615384616
2021,1326,21,9,1698,622,0.7,1076,0.7318965517241379
2021,1328,15,10,1204,665,0.6,539,0.6441947565543071
2021,1329,20,8,1558,600,0.7142857142857143,958,0.7219647822057461
2021,1330,14,8,999,495,0.6363636363636364,504,0.6686746987951807
2021,1331,13,10,1098,728,0.5652173913043478,370,0.6013143483023001
2021,1332,20,6,1530,404,0.7692307692307693,1126,0.7911065149948294
2021,1333,16,12,1165,770,0.5714285714285714,395,0.6020671834625323
2021,1334,8,9,594,570,0.47058823529411764,24,0.5103092783505154
2021,1336,11,14,833,983,0.44,-150,0.45870044052863435
2021,1337,10,12,796,849,0.45454545454545453,-53,0.4838905775075988
2021,1338,10,12,771,795,0.45454545454545453,-24,0.49233716475095785
2021,1339,3,15,235,979,0.16666666666666666,-744,0.19357495881383854
2021,1340,6,12,432,752,0.3333333333333333,-320,0.36486486486486486
2021,1341,16,5,1183,314,0.7619047619047619,869,0.790247160988644
2021,1342,6,15,424,902,0.2857142857142857,-478,0.31975867269984914
2021,1344,13,13,974,842,0.5,132,0.5363436123348018
2021,1345,18,9,1348,572,0.6666666666666666,776,0.7020833333333333
2021,1346,9,13,700,785,0.4090909090909091,-85,0.4713804713804714
2021,1347,13,12,971,683,0.52,288,0.5870616686819831
2021,1348,10,15,771,1015,0.4,-244,0.4316909294512878
2021,1349,12,13,933,858,0.48,75,0.5209380234505863
2021,1350,12,8,940,544,0.6,396,0.633423180592992
2021,1351,6,17,460,1093,0.2608695652173913,-633,0.29620090148100453
2021,1352,3,15,257,1042,0.16666666666666666,-785,0.19784449576597382
2021,1353,15,11,1134,685,0.5769230769230769,449,0.6234194612424409
2021,1354,1,17,63,1039,0.05555555555555555,-976,0.05716878402903811
2021,1355,15,7,1237,520,0.6818181818181818,717,0.7040409789413773
2021,1356,11,14,782,820,0.44,-38,0.48813982521847693
2021,1357,9,9,689,576,0.5,113,0.5446640316205533
2021,1358,15,9,1216,571,0.625,645,0.6804700615556799
2021,1359,4,13,327,902,0.23529411764705882,-575,0.2660699755899105
2021,1360,3,11,219,708,0.21428571428571427,-489,0.23624595469255663
2021,1361,22,4,1684,233,0.8461538461538461,1451,0.8784559207094418
2021,1362,11,14,865,921,0.44,-56,0.4843225083986562
2021,1363,3,16,217,997,0.15789473684210525,-780,0.1787479406919275
2021,1364,20,4,1521,253,0.8333333333333334,1268,0.8573844419391207
2021,1365,11,8,799,506,0.5789473684210527,293,0.6122605363984674
2021,1367,5,17,338,1105,0.22727272727272727,-767,0.23423423423423423
2021,1368,8,18,623,1152,0.3076923076923077,-529,0.35098591549295777
2021,1369,11,16,849,1015,0.4074074074074074,-166,0.45547210300429186
2021,1370,8,11,617,718,0.42105263157894735,-101,0.46217228464419474
2021,1371,14,13,1050,874,0.5185185185185185,176,0.5457380457380457
2021,1372,13,5,1087,313,0.7222222222222222,774,0.7764285714285715
2021,1373,12,5,844,305,0.7058823529411765,539,0.7345517841601392
2021,1374,11,5,865,320,0.6875,545,0.729957805907173
2021,1375,13,11,910,801,0.5416666666666666,109,0.5318527177089422
2021,1376,6,15,471,1052,0.2857142857142857,-581,0.309258043335522
2021,1377,13,11,1050,765,0.5416666666666666,285,0.5785123966942148
2021,1378,8,13,574,781,0.38095238095238093,-207,0.4236162361623616
2021,1379,6,17,433,1018,0.2608695652173913,-585,0.2984148862853205
2021,1380,8,11,637,690,0.42105263157894735,-53,0.4800301431801055
2021,1381,15,4,1223,290,0.7894736842105263,933,0.8083278255122274
2021,1382,16,4,1178,232,0.8,946,0.8354609929078014
2021,1383,9,10,736,740,0.47368421052631576,-4,0.4986449864498645
2021,1384,6,16,477,1038,0.2727272727272727,-561,0.31485148514851485
2021,1385,16,11,1332,800,0.5925925925925926,532,0.624765478424015
2021,1386,5,15,403,1040,0.25,-637,0.27927927927927926
2021,1387,14,6,1108,399,0.7,709,0.7352355673523556
2021,1388,14,9,966,509,0.6086956521739131,457,0.6549152542372881
2021,1389,14,11,942,638,0.56,304,0.5962025316455696
2021,1390,14,13,1074,809,0.5185185185185185,265,0.5703664365374402
2021,1391,9,13,702,832,0.4090909090909091,-130,0.4576271186440678
2021,1392,8,14,547,892,0.36363636363636365,-345,0.3801250868658791
2021,1393,16,9,1280,616,0.64,664,0.6751054852320675
2021,1394,2,19,171,1161,0.09523809523809523,-990,0.12837837837837837
2021,1395,12,14,877,861,0.46153846153846156,16,0.5046029919447641
2021,1396,5,11,340,713,0.3125,-373,0.32288698955365625
2021,1397,18,8,1399,486,0.6923076923076923,913,0.7421750663129973
2021,1398,3,19,230,1253,0.13636363636363635,-1023,0.15509103169251517
2021,1399,5,22,378,1419,0.18518518518518517,-1041,0.21035058430717862
2021,1400,19,7,1459,497,0.7307692307692307,962,0.7459100204498977
2021,1401,8,10,567,590,0.4444444444444444,-23,0.49006050129645634
2021,1402,17,6,1117,387,0.7391304347826086,730,0.742686170212766
2021,1403,17,10,1298,674,0.6296296296296297,624,0.6582150101419878
2021,1404,7,16,497,979,0.30434782608695654,-482,0.3367208672086721
2021,1405,21,8,1763,604,0.7241379310344828,1159,0.7448246725813266
2021,1406,4,14,296,918,0.2222222222222222,-622,0.24382207578253706
2021,1407,8,17,571,1019,0.32,-448,0.3591194968553459
2021,1408,10,13,674,796,0.43478260869565216,-122,0.45850340136054424
2021,1409,9,12,620,744,0.42857142857142855,-124,0.45454545454545453
2021,1410,5,10,365,619,0.3333333333333333,-254,0.3709349593495935
2021,1411,15,8,1157,535,0.6521739130434783,622,0.683806146572104
2021,1412,20,7,1459,440,0.7407407407407407,1019,0.7682991047919958
2021,1413,9,8,638,562,0.5294117647058824,76,0.5316666666666666
2021,1414,16,9,1167,544,0.64,623,0.6820572764465225
2021,1415,14,8,1016,528,0.6363636363636364,488,0.6580310880829016
2021,1416,11,12,787,759,0.4782608695652174,28,0.5090556274256145
2021,1417,17,9,1296,598,0.6538461538461539,698,0.6842661034846885
2021,1418,15,9,1095,665,0.625,430,0.6221590909090909
2021,1419,7,19,522,1148,0.2692307692307692,-626,0.3125748502994012
2021,1420,14,6,984,407,0.7,577,0.7074047447879224
2021,1421,10,10,799,669,0.5,130,0.5442779291553134
2021,1422,21,8,1608,527,0.7241379310344828,1081,0.7531615925058548
2021,1423,6,10,471,710,0.375,-239,0.3988145639288738
2021,1424,10,15,685,996,0.4,-311,0.40749553837001784
2021,1425,22,7,1727,441,0.7586206896551724,1286,0.7965867158671587
2021,1426,10,13,712,887,0.43478260869565216,-175,0.4452782989368355
2021,1427,11,11,914,723,0.5,191,0.5583384239462431
2021,1428,12,13,948,855,0.48,93,0.5257903494176372
2021,1429,19,8,1434,528,0.7037037037037037,906,0.7308868501529052
2021,1430,9,11,690,763,0.45,-73,0.4748795595320027
2021,1431,9,12,704,731,0.42857142857142855,-27,0.4905923344947735
2021,1433,19,7,1409,455,0.7307692307692307,954,0.755901287553648
2021,1434,8,18,590,1057,0.3076923076923077,-467,0.3582270795385549
2021,1435,9,16,704,1090,0.36,-386,0.39241917502787066
2021,1436,10,5,768,327,0.6666666666666666,441,0.7013698630136986
2021,1437,16,6,1276,386,0.7272727272727273,890,0.7677496991576414
2021,1438,18,6,1275,372,0.75,903,0.7741347905282332
2021,1439,15,6,1131,384,0.7142857142857143,747,0.7465346534653465
2021,1440,10,12,866,839,0.45454545454545453,27,0.5079178885630499
2021,1441,9,16,753,1099,0.36,-346,0.4065874730021598
2021,1442,6,15,497,1029,0.2857142857142857,-532,0.3256880733944954
2021,1443,20,7,1544,430,0.7407407407407407,1114,0.7821681864235056
2021,1444,4,16,292,971,0.2,-679,0.23119556611243072
2021,1447,13,7,955,470,0.65,485,0.6701754385964912
2021,1448,5,16,393,995,0.23809523809523808,-602,0.2831412103746398
2021,1449,5,21,367,1392,0.19230769230769232,-1025,0.20864127345082434
2021,1450,14,13,1020,833,0.5185185185185185,187,0.5504587155963303
2021,1451,14,6,1160,424,0.7,736,0.7323232323232324
2021,1452,18,9,1391,696,0.6666666666666666,695,0.6665069477719214
2021,1453,8,17,648,1142,0.32,-494,0.36201117318435755
2021,1454,10,12,809,853,0.45454545454545453,-44,0.48676293622142
2021,1455,14,5,1066,300,0.7368421052631579,766,0.780380673499268
2021,1456,7,10,528,573,0.4117647058823529,-45,0.47956403269754766
2021,1457,23,1,1854,55,0.9583333333333334,1799,0.9711891042430592
2021,1458,17,12,1254,765,0.5862068965517241,489,0.6210995542347697
2021,1459,13,9,1005,580,0.5909090909090909,425,0.6340694006309149
2021,1460,18,6,1529,438,0.75,1091,0.7773258769700051
2021,1461,14,11,1197,718,0.56,479,0.625065274151436
2021,1462,13,8,1024,547,0.6190476190476191,477,0.6518141311266709
2021,1464,11,12,853,836,0.4782608695652174,17,0.5050325636471285
2021,1465,9,10,736,714,0.47368421052631576,22,0.5075862068965518
2021,1466,9,11,682,688,0.45,-6,0.4978102189781022
2021,1467,9,9,639,554,0.5,85,0.5356244761106455
2021,1468,11,7,836,470,0.6111111111111112,366,0.6401225114854517
2021,1469,6,13,460,825,0.3157894736842105,-365,0.35797665369649806
2021,1470,5,10,345,613,0.3333333333333333,-268,0.36012526096033404
2021,1471,4,10,346,615,0.2857142857142857,-269,0.3600416233090531
2021,3101,9,10,637,587,0.47368421052631576,50,0.5204248366013072
2021,3102,7,17,516,918,0.2916666666666667,-402,0.3598326359832636
2021,3103,6,14,475,847,0.3,-372,0.35930408472012104
2021,3104,16,9,1279,591,0.64,688,0.6839572192513369
2021,3105,10,7,715,407,0.5882352941176471,308,0.6372549019607843
2021,3106,16,4,1237,231,0.8,1006,0.8426430517711172
2021,3107,7,11,397,500,0.3888888888888889,-103,0.44258639910813824
2021,3108,7,13,457,713,0.35,-256,0.3905982905982906
2021,3110,7,4,446,259,0.6363636363636364,187,0.6326241134751773
2021,3111,15,12,1060,687,0.5555555555555556,373,0.6067544361763022
2021,3112,16,5,1114,284,0.7619047619047619,830,0.7968526466380543
2021,3113,11,10,645,517,0.5238095238095238,128,0.5550774526678142
2021,3114,15,11,979,549,0.5769230769230769,430,0.6407068062827225
2021,3115,3,18,227,1093,0.14285714285714285,-866,0.17196969696969697
2021,3116,19,8,1655,588,0.7037037037037037,1067,0.7378510922871154
2021,3117,5,12,327,702,0.29411764705882354,-375,0.3177842565597668
2021,3119,9,11,595,590,0.45,5,0.5021097046413502
2021,3120,5,19,413,1151,0.20833333333333334,-738,0.2640664961636829
2021,3122,11,11,757,622,0.5,135,0.5489485134155185
2021,3123,14,11,1105,719,0.56,386,0.6058114035087719
2021,3124,25,2,2054,149,0.9259259259259259,1905,0.932364956876986
2021,3125,20,5,1455,306,0.8,1149,0.8262350936967632
2021,3127,5,11,306,557,0.3125,-251,0.354577056778679
2021,3129,13,9,1011,493,0.5909090909090909,518,0.6722074468085106
2021,3130,7,12,496,799,0.3684210526315789,-303,0.383011583011583
2021,3131,12,2,835,95,0.8571428571428571,740,0.8978494623655914
2021,3132,20,6,1481,436,0.7692307692307693,1045,0.7725612936880543
2021,3133,16,11,1211,673,0.5925925925925926,538,0.6427813163481954
2021,3136,7,14,492,720,0.3333333333333333,-228,0.40594059405940597
2021,3137,9,1,652,54,0.9,598,0.9235127478753541
2021,3138,15,9,1173,598,0.625,575,0.6623376623376623
2021,3139,3,17,217,927,0.15,-710,0.1896853146853147
2021,3140,18,5,1320,274,0.782608695652174,1046,0.8281053952321205
2021,3141,18,8,1456,569,0.6923076923076923,887,0.7190123456790124
2021,3142,13,11,869,612,0.5416666666666666,257,0.5867656988521269
2021,3143,1,16,67,779,0.058823529411764705,-712,0.07919621749408984
2021,3144,16,6,986,352,0.7272727272727273,634,0.7369207772795217
2021,3146,13,14,785,694,0.48148148148148145,91,0.530764029749831
2021,3148,4,14,298,814,0.2222222222222222,-516,0.26798561151079137
2021,3149,5,17,306,950,0.22727272727272727,-644,0.24363057324840764
2021,3150,10,10,768,754,0.5,14,0.5045992115637319
2021,3151,14,10,988,537,0.5833333333333334,451,0.6478688524590164
2021,3153,8,16,572,911,0.3333333333333333,-339,0.3857046527309508
2021,3155,11,13,853,845,0.4583333333333333,8,0.5023557126030624
2021,3156,10,9,713,477,0.5263157894736842,236,0.5991596638655462
2021,3157,1,15,88,944,0.0625,-856,0.08527131782945736
2021,3158,5,9,363,514,0.35714285714285715,-151,0.41391106043329534
2021,3159,1,8,87,410,0.1111111111111111,-323,0.1750503018108652
2021,3160,9,10,628,583,0.47368421052631576,45,0.518579686209744
2021,3161,13,6,1023,400,0.6842105263157895,623,0.71890372452565
2021,3163,24,1,1964,87,0.96,1877,0.9575816674792784
2021,3164,2,13,113,654,0.13333333333333333,-541,0.14732724902216426
2021,3166,9,11,625,607,0.45,18,0.5073051948051948
2021,3167,9,9,584,496,0.5,88,0.5407407407407407
2021,3168,3,18,180,999,0.14285714285714285,-819,0.15267175572519084
2021,3170,3,22,220,1413,0.12,-1193,0.13472137170851195
2021,3172,9,14,636,802,0.391304347826087,-166,0.4422809457579972
2021,3173,14,3,954,181,0.8235294117647058,773,0.8405286343612335
2021,3174,20,4,1503,231,0.8333333333333334,1272,0.8667820069204152
2021,3175,3,11,186,629,0.21428571428571427,-443,0.2282208588957055
2021,3176,7,16,551,1101,0.30434782608695654,-550,0.33353510895883776
2021,3177,14,8,1213,581,0.6363636363636364,632,0.6761426978818283
2021,3178,1,13,72,732,0.07142857142857142,-660,0.08955223880597014
2021,3179,16,11,1271,797,0.5925925925925926,474,0.6146034816247582
2021,3180,14,8,915,439,0.6363636363636364,476,0.6757754800590842
2021,3181,3,1,249,49,0.75,200,0.8355704697986577
2021,3182,5,11,340,659,0.3125,-319,0.34034034034034033
2021,3183,11,15,771,915,0.4230769230769231,-144,0.45729537366548045
2021,3184,9,15,643,850,0.375,-207,0.4306764902880107
2021,3185,10,10,670,611,0.5,59,0.5230288836846214
2021,3186,5,17,368,1008,0.22727272727272727,-640,0.26744186046511625
2021,3187,8,14,530,796,0.36363636363636365,-266,0.3996983408748115
2021,3188,5,19,319,1026,0.20833333333333334,-707,0.23717472118959107
2021,3189,7,8,506,441,0.4666666666666667,65,0.5343189017951425
2021,3190,3,16,188,909,0.15789473684210525,-721,0.17137648131267091
2021,3191,5,17,335,838,0.22727272727272727,-503,0.2855924978687127
2021,3192,16,8,1024,422,0.6666666666666666,602,0.7081604426002767
2021,3193,11,5,708,237,0.6875,471,0.7492063492063492
2021,3194,10,11,772,722,0.47619047619047616,50,0.5167336010709505
2021,3195,24,2,1994,129,0.9230769230769231,1865,0.9392369288742346
2021,3196,11,13,857,892,0.4583333333333333,-35,0.48999428244711263
2021,3198,10,12,782,776,0.45454545454545453,6,0.5019255455712451
2021,3199,10,8,707,474,0.5555555555555556,233,0.598645215918713
2021,3200,12,4,752,248,0.75,504,0.752
2021,3201,16,10,1303,723,0.6153846153846154,580,0.6431391905231985
2021,3202,8,14,474,799,0.36363636363636365,-325,0.3723487824037706
2021,3203,8,14,491,746,0.36363636363636365,-255,0.396928051738076
2021,3204,8,13,652,877,0.38095238095238093,-225,0.4264224983649444
2021,3205,11,13,746,782,0.4583333333333333,-36,0.4882198952879581
2021,3206,3,19,218,898,0.13636363636363635,-680,0.1953405017921147
2021,3207,2,15,118,738,0.11764705882352941,-620,0.1378504672897196
2021,3208,20,6,1548,332,0.7692307692307693,1216,0.823404255319149
2021,3209,12,11,838,674,0.5217391304347826,164,0.5542328042328042
2021,3210,15,8,1018,496,0.6521739130434783,522,0.6723910171730515
2021,3211,23,3,1658,200,0.8846153846153846,1458,0.8923573735199138
2021,3212,10,10,662,604,0.5,58,0.5229067930489731
2021,3213,15,7,1120,442,0.6818181818181818,678,0.7170294494238156
2021,3214,4,11,249,590,0.26666666666666666,-341,0.2967818831942789
2021,3216,3,9,181,436,0.25,-255,0.293354943273906
2021,3218,8,7,548,387,0.5333333333333333,161,0.586096256684492
2021,3219,20,6,1500,365,0.7692307692307693,1135,0.8042895442359249
2021,3220,8,12,558,635,0.4,-77,0.4677284157585918
2021,3221,7,8,463,450,0.4666666666666667,13,0.5071193866374589
2021,3222,16,7,1191,359,0.6956521739130435,832,0.7683870967741936
2021,3223,8,11,561,617,0.42105263157894735,-56,0.4762308998302207
2021,3224,15,4,1038,254,0.7894736842105263,784,0.8034055727554179
2021,3225,17,7,1356,375,0.7083333333333334,981,0.7833622183708839
2021,3226,21,3,1526,187,0.875,1339,0.8908347927612376
2021,3227,2,16,142,936,0.1111111111111111,-794,0.13172541743970315
2021,3228,5,18,314,1056,0.21739130434782608,-742,0.2291970802919708
2021,3229,13,7,927,421,0.65,506,0.6876854599406528
2021,3230,5,9,319,503,0.35714285714285715,-184,0.3880778588807786
2021,3231,18,5,1414,337,0.782608695652174,1077,0.8075385494003426
2021,3232,5,15,394,857,0.25,-463,0.3149480415667466
2021,3233,6,9,369,451,0.4,-82,0.45
2021,3234,18,9,1611,727,0.6666666666666666,884,0.6890504704875963
2021,3235,16,10,1314,681,0.6153846153846154,633,0.6586466165413534
2021,3236,1,22,71,1163,0.043478260869565216,-1092,0.05753646677471637
2021,3237,15,5,1099,303,0.75,796,0.7838801711840229
2021,3238,18,5,1262,317,0.782608695652174,945,0.799240025332489
2021,3239,2,17,126,964,0.10526315789473684,-838,0.11559633027522936
2021,3240,15,9,1030,516,0.625,514,0.666235446313066
2021,3241,14,10,1029,650,0.5833333333333334,379,0.6128648004764741
2021,3242,7,18,567,1193,0.28,-626,0.3221590909090909
2021,3243,9,18,632,1070,0.3333333333333333,-438,0.37132784958871917
2021,3244,3,12,228,660,0.2,-432,0.25675675675675674
2021,3245,11,9,790,578,0.55,212,0.577485380116959
2021,3246,17,8,1312,515,0.68,797,0.7181171319102354
2021,3247,12,14,810,870,0.46153846153846156,-60,0.48214285714285715
2021,3248,5,8,329,460,0.38461538461538464,-131,0.41698352344740175
2021,3249,10,14,667,817,0.4166666666666667,-150,0.4494609164420485
2021,3250,9,5,701,318,0.6428571428571429,383,0.6879293424926398
2021,3251,17,8,1274,524,0.68,750,0.7085650723025584
2021,3252,10,10,692,553,0.5,139,0.5558232931726907
2021,3253,11,9,748,531,0.55,217,0.584831899921814
2021,3254,7,11,439,619,0.3888888888888889,-180,0.41493383742911155
2021,3255,14,11,1099,679,0.56,420,0.6181102362204725
2021,3256,14,10,980,570,0.5833333333333334,410,0.632258064516129
2021,3257,23,3,1870,175,0.8846153846153846,1695,0.9144254278728606
2021,3258,7,19,497,1091,0.2692307692307692,-594,0.31297229219143574
2021,3260,10,13,616,707,0.43478260869565216,-91,0.4656084656084656
2021,3261,9,13,586,739,0.4090909090909091,-153,0.4422641509433962
2021,3262,12,9,788,418,0.5714285714285714,370,0.6533996683250415
2021,3263,17,3,1153,171,0.85,982,0.870845921450151
2021,3264,10,7,611,323,0.5882352941176471,288,0.6541755888650964
2021,3265,18,3,1171,164,0.8571428571428571,1007,0.8771535580524344
2021,3266,19,6,1416,353,0.76,1063,0.8004522328999435
2021,3267,8,11,545,597,0.42105263157894735,-52,0.47723292469352013
2021,3268,24,2,2215,158,0.9230769230769231,2057,0.933417614833544
2021,3269,14,6,1042,382,0.7,660,0.7317415730337079
2021,3270,6,15,411,754,0.2857142857142857,-343,0.35278969957081546
2021,3272,4,15,261,891,0.21052631578947367,-630,0.2265625
2021,3273,18,6,1273,373,0.75,900,0.7733900364520049
2021,3274,11,11,798,655,0.5,143,0.5492085340674466
2021,3275,4,20,263,1304,0.16666666666666666,-1041,0.16783663050414804
2021,3276,14,5,1104,321,0.7368421052631579,783,0.7747368421052632
2021,3277,15,8,1192,537,0.6521739130434783,655,0.6894158473105841
2021,3278,8,13,622,821,0.38095238095238093,-199,0.43104643104643103
2021,3279,11,11,855,704,0.5,151,0.5484284797947402
2021,3280,10,9,794,582,0.5263157894736842,212,0.5770348837209303
2021,3281,9,11,752,743,0.45,9,0.5030100334448161
2021,3282,8,12,622,723,0.4,-101,0.462453531598513
2021,3283,20,2,1419,111,0.9090909090909091,1308,0.9274509803921569
2021,3284,2,16,124,704,0.1111111111111111,-580,0.1497584541062802
2021,3285,11,11,771,678,0.5,93,0.5320910973084886
2021,3286,17,7,1299,430,0.7083333333333334,869,0.7513013302486987
2021,3287,6,16,373,893,0.2727272727272727,-520,0.29462875197472355
2021,3288,12,4,800,229,0.75,571,0.7774538386783285
2021,3290,4,16,256,856,0.2,-600,0.2302158273381295
2021,3291,16,6,1212,393,0.7272727272727273,819,0.7551401869158878
2021,3292,17,7,1331,458,0.7083333333333334,873,0.7439910564561207
2021,3293,16,11,1207,678,0.5925925925925926,529,0.640318302387268
2021,3294,14,12,972,712,0.5384615384615384,260,0.5771971496437055
2021,3295,15,9,1097,569,0.625,528,0.6584633853541416
2021,3296,12,12,958,802,0.5,156,0.5443181818181818
2021,3297,8,11,577,658,0.42105263157894735,-81,0.4672064777327935
2021,3298,5,7,307,400,0.4166666666666667,-93,0.43422913719943423
2021,3299,13,2,964,100,0.8666666666666667,864,0.9060150375939849
2021,3300,3,12,192,737,0.2,-545,0.20667384284176535
2021,3301,20,2,1561,140,0.9090909090909091,1421,0.9176954732510288
2021,3303,7,13,520,718,0.35,-198,0.420032310177706
2021,3304,12,12,852,813,0.5,39,0.5117117117117117
2021,3305,11,9,720,544,0.55,176,0.569620253164557
2021,3306,5,15,302,773,0.25,-471,0.28093023255813954
2021,3307,14,4,1172,274,0.7777777777777778,898,0.8105117565698479
2021,3308,8,12,538,693,0.4,-155,0.4370430544272949
2021,3309,6,15,401,751,0.2857142857142857,-350,0.3480902777777778
2021,3310,4,7,307,383,0.36363636363636365,-76,0.4449275362318841
2021,3311,10,14,718,758,0.4166666666666667,-40,0.48644986449864497
2021,3312,4,14,275,739,0.2222222222222222,-464,0.27120315581854043
2021,3313,4,9,273,432,0.3076923076923077,-159,0.3872340425531915
2021,3314,13,10,1093,628,0.5652173913043478,465,0.6350958744915747
2021,3315,2,19,154,1242,0.09523809523809523,-1088,0.11031518624641834
2021,3316,13,11,1000,700,0.5416666666666666,300,0.5882352941176471
2021,3317,13,7,963,423,0.65,540,0.6948051948051948
2021,3318,7,13,474,767,0.35,-293,0.3819500402900886
2021,3319,13,13,1044,822,0.5,222,0.5594855305466238
2021,3320,14,12,1074,761,0.5384615384615384,313,0.5852861035422343
2021,3321,15,8,1104,465,0.6521739130434783,639,0.7036328871892925
2021,3322,1,19,50,881,0.05,-831,0.05370569280343716
2021,3323,10,10,735,665,0.5,70,0.525
2021,3324,12,12,919,748,0.5,171,0.5512897420515896
2021,3325,14,8,1119,609,0.6363636363636364,510,0.6475694444444444
2021,3326,13,7,1151,453,0.65,698,0.7175810473815462
2021,3328,12,12,939,825,0.5,114,0.532312925170068
2021,3329,18,8,1358,485,0.6923076923076923,873,0.7368421052631579
2021,3330,13,11,952,761,0.5416666666666666,191,0.5557501459427904
2021,3331,5,15,390,891,0.25,-501,0.3044496487119438
2021,3332,13,8,1043,492,0.6190476190476191,551,0.6794788273615635
2021,3333,10,7,791,422,0.5882352941176471,369,0.6521022258862325
2021,3334,11,11,810,690,0.5,120,0.54
2021,3336,9,15,722,1018,0.375,-296,0.4149425287356322
2021,3337,4,18,236,1048,0.18181818181818182,-812,0.1838006230529595
2021,3338,5,14,385,858,0.2631578947368421,-473,0.30973451327433627
2021,3339,11,12,808,736,0.4782608695652174,72,0.5233160621761658
2021,3340,9,13,600,789,0.4090909090909091,-189,0.4319654427645788
2021,3341,3,13,244,717,0.1875,-473,0.25390218522372526
2021,3342,11,10,739,567,0.5238095238095238,172,0.5658499234303216
2021,3344,7,14,477,727,0.3333333333333333,-250,0.3961794019933555
2021,3345,7,16,541,982,0.30434782608695654,-441,0.3552199606040709
2021,3346,13,8,851,483,0.6190476190476191,368,0.6379310344827587
2021,3347,9,11,582,656,0.45,-74,0.4701130856219709
2021,3348,11,8,728,466,0.5789473684210527,262,0.609715242881072
2021,3349,18,4,1278,240,0.8181818181818182,1038,0.841897233201581
2021,3350,13,9,883,510,0.5909090909090909,373,0.633883704235463
2021,3351,8,18,479,919,0.3076923076923077,-440,0.3426323319027182
2021,3352,4,13,256,706,0.23529411764705882,-450,0.2661122661122661
2021,3353,14,4,1078,283,0.7777777777777778,795,0.7920646583394563
2021,3354,1,9,69,391,0.1,-322,0.15
2021,3355,21,3,1550,141,0.875,1409,0.9166173861620343
2021,3356,9,16,639,866,0.36,-227,0.4245847176079734
2021,3357,8,10,546,578,0.4444444444444444,-32,0.48576512455516013
2021,3358,12,8,908,545,0.6,363,0.6249139710942877
2021,3359,12,9,883,505,0.5714285714285714,378,0.6361671469740634
2021,3360,11,7,758,389,0.6111111111111112,369,0.6608544027898866
2021,3361,7,17,463,978,0.2916666666666667,-515,0.32130464954892435
2021,3362,14,10,1102,600,0.5833333333333334,502,0.6474735605170387
2021,3363,2,2,134,128,0.5,6,0.5114503816793893
2021,3364,7,14,540,846,0.3333333333333333,-306,0.38961038961038963
2021,3365,14,11,1005,629,0.56,376,0.6150550795593636
2021,3367,6,15,385,796,0.2857142857142857,-411,0.3259949195596952
2021,3368,11,8,815,494,0.5789473684210527,321,0.6226126814362108
2021,3369,14,11,963,659,0.56,304,0.593711467324291
2021,3370,8,14,578,848,0.36363636363636365,-270,0.4053295932678822
2021,3371,14,7,1131,479,0.6666666666666666,652,0.7024844720496894
2021,3372,22,2,1826,106,0.9166666666666666,1720,0.9451345755693582
2021,3373,4,9,279,478,0.3076923076923077,-199,0.36856010568031705
2021,3375,11,13,736,756,0.4583333333333333,-20,0.4932975871313673
2021,3376,22,4,1768,229,0.8461538461538461,1539,0.885327991987982
2021,3377,18,5,1405,314,0.782608695652174,1091,0.8173356602675974
2021,3378,18,3,1224,156,0.8571428571428571,1068,0.8869565217391304
2021,3379,6,12,426,759,0.3333333333333333,-333,0.3594936708860759
2021,3380,12,11,799,596,0.5217391304347826,203,0.5727598566308244
2021,3381,10,9,791,528,0.5263157894736842,263,0.599696739954511
2021,3382,6,15,418,817,0.2857142857142857,-399,0.3384615384615385
2021,3383,4,10,276,629,0.2857142857142857,-353,0.30497237569060776
2021,3384,14,9,958,513,0.6086956521739131,445,0.6512576478585996
2021,3385,8,15,526,925,0.34782608695652173,-399,0.36250861474844936
2021,3386,6,10,410,551,0.375,-141,0.4266389177939646
2021,3387,12,4,803,258,0.75,545,0.7568331762488218
2021,3388,7,19,499,1133,0.2692307692307692,-634,0.30575980392156865
2021,3389,13,15,829,838,0.4642857142857143,-9,0.4973005398920216
2021,3390,25,2,1980,138,0.9259259259259259,1842,0.9348441926345609
2021,3391,7,13,494,733,0.35,-239,0.4026079869600652
2021,3392,15,5,951,255,0.75,696,0.7885572139303483
2021,3393,13,8,1015,502,0.6190476190476191,513,0.6690837178642056
2021,3394,4,12,233,640,0.25,-407,0.26689576174112256
2021,3395,10,15,751,948,0.4,-197,0.4420247204237787
2021,3396,11,11,749,615,0.5,134,0.5491202346041055
2021,3397,16,7,1222,433,0.6956521739130435,789,0.7383685800604229
2021,3399,15,10,1065,615,0.6,450,0.6339285714285714
2021,3400,18,9,1365,521,0.6666666666666666,844,0.7237539766702015
2021,3401,23,2,1750,129,0.92,1621,0.9313464608834486
2021,3402,11,11,772,609,0.5,163,0.559015206372194
2021,3403,9,15,745,950,0.375,-205,0.43952802359882004
2021,3404,20,5,1415,343,0.8,1072,0.8048919226393629
2021,3405,12,12,850,812,0.5,38,0.5114320096269555
2021,3406,12,9,1045,590,0.5714285714285714,455,0.6391437308868502
2021,3407,20,5,1729,378,0.8,1351,0.8205980066445183
2021,3408,17,8,1249,471,0.68,778,0.7261627906976744
2021,3409,5,14,339,729,0.2631578947368421,-390,0.31741573033707865
2021,3410,6,14,403,847,0.3,-444,0.3224
2021,3411,5,10,377,538,0.3333333333333333,-161,0.41202185792349727
2021,3412,8,13,601,834,0.38095238095238093,-233,0.418815331010453
2021,3413,13,2,864,117,0.8666666666666667,747,0.8807339449541285
2021,3414,14,9,990,508,0.6086956521739131,482,0.6608811748998665
2021,3415,6,12,364,677,0.3333333333333333,-313,0.34966378482228627
2021,3416,16,4,930,231,0.8,699,0.8010335917312662
2021,3417,16,5,1215,296,0.7619047619047619,919,0.8041032428855063
2021,3418,16,6,1027,375,0.7272727272727273,652,0.7325249643366619
2021,3419,2,20,130,969,0.09090909090909091,-839,0.11828935395814377
2021,3420,2,6,118,342,0.25,-224,0.2565217391304348
2021,3421,10,15,681,831,0.4,-150,0.4503968253968254
2021,3422,7,14,392,651,0.3333333333333333,-259,0.37583892617449666
2021,3423,7,14,460,787,0.3333333333333333,-327,0.3688853247794707
2021,3424,15,9,1101,582,0.625,519,0.6541889483065954
2021,3425,11,12,776,687,0.4782608695652174,89,0.530416951469583
2021,3426,11,7,721,348,0.6111111111111112,373,0.6744621141253508
2021,3427,1,18,73,1074,0.05263157894736842,-1001,0.06364428945074106
2021,3428,5,16,369,895,0.23809523809523808,-526,0.29193037974683544
2021,3429,4,20,280,1232,0.16666666666666666,-952,0.18518518518518517
2021,3430,12,6,741,363,0.6666666666666666,378,0.6711956521739131
2021,3431,17,8,1260,483,0.68,777,0.7228915662650602
2021,3433,15,10,1001,611,0.6,390,0.6209677419354839
2021,3434,12,13,824,784,0.48,40,0.5124378109452736
2021,3435,4,4,348,246,0.5,102,0.5858585858585859
2021,3436,4,2,264,110,0.6666666666666666,154,0.7058823529411765
2021,3437,15,6,1115,362,0.7142857142857143,753,0.7549085985104943
2021,3439,14,9,1092,591,0.6086956521739131,501,0.6488413547237076
2021,3441,4,18,229,961,0.18181818181818182,-732,0.19243697478991598
2021,3442,8,16,645,1012,0.3333333333333333,-367,0.3892576946288473
2021,3443,7,16,514,955,0.30434782608695654,-441,0.3498978897208986
2021,3444,6,15,447,924,0.2857142857142857,-477,0.32603938730853393
2021,3447,13,5,848,240,0.7222222222222222,608,0.7794117647058824
2021,3448,12,12,838,762,0.5,76,0.52375
2021,3449,7,14,497,737,0.3333333333333333,-240,0.4027552674230146
2021,3450,12,11,824,640,0.5217391304347826,184,0.5628415300546448
2021,3451,2,19,154,1161,0.09523809523809523,-1007,0.11711026615969582
2021,3452,21,6,1583,380,0.7777777777777778,1203,0.8064187468160978
2021,3453,15,7,1029,398,0.6818181818181818,631,0.7210932025227751
2021,3454,19,7,1259,408,0.7307692307692307,851,0.755248950209958
2021,3455,6,12,427,715,0.3333333333333333,-288,0.37390542907180385
2021,3456,6,7,352,413,0.46153846153846156,-61,0.46013071895424834
2021,3457,6,18,362,870,0.25,-508,0.29383116883116883
2021,3458,5,19,386,1128,0.20833333333333334,-742,0.25495376486129456
2021,3459,12,11,827,585,0.5217391304347826,242,0.5856940509915014
2021,3460,18,7,1175,415,0.72,760,0.7389937106918238
2021,3461,14,9,894,527,0.6086956521739131,367,0.6291344123856439
2021,3462,5,10,345,597,0.3333333333333333,-252,0.3662420382165605
2021,3464,10,8,741,458,0.5555555555555556,283,0.6180150125104253
2021,3465,22,0,1684,0,1.0,1684,1.0
2021,3466,7,18,505,1228,0.28,-723,0.291402192729371
2021,3467,5,10,367,603,0.3333333333333333,-236,0.3783505154639175
2021,3468,5,17,361,1020,0.22727272727272727,-659,0.2614047791455467
2021,3470,5,16,329,901,0.23809523809523808,-572,0.26747967479674795
2021,3471,6,9,418,498,0.4,-80,0.45633187772925765
2022,1101,19,10,1478,644,0.6551724137931034,834,0.6965127238454288
2022,1102,11,18,705,1007,0.3793103448275862,-302,0.4117990654205608
2022,1103,22,9,1616,532,0.7096774193548387,1084,0.7523277467411545
2022,1104,19,13,1579,980,0.59375,599,0.6170379054318093
2022,1105,12,18,864,979,0.4,-115,0.46880086814975586
2022,1106,9,21,698,1371,0.3,-673,0.3373610439826003
2022,1107,13,18,856,1061,0.41935483870967744,-205,0.44653103808033384
2022,1108,17,16,1215,985,0.5151515151515151,230,0.5522727272727272
2022,1110,10,22,713,1318,0.3125,-605,0.35105859182668636
2022,1111,16,14,1108,842,0.5333333333333333,266,0.5682051282051283
2022,1112,31,3,2680,195,0.9117647058823529,2485,0.9321739130434783
2022,1113,14,17,986,1041,0.45161290322580644,-55,0.48643315244203256
2022,1114,6,19,453,1149,0.24,-696,0.28277153558052437
2022,1115,5,24,381,1502,0.1724137931034483,-1121,0.20233669676048857
2022,1116,25,8,1964,575,0.7575757575757576,1389,0.7735328869633714
2022,1117,15,11,1114,682,0.5769230769230769,432,0.6202672605790646
2022,1119,13,16,963,1040,0.4482758620689655,-77,0.48077883175237146
2022,1120,27,5,2148,371,0.84375,1777,0.8527193330686781
2022,1122,10,17,676,1015,0.37037037037037035,-339,0.39976345357776466
2022,1123,13,17,1054,1165,0.43333333333333335,-111,0.4749887336638125
2022,1124,26,6,2055,393,0.8125,1662,0.8394607843137255
2022,1125,24,7,1975,422,0.7741935483870968,1553,0.8239465999165624
2022,1126,8,21,559,1254,0.27586206896551724,-695,0.3083287369001655
2022,1127,10,17,739,1034,0.37037037037037035,-295,0.4168076706147772
2022,1129,26,7,1809,439,0.7878787878787878,1370,0.8047153024911032
2022,1130,13,20,935,1274,0.3939393939393939,-339,0.42326844726120416
2022,1131,20,12,1461,807,0.625,654,0.6441798941798942
2022,1132,11,18,921,1337,0.3793103448275862,-416,0.4078830823737821
2022,1133,16,14,1192,901,0.5333333333333333,291,0.5695174390826565
2022,1135,11,16,841,1030,0.4074074074074074,-189,0.4494922501336184
2022,1136,21,9,1674,619,0.7,1055,0.7300479720889664
2022,1137,9,23,709,1568,0.28125,-859,0.3113746157224418
2022,1138,17,11,1427,777,0.6071428571428571,650,0.6474591651542649
2022,1139,12,19,853,1102,0.3870967741935484,-249,0.4363171355498721
2022,1140,20,10,1517,679,0.6666666666666666,838,0.6908014571948998
2022,1141,7,23,518,1460,0.23333333333333334,-942,0.26188068756319516
2022,1142,6,21,414,1221,0.2222222222222222,-807,0.25321100917431194
2022,1143,12,20,834,1184,0.375,-350,0.4132804757185332
2022,1144,13,13,902,775,0.5,127,0.5378652355396542
2022,1145,10,21,744,1342,0.3225806451612903,-598,0.3566634707574305
2022,1146,9,20,720,1340,0.3103448275862069,-620,0.34951456310679613
2022,1148,8,24,562,1415,0.25,-853,0.28426909458775923
2022,1149,3,25,208,1580,0.10714285714285714,-1372,0.116331096196868
2022,1150,17,14,1261,910,0.5483870967741935,351,0.5808383233532934
2022,1151,25,7,1853,486,0.78125,1367,0.7922188969645148
2022,1152,7,25,450,1537,0.21875,-1087,0.2264720684448918
2022,1153,17,15,1258,962,0.53125,296,0.5666666666666667
2022,1154,10,18,811,1258,0.35714285714285715,-447,0.3919768003866602
2022,1155,17,16,1286,1081,0.5151515151515151,205,0.5433037600337981
2022,1156,18,10,1395,709,0.6428571428571429,686,0.6630228136882129
2022,1157,12,13,879,843,0.48,36,0.5104529616724739
2022,1158,17,15,1389,1113,0.53125,276,0.5551558752997602
2022,1159,22,11,1716,773,0.6666666666666666,943,0.6894335074327039
2022,1160,21,11,1632,645,0.65625,987,0.7167325428194994
2022,1161,24,5,1814,310,0.8275862068965517,1504,0.8540489642184558
2022,1162,3,22,235,1430,0.12,-1195,0.14114114114114115
2022,1163,23,9,1834,572,0.71875,1262,0.7622610141313383
2022,1164,9,23,670,1472,0.28125,-802,0.3127917833800187
2022,1165,13,11,1072,758,0.5416666666666666,314,0.585792349726776
2022,1166,22,11,1635,643,0.6666666666666666,992,0.7177348551360843
2022,1167,6,19,358,1187,0.24,-829,0.23171521035598705
2022,1168,19,10,1338,660,0.6551724137931034,678,0.6696696696696697
2022,1169,6,22,426,1270,0.21428571428571427,-844,0.2511792452830189
2022,1170,9,18,652,1090,0.3333333333333333,-438,0.3742824339839265
2022,1171,8,16,576,1019,0.3333333333333333,-443,0.361128526645768
2022,1172,26,6,1993,395,0.8125,1598,0.8345896147403685
2022,1173,23,10,1660,621,0.696969696969697,1039,0.7277509864094696
2022,1174,21,12,1568,846,0.6363636363636364,722,0.6495443247721624
2022,1176,10,20,781,1337,0.3333333333333333,-556,0.3687440982058546
2022,1177,15,16,1257,1015,0.4838709677419355,242,0.5532570422535211
2022,1178,13,15,987,960,0.4642857142857143,27,0.5069337442218799
2022,1179,22,10,1680,649,0.6875,1031,0.721339630742808
2022,1180,14,14,1051,958,0.5,93,0.523145843703335
2022,1181,28,6,2292,434,0.8235294117647058,1858,0.8407923697725606
2022,1182,6,24,457,1499,0.2,-1042,0.233640081799591
2022,1183,3,26,202,1372,0.10344827586206896,-1170,0.12833545108005082
2022,1184,9,18,704,1330,0.3333333333333333,-626,0.34611602753195675
2022,1185,9,21,745,1319,0.3,-574,0.36094961240310075
2022,1186,16,15,1265,1068,0.5161290322580645,197,0.5422203171881698
2022,1187,15,15,1092,971,0.5,121,0.5293262239457102
2022,1188,9,21,625,1377,0.3,-752,0.31218781218781216
2022,1189,8,22,589,1362,0.26666666666666666,-773,0.3018964633521271
2022,1190,13,17,976,1148,0.43333333333333335,-172,0.4595103578154426
2022,1191,5,24,310,1396,0.1724137931034483,-1086,0.1817116060961313
2022,1192,4,22,315,1433,0.15384615384615385,-1118,0.18020594965675057
2022,1193,14,18,1026,1103,0.4375,-77,0.48191639267261627
2022,1194,16,14,1303,905,0.5333333333333333,398,0.5901268115942029
2022,1195,19,11,1536,749,0.6333333333333333,787,0.6722100656455142
2022,1196,19,13,1421,844,0.59375,577,0.627373068432671
2022,1197,11,17,802,981,0.39285714285714285,-179,0.44980370162647226
2022,1198,13,17,961,1097,0.43333333333333335,-136,0.46695821185617103
2022,1199,17,14,1333,868,0.5483870967741935,465,0.6056338028169014
2022,1200,16,16,1124,991,0.5,133,0.5314420803782506
2022,1201,18,13,1250,745,0.5806451612903226,505,0.6265664160401002
2022,1202,21,12,1701,821,0.6363636363636364,880,0.6744647105471848
2022,1203,12,18,904,1147,0.4,-243,0.44076060458313016
2022,1204,10,16,689,965,0.38461538461538464,-276,0.4165659008464329
2022,1205,15,13,1062,823,0.5357142857142857,239,0.563395225464191
2022,1206,14,16,1045,1077,0.4666666666666667,-32,0.4924599434495759
2022,1207,6,25,517,1675,0.1935483870967742,-1158,0.23585766423357665
2022,1208,6,26,452,1782,0.1875,-1330,0.20232766338406447
2022,1209,15,10,1063,645,0.6,418,0.6223653395784543
2022,1210,11,20,833,1259,0.3548387096774194,-426,0.39818355640535374
2022,1211,26,3,2327,220,0.896551724137931,2107,0.9136238712210444
2022,1212,10,20,701,1249,0.3333333333333333,-548,0.3594871794871795
2022,1213,21,8,1559,482,0.7241379310344828,1077,0.7638412542871141
2022,1214,7,19,493,1149,0.2692307692307692,-656,0.3002436053593179
2022,1216,12,20,865,1369,0.375,-504,0.38719785138764545
2022,1217,10,13,720,880,0.43478260869565216,-160,0.45
2022,1218,15,11,1067,676,0.5769230769230769,391,0.6121629374641423
2022,1219,11,18,837,1126,0.3793103448275862,-289,0.4263881813550688
2022,1220,19,11,1560,745,0.6333333333333333,815,0.6767895878524945
2022,1221,7,22,491,1338,0.2413793103448276,-847,0.2684527063969382
2022,1222,29,5,2230,348,0.8529411764705882,1882,0.8650116369278511
2022,1223,7,18,619,1171,0.28,-552,0.3458100558659218
2022,1224,13,13,1013,901,0.5,112,0.5292580982236155
2022,1225,7,22,581,1503,0.2413793103448276,-922,0.2787907869481766
2022,1226,5,23,377,1369,0.17857142857142858,-992,0.215922107674685
2022,1227,13,16,975,1093,0.4482758620689655,-118,0.47147001934235977
2022,1228,22,9,1727,622,0.7096774193548387,1105,0.7352064708386548
2022,1229,11,20,889,1396,0.3548387096774194,-507,0.3890590809628009
2022,1230,5,24,371,1513,0.1724137931034483,-1142,0.19692144373673037
2022,1231,20,13,1482,877,0.6060606060606061,605,0.6282323018228063
2022,1232,8,20,586,1323,0.2857142857142857,-737,0.3069669984284966
2022,1233,25,7,1916,492,0.78125,1424,0.7956810631229236
2022,1234,26,9,2292,640,0.7428571428571429,1652,0.781718963165075
2022,1235,20,12,1445,682,0.625,763,0.6793606017865539
2022,1236,19,11,1448,706,0.6333333333333333,742,0.6722376973073352
2022,1237,1,26,66,1319,0.037037037037037035,-1253,0.047653429602888084
2022,1238,11,19,754,1075,0.36666666666666664,-321,0.41224712957900495
2022,1239,17,10,1134,600,0.6296296296296297,534,0.6539792387543253
2022,1240,19,10,1446,613,0.6551724137931034,833,0.7022826614861584
2022,1241,13,14,977,970,0.48148148148148145,7,0.5017976373908577
2022,1242,28,6,2260,412,0.8235294117647058,1848,0.8458083832335329
2022,1243,14,17,1016,1123,0.45161290322580644,-107,0.4749883122954652
2022,1244,9,18,696,1237,0.3333333333333333,-541,0.3600620796689084
2022,1245,21,10,1549,604,0.6774193548387096,945,0.7194612169066419
2022,1246,26,7,2160,462,0.7878787878787878,1698,0.8237986270022883
2022,1247,11,19,786,1239,0.36666666666666664,-453,0.38814814814814813
2022,1248,9,20,642,1305,0.3103448275862069,-663,0.32973805855161786
2022,1250,12,19,950,1170,0.3870967741935484,-220,0.4481132075471698
2022,1251,19,11,1453,697,0.6333333333333333,756,0.6758139534883721
2022,1252,11,19,858,1295,0.36666666666666664,-437,0.3985137018114259
2022,1253,18,12,1365,808,0.6,557,0.6281638288080994
2022,1254,15,14,1230,909,0.5172413793103449,321,0.5750350631136045
2022,1255,22,6,1674,390,0.7857142857142857,1284,0.811046511627907
2022,1256,21,10,1615,669,0.6774193548387096,946,0.707092819614711
2022,1257,13,19,952,1202,0.40625,-250,0.44196843082636955
2022,1258,10,18,780,1156,0.35714285714285715,-376,0.40289256198347106
2022,1259,13,16,923,992,0.4482758620689655,-69,0.48198433420365533
2022,1260,24,7,1790,484,0.7741935483870968,1306,0.7871591908531222
2022,1261,22,11,1693,720,0.6666666666666666,973,0.7016162453377538
2022,1262,12,16,856,1034,0.42857142857142855,-178,0.45291005291005293
2022,1263,3,23,209,1370,0.11538461538461539,-1161,0.13236225459151363
2022,1264,14,15,1070,957,0.4827586206896552,113,0.5278737049827331
2022,1265,14,16,1033,1030,0.4666666666666667,3,0.5007270964614638
2022,1266,19,12,1471,835,0.6129032258064516,636,0.6379011274934953
2022,1267,10,21,808,1454,0.3225806451612903,-646,0.3572060123784262
2022,1268,15,17,1163,1107,0.46875,56,0.5123348017621145
2022,1269,15,17,1250,1172,0.46875,78,0.5161023947151114
2022,1270,7,22,576,1554,0.2413793103448276,-978,0.2704225352112676
2022,1271,8,15,569,895,0.34782608695652173,-326,0.38866120218579236
2022,1272,21,10,1674,664,0.6774193548387096,1010,0.7159965782720273
2022,1273,14,17,1052,1107,0.45161290322580644,-55,0.4872626215840667
2022,1274,23,10,1793,676,0.696969696969697,1117,0.7262049412717699
2022,1275,11,18,887,1252,0.3793103448275862,-365,0.41467975689574565
2022,1276,17,14,1342,922,0.5483870967741935,420,0.592756183745583
2022,1277,22,12,1676,775,0.6470588235294118,901,0.6838025295797634
2022,1278,13,17,946,1064,0.43333333333333335,-118,0.47064676616915424
2022,1279,13,19,982,1198,0.40625,-216,0.4504587155963303
2022,1280,18,15,1369,970,0.5454545454545454,399,0.5852928601966653
2022,1281,11,21,832,1237,0.34375,-405,0.40212663122281295
2022,1282,15,12,1149,760,0.5555555555555556,389,0.6018858040859089
2022,1283,22,10,1712,741,0.6875,971,0.6979209131675499
2022,1284,21,13,1486,847,0.6176470588235294,639,0.6369481354479212
2022,1285,15,14,1095,919,0.5172413793103449,176,0.5436941410129096
2022,1286,25,7,1860,552,0.78125,1308,0.7711442786069652
2022,1287,20,11,1430,696,0.6451612903225806,734,0.6726246472248354
2022,1288,9,14,692,922,0.391304347826087,-230,0.42874845105328374
2022,1290,2,26,169,1713,0.07142857142857142,-1544,0.089798087141339
2022,1291,13,16,913,954,0.4482758620689655,-41,0.48901981788966253
2022,1292,21,10,1567,695,0.6774193548387096,872,0.6927497789566756
2022,1293,27,2,2097,116,0.9310344827586207,1981,0.947582467239042
2022,1294,18,14,1464,1011,0.5625,453,0.5915151515151515
2022,1295,21,10,1598,669,0.6774193548387096,929,0.7048963387737097
2022,1296,9,21,601,1322,0.3,-721,0.312532501300052
2022,1297,18,12,1306,758,0.6,548,0.6327519379844961
2022,1298,20,11,1333,657,0.6451612903225806,676,0.6698492462311558
2022,1299,9,20,630,1275,0.3103448275862069,-645,0.33070866141732286
2022,1300,12,15,882,951,0.4444444444444444,-69,0.48117839607201307
2022,1301,11,21,868,1468,0.34375,-600,0.3715753424657534
2022,1303,4,25,323,1698,0.13793103448275862,-1375,0.15982187036120732
2022,1304,10,22,807,1538,0.3125,-731,0.344136460554371
2022,1305,12,18,973,1178,0.4,-205,0.4523477452347745
2022,1306,13,13,912,823,0.5,89,0.5256484149855908
2022,1307,11,19,919,1291,0.36666666666666664,-372,0.4158371040723982
2022,1308,23,6,1679,396,0.7931034482758621,1283,0.809156626506024
2022,1309,15,13,1218,912,0.5357142857142857,306,0.571830985915493
2022,1310,13,16,932,978,0.4482758620689655,-46,0.48795811518324606
2022,1311,17,11,1369,768,0.6071428571428571,601,0.6406176883481516
2022,1312,10,18,697,1053,0.35714285714285715,-356,0.3982857142857143
2022,1313,21,6,1610,358,0.7777777777777778,1252,0.818089430894309
2022,1314,24,9,1934,624,0.7272727272727273,1310,0.7560594214229867
2022,1315,4,25,323,1673,0.13793103448275862,-1350,0.16182364729458917
2022,1316,8,20,633,1193,0.2857142857142857,-560,0.3466593647316539
2022,1317,22,6,1435,355,0.7857142857142857,1080,0.8016759776536313
2022,1318,9,22,589,1404,0.2903225806451613,-815,0.29553437029603613
2022,1319,7,23,514,1449,0.23333333333333334,-935,0.2618441161487519
2022,1320,18,11,1423,714,0.6206896551724138,709,0.6658867571361722
2022,1321,14,16,1067,1105,0.4666666666666667,-38,0.4912523020257827
2022,1322,6,23,524,1555,0.20689655172413793,-1031,0.25204425204425207
2022,1323,21,10,1579,651,0.6774193548387096,928,0.7080717488789238
2022,1324,18,12,1343,826,0.6,517,0.6191793453204242
2022,1325,23,9,1781,571,0.71875,1210,0.7572278911564626
2022,1326,19,11,1491,723,0.6333333333333333,768,0.6734417344173442
2022,1328,18,15,1345,915,0.5454545454545454,430,0.5951327433628318
2022,1329,15,15,1100,951,0.5,149,0.5363237445148707
2022,1330,12,19,889,1158,0.3870967741935484,-269,0.4342940889106009
2022,1331,16,12,1382,899,0.5714285714285714,483,0.6058746163963175
2022,1332,18,14,1403,913,0.5625,490,0.6057858376511226
2022,1333,3,28,244,1873,0.0967741935483871,-1629,0.11525743977326405
2022,1334,6,22,454,1372,0.21428571428571427,-918,0.24863088718510407
2022,1335,12,16,942,1075,0.42857142857142855,-133,0.4670302429350521
2022,1336,14,17,986,1017,0.45161290322580644,-31,0.4922616075886171
2022,1337,6,25,451,1636,0.1935483870967742,-1185,0.21609966459032104
2022,1338,11,21,717,1252,0.34375,-535,0.36414423565261556
2022,1339,16,14,1203,955,0.5333333333333333,248,0.5574606116774792
2022,1340,12,17,929,1147,0.41379310344827586,-218,0.447495183044316
2022,1341,8,19,607,1270,0.2962962962962963,-663,0.32338838572189665
2022,1342,9,20,621,1270,0.3103448275862069,-649,0.328397673188789
2022,1343,21,6,1680,442,0.7777777777777778,1238,0.7917059377945335
2022,1344,25,5,1842,312,0.8333333333333334,1530,0.8551532033426184
2022,1345,27,7,2255,458,0.7941176470588235,1797,0.8311831920383339
2022,1346,13,17,1003,1120,0.43333333333333335,-117,0.47244465379180406
2022,1347,9,18,614,1055,0.3333333333333333,-441,0.3678849610545237
2022,1348,14,16,1027,984,0.4666666666666667,43,0.5106911984087519
2022,1349,14,16,1159,1025,0.4666666666666667,134,0.5306776556776557
2022,1350,23,12,1685,825,0.6571428571428571,860,0.6713147410358565
2022,1351,13,19,950,1205,0.40625,-255,0.4408352668213457
2022,1352,7,24,504,1617,0.22580645161290322,-1113,0.2376237623762376
2022,1353,18,13,1266,839,0.5806451612903226,427,0.6014251781472684
2022,1354,12,16,851,1102,0.42857142857142855,-251,0.43573988735279057
2022,1355,28,4,2426,311,0.875,2115,0.88637194008038
2022,1356,15,15,1055,855,0.5,200,0.5523560209424084
2022,1357,9,20,682,1389,0.3103448275862069,-707,0.32930951231289235
2022,1358,16,14,1120,846,0.5333333333333333,274,0.5696846388606307
2022,1359,18,11,1360,762,0.6206896551724138,598,0.6409048067860509
2022,1360,13,16,884,970,0.4482758620689655,-86,0.47680690399137
2022,1361,23,8,1603,421,0.7419354838709677,1182,0.7919960474308301
2022,1362,23,9,1833,599,0.71875,1234,0.7537006578947368
2022,1363,7,23,529,1346,0.23333333333333334,-817,0.28213333333333335
2022,1364,15,11,1153,707,0.5769230769230769,446,0.6198924731182796
2022,1365,21,11,1757,743,0.65625,1014,0.7028
2022,1367,12,16,901,1053,0.42857142857142855,-152,0.4611054247697032
2022,1368,15,14,1252,956,0.5172413793103449,296,0.5670289855072463
2022,1369,12,18,994,1277,0.4,-283,0.4376926464112726
2022,1370,21,9,1638,568,0.7,1070,0.742520398912058
2022,1371,20,10,1465,682,0.6666666666666666,783,0.6823474615742897
2022,1372,18,9,1395,574,0.6666666666666666,821,0.7084814626714068
2022,1373,15,14,1081,841,0.5172413793103449,240,0.5624349635796045
2022,1374,23,8,1799,506,0.7419354838709677,1293,0.7804772234273318
2022,1375,15,11,1106,690,0.5769230769230769,416,0.6158129175946548
2022,1376,17,13,1292,798,0.5666666666666667,494,0.6181818181818182
2022,1377,17,12,1363,774,0.5862068965517241,589,0.6378100140383716
2022,1378,8,23,508,1273,0.25806451612903225,-765,0.2852330151600225
2022,1379,5,26,359,1586,0.16129032258064516,-1227,0.1845758354755784
2022,1380,15,14,1114,920,0.5172413793103449,194,0.5476892822025565
2022,1381,18,11,1453,761,0.6206896551724138,692,0.6562782294489612
2022,1382,20,9,1481,553,0.6896551724137931,928,0.7281219272369714
2022,1383,9,20,659,1245,0.3103448275862069,-586,0.34611344537815125
2022,1384,8,21,625,1333,0.27586206896551724,-708,0.3192032686414709
2022,1385,17,15,1479,1068,0.53125,411,0.5806831566548881
2022,1386,11,19,820,1208,0.36666666666666664,-388,0.40433925049309666
2022,1387,22,11,1715,756,0.6666666666666666,959,0.6940509915014165
2022,1388,24,7,1748,408,0.7741935483870968,1340,0.8107606679035251
2022,1389,18,11,1226,693,0.6206896551724138,533,0.6388744137571651
2022,1390,16,16,1168,956,0.5,212,0.5499058380414312
2022,1391,7,19,515,1223,0.2692307692307692,-708,0.2963176064441887
2022,1392,17,13,1350,824,0.5666666666666667,526,0.6209751609935602
2022,1393,16,17,1374,1179,0.48484848484848486,195,0.5381903642773208
2022,1394,19,11,1414,799,0.6333333333333333,615,0.6389516493447809
2022,1395,20,12,1438,741,0.625,697,0.6599357503441946
2022,1396,17,12,1234,702,0.5862068965517241,532,0.637396694214876
2022,1397,26,7,1997,418,0.7878787878787878,1579,0.8269151138716356
2022,1398,12,18,918,1145,0.4,-227,0.4449830344158992
2022,1399,9,21,752,1350,0.3,-598,0.3577545195052331
2022,1400,21,11,1501,686,0.65625,815,0.6863283036122543
2022,1401,22,12,1677,769,0.6470588235294118,908,0.6856091578086672
2022,1402,18,7,1293,419,0.72,874,0.7552570093457944
2022,1403,25,9,1889,549,0.7352941176470589,1340,0.7748154224774405
2022,1404,6,22,475,1395,0.21428571428571427,-920,0.2540106951871658
2022,1405,25,7,2093,463,0.78125,1630,0.8188575899843505
2022,1406,25,8,1902,512,0.7575757575757576,1390,0.7879038939519469
2022,1407,17,11,1209,666,0.6071428571428571,543,0.6448
2022,1408,14,15,1103,1018,0.4827586206896552,85,0.5200377180575201
2022,1409,11,20,822,1267,0.3548387096774194,-445,0.39348970799425564
2022,1410,6,23,467,1586,0.20689655172413793,-1119,0.22747199220652703
2022,1411,18,12,1340,737,0.6,603,0.6451612903225806
2022,1412,25,7,2069,473,0.78125,1596,0.8139260424862313
2022,1413,12,10,854,633,0.5454545454545454,221,0.574310692669805
2022,1414,13,10,876,594,0.5652173913043478,282,0.5959183673469388
2022,1415,14,12,948,750,0.5384615384615384,198,0.558303886925795
2022,1416,18,12,1344,751,0.6,593,0.641527446300716
2022,1417,25,7,1947,497,0.78125,1450,0.796644844517185
2022,1418,14,15,1043,995,0.4827586206896552,48,0.5117762512266928
2022,1419,10,18,767,1172,0.35714285714285715,-405,0.39556472408457966
2022,1420,17,14,1427,847,0.5483870967741935,580,0.627528583992964
2022,1421,13,14,983,942,0.48148148148148145,41,0.5106493506493507
2022,1422,16,14,1061,874,0.5333333333333333,187,0.5483204134366925
2022,1423,21,9,1546,543,0.7,1003,0.7400670177118238
2022,1424,17,14,1247,888,0.5483870967741935,359,0.5840749414519907
2022,1425,26,7,1935,460,0.7878787878787878,1475,0.8079331941544885
2022,1426,9,18,665,1084,0.3333333333333333,-419,0.38021726700971986
2022,1427,7,21,548,1270,0.25,-722,0.30143014301430143
2022,1428,11,20,806,1355,0.3548387096774194,-549,0.37297547431744565
2022,1429,17,15,1391,941,0.53125,450,0.5964837049742711
2022,1430,18,12,1322,768,0.6,554,0.6325358851674641
2022,1431,17,13,1244,786,0.5666666666666667,458,0.6128078817733991
2022,1433,21,9,1465,517,0.7,948,0.7391523713420787
2022,1434,12,18,917,1140,0.4,-223,0.4457948468643656
2022,1435,17,16,1285,1038,0.5151515151515151,247,0.5531640120533793
2022,1436,27,5,2091,301,0.84375,1790,0.8741638795986622
2022,1437,26,7,1955,442,0.7878787878787878,1513,0.8156028368794326
2022,1438,19,13,1263,739,0.59375,524,0.6308691308691309
2022,1439,23,12,1737,739,0.6571428571428571,998,0.7015347334410339
2022,1440,13,15,1061,1094,0.4642857142857143,-33,0.4923433874709977
2022,1441,10,21,777,1382,0.3225806451612903,-605,0.35988883742473365
2022,1442,14,15,1141,1110,0.4827586206896552,31,0.5068858285206574
2022,1443,17,13,1353,866,0.5666666666666667,487,0.6097341144659757
2022,1444,6,22,461,1360,0.21428571428571427,-899,0.2531576057111477
2022,1447,20,6,1525,381,0.7692307692307693,1144,0.8001049317943337
2022,1448,23,9,1901,642,0.71875,1259,0.7475422729060165
2022,1449,17,15,1284,976,0.53125,308,0.5681415929203539
2022,1450,19,14,1494,879,0.5757575757575758,615,0.629582806573957
2022,1451,19,12,1512,819,0.6129032258064516,693,0.6486486486486487
2022,1452,16,17,1137,1122,0.48484848484848486,15,0.5033200531208499
2022,1453,4,25,276,1499,0.13793103448275862,-1223,0.15549295774647887
2022,1454,9,22,633,1366,0.2903225806451613,-733,0.3166583291645823
2022,1455,15,13,1068,849,0.5357142857142857,219,0.5571205007824727
2022,1456,4,27,282,1675,0.12903225806451613,-1393,0.14409810935104753
2022,1457,20,9,1532,604,0.6896551724137931,928,0.7172284644194756
2022,1458,24,7,1737,455,0.7741935483870968,1282,0.7924270072992701
2022,1459,17,13,1291,816,0.5666666666666667,475,0.6127195064072141
2022,1460,20,13,1582,898,0.6060606060606061,684,0.6379032258064516
2022,1461,24,8,1805,495,0.75,1310,0.7847826086956522
2022,1462,18,13,1402,890,0.5806451612903226,512,0.6116928446771379
2022,1463,18,11,1350,732,0.6206896551724138,618,0.6484149855907781
2022,1464,16,14,1235,915,0.5333333333333333,320,0.5744186046511628
2022,1465,15,15,1168,908,0.5,260,0.5626204238921002
2022,1466,5,21,356,1312,0.19230769230769232,-956,0.21342925659472423
2022,1467,13,16,893,873,0.4482758620689655,20,0.5056625141562854
2022,1468,16,13,1185,786,0.5517241379310345,399,0.6012176560121766
2022,1469,9,18,698,1140,0.3333333333333333,-442,0.3797606093579978
2022,1470,11,17,776,992,0.39285714285714285,-216,0.43891402714932126
2022,1471,11,16,870,976,0.4074074074074074,-106,0.4712892741061755
2022,1472,7,20,601,1361,0.25925925925925924,-760,0.30632008154943935
2022,3101,13,13,999,845,0.5,154,0.5417570498915402
2022,3102,16,13,1059,735,0.5517241379310345,324,0.5903010033444817
2022,3103,16,11,1159,632,0.5925925925925926,527,0.6471245114461195
2022,3104,17,13,1317,799,0.5666666666666667,518,0.6224007561436673
2022,3105,15,14,976,754,0.5172413793103449,222,0.5641618497109827
2022,3106,14,15,1020,813,0.4827586206896552,207,0.5564648117839607
2022,3107,22,9,1291,455,0.7096774193548387,836,0.7394043528064147
2022,3108,2,22,122,1099,0.08333333333333333,-977,0.09991809991809991
2022,3110,23,8,1433,428,0.7419354838709677,1005,0.7700161203653949
2022,3111,12,12,852,777,0.5,75,0.5230202578268877
2022,3112,20,7,1397,435,0.7407407407407407,962,0.7625545851528385
2022,3113,12,14,848,797,0.46153846153846156,51,0.5155015197568389
2022,3114,15,10,952,548,0.6,404,0.6346666666666667
2022,3115,12,16,904,988,0.42857142857142855,-84,0.47780126849894294
2022,3116,18,13,1470,816,0.5806451612903226,654,0.6430446194225722
2022,3117,9,16,765,1132,0.36,-367,0.4032683183974697
2022,3119,15,13,1015,748,0.5357142857142857,267,0.5757231990924561
2022,3120,10,18,728,1056,0.35714285714285715,-328,0.4080717488789238
2022,3122,17,11,1203,627,0.6071428571428571,576,0.6573770491803279
2022,3123,20,12,1523,763,0.625,760,0.6662292213473315
2022,3124,27,6,2126,415,0.8181818181818182,1711,0.8366784730421094
2022,3125,22,7,1611,404,0.7586206896551724,1207,0.7995037220843673
2022,3126,4,21,295,1181,0.16,-886,0.19986449864498645
2022,3127,7,20,451,1051,0.25925925925925924,-600,0.3002663115845539
2022,3129,6,21,430,1197,0.2222222222222222,-767,0.26429010448678547
2022,3130,19,11,1493,671,0.6333333333333333,822,0.6899260628465804
2022,3131,17,14,1174,763,0.5483870967741935,411,0.6060918946824987
2022,3132,14,15,1076,1005,0.4827586206896552,71,0.5170591061989428
2022,3133,3,23,225,1269,0.11538461538461539,-1044,0.15060240963855423
2022,3135,5,20,337,1046,0.2,-709,0.24367317425885757
2022,3136,9,22,548,1142,0.2903225806451613,-594,0.3242603550295858
2022,3137,23,9,1514,484,0.71875,1030,0.7577577577577578
2022,3138,25,8,1966,544,0.7575757575757576,1422,0.7832669322709164
2022,3139,1,27,75,1481,0.03571428571428571,-1406,0.04820051413881748
2022,3140,26,3,2043,214,0.896551724137931,1829,0.9051838723969872
2022,3141,4,25,263,1453,0.13793103448275862,-1190,0.15326340326340326
2022,3142,3,22,180,1251,0.12,-1071,0.12578616352201258
2022,3143,10,13,786,759,0.43478260869565216,27,0.5087378640776699
2022,3144,20,7,1257,380,0.7407407407407407,877,0.7678680513133781
2022,3145,6,25,413,1380,0.1935483870967742,-967,0.23034021193530396
2022,3146,6,19,363,931,0.24,-568,0.28052550231839257
2022,3148,6,20,418,1098,0.23076923076923078,-680,0.2757255936675462
2022,3149,2,26,122,1265,0.07142857142857142,-1143,0.08795962509012256
2022,3150,22,9,1500,472,0.7096774193548387,1028,0.7606490872210954
2022,3151,7,23,465,1343,0.23333333333333334,-878,0.2571902654867257
2022,3152,4,23,260,1266,0.14814814814814814,-1006,0.17038007863695936
2022,3153,11,17,751,923,0.39285714285714285,-172,0.4486260454002389
2022,3155,10,21,730,1267,0.3225806451612903,-537,0.3655483224837256
2022,3156,17,8,1227,471,0.68,756,0.7226148409893993
2022,3157,12,11,867,707,0.5217391304347826,160,0.5508259212198221
2022,3158,16,13,1250,857,0.5517241379310345,393,0.5932605600379687
2022,3159,6,24,372,1245,0.2,-873,0.2300556586270872
2022,3160,22,8,1521,440,0.7333333333333333,1081,0.7756246812850587
2022,3161,19,11,1370,703,0.6333333333333333,667,0.6608779546550893
2022,3162,22,5,1537,329,0.8148148148148148,1208,0.8236870310825295
2022,3163,25,5,1950,293,0.8333333333333334,1657,0.8693713776192599
2022,3164,15,13,1079,681,0.5357142857142857,398,0.6130681818181818
2022,3165,8,16,459,792,0.3333333333333333,-333,0.3669064748201439
2022,3166,20,9,1587,583,0.6896551724137931,1004,0.7313364055299539
2022,3167,4,20,308,1111,0.16666666666666666,-803,0.21705426356589147
2022,3168,11,18,704,1045,0.3793103448275862,-341,0.4025157232704403
2022,3169,7,19,429,1012,0.2692307692307692,-583,0.29770992366412213
2022,3170,13,16,899,969,0.4482758620689655,-70,0.48126338329764456
2022,3171,3,23,187,1035,0.11538461538461539,-848,0.1530278232405892
2022,3172,16,14,1070,808,0.5333333333333333,262,0.56975505857295
2022,3173,25,5,1684,281,0.8333333333333334,1403,0.8569974554707379
2022,3174,23,7,1726,419,0.7666666666666667,1307,0.8046620046620047
2022,3176,8,20,607,1169,0.2857142857142857,-562,0.34177927927927926
2022,3177,22,10,2066,759,0.6875,1307,0.7313274336283185
2022,3178,1,27,63,1497,0.03571428571428571,-1434,0.04038461538461539
2022,3179,17,13,1420,765,0.5666666666666667,655,0.6498855835240275
2022,3180,26,5,1737,296,0.8387096774193549,1441,0.8544023610427939
2022,3181,17,13,1239,712,0.5666666666666667,527,0.6350589441312148
2022,3182,11,18,763,1088,0.3793103448275862,-325,0.41220961642355486
2022,3183,14,14,1064,809,0.5,255,0.5680726107848372
2022,3184,11,16,779,969,0.4074074074074074,-190,0.44565217391304346
2022,3185,6,20,455,1216,0.23076923076923078,-761,0.2722920406941951
2022,3186,7,21,467,1160,0.25,-693,0.28703134603564845
2022,3187,11,18,814,932,0.3793103448275862,-118,0.4662084765177549
2022,3188,13,18,986,1162,0.41935483870967744,-176,0.4590316573556797
2022,3189,17,12,1151,657,0.5862068965517241,494,0.6366150442477876
2022,3190,6,22,403,1147,0.21428571428571427,-744,0.26
2022,3191,7,22,513,1369,0.2413793103448276,-856,0.2725823591923486
2022,3192,19,11,1223,624,0.6333333333333333,599,0.6621548456957228
2022,3193,25,6,1675,342,0.8064516129032258,1333,0.8304412493802678
2022,3194,3,25,202,1398,0.10714285714285714,-1196,0.12625
2022,3195,26,2,2035,110,0.9285714285714286,1925,0.9487179487179487
2022,3196,21,10,1503,621,0.6774193548387096,882,0.7076271186440678
2022,3197,3,24,214,1243,0.1111111111111111,-1029,0.14687714481811942
2022,3198,12,16,811,934,0.42857142857142855,-123,0.464756446991404
2022,3199,17,13,1203,770,0.5666666666666667,433,0.6097313735428281
2022,3200,18,10,1206,533,0.6428571428571429,673,0.6935020126509488
2022,3201,9,18,665,1177,0.3333333333333333,-512,0.36102062975027144
2022,3202,17,12,1127,703,0.5862068965517241,424,0.6158469945355192
2022,3203,12,18,677,859,0.4,-182,0.4407552083333333
2022,3204,15,10,1222,666,0.6,556,0.6472457627118644
2022,3205,16,15,1230,950,0.5161290322580645,280,0.5642201834862385
2022,3206,10,19,643,1058,0.3448275862068966,-415,0.37801293356848914
2022,3207,9,19,590,1067,0.32142857142857145,-477,0.356065178032589
2022,3208,20,9,1464,541,0.6896551724137931,923,0.7301745635910224
2022,3209,8,16,521,1012,0.3333333333333333,-491,0.33985649054142203
2022,3210,21,10,1364,528,0.6774193548387096,836,0.7209302325581395
2022,3211,26,6,1902,316,0.8125,1586,0.8575293056807936
2022,3212,14,17,1005,987,0.45161290322580644,18,0.5045180722891566
2022,3213,20,9,1323,519,0.6896551724137931,804,0.7182410423452769
2022,3214,13,16,837,885,0.4482758620689655,-48,0.48606271777003485
2022,3216,4,26,252,1370,0.13333333333333333,-1118,0.15536374845869297
2022,3217,13,14,1063,852,0.48148148148148145,211,0.5550913838120104
2022,3218,20,9,1351,518,0.6896551724137931,833,0.7228464419475655
2022,3219,15,14,1020,752,0.5172413793103449,268,0.5756207674943566
2022,3220,7,20,425,957,0.25925925925925924,-532,0.30752532561505064
2022,3221,19,10,1206,518,0.6551724137931034,688,0.6995359628770301
2022,3222,16,15,1143,816,0.5161290322580645,327,0.5834609494640123
2022,3223,13,10,813,491,0.5652173913043478,322,0.6234662576687117
2022,3224,19,9,1320,481,0.6785714285714286,839,0.7329261521377013
2022,3225,13,18,952,1144,0.41935483870967744,-192,0.4541984732824427
2022,3226,17,11,1227,592,0.6071428571428571,635,0.6745464540956569
2022,3227,2,25,136,1295,0.07407407407407407,-1159,0.09503843466107617
2022,3228,7,20,523,1215,0.25925925925925924,-692,0.3009205983889528
2022,3229,18,13,1218,778,0.5806451612903226,440,0.6102204408817635
2022,3230,11,16,706,837,0.4074074074074074,-131,0.457550226830849
2022,3231,22,8,1621,533,0.7333333333333333,1088,0.7525533890436398
2022,3232,10,20,738,1158,0.3333333333333333,-420,0.38924050632911394
2022,3233,11,16,692,829,0.4074074074074074,-137,0.4549638395792242
2022,3234,23,7,2012,523,0.7666666666666667,1489,0.7936883629191321
2022,3235,26,6,2108,352,0.8125,1756,0.8569105691056911
2022,3236,5,21,379,1131,0.19230769230769232,-752,0.2509933774834437
2022,3237,24,4,1734,238,0.8571428571428571,1496,0.8793103448275862
2022,3238,23,6,1902,407,0.7931034482758621,1495,0.8237332178432222
2022,3239,12,13,713,707,0.48,6,0.502112676056338
2022,3240,22,7,1498,405,0.7586206896551724,1093,0.7871781397792958
2022,3241,14,15,974,869,0.4827586206896552,105,0.5284861638632664
2022,3242,20,9,1492,592,0.6896551724137931,900,0.7159309021113244
2022,3243,19,12,1395,679,0.6129032258064516,716,0.6726133076181292
2022,3244,8,19,542,1046,0.2962962962962963,-504,0.3413098236775819
2022,3245,16,11,1129,672,0.5925925925925926,457,0.6268739589117157
2022,3246,19,11,1507,668,0.6333333333333333,839,0.6928735632183908
2022,3247,16,12,1127,703,0.5714285714285714,424,0.6158469945355192
2022,3248,12,18,712,924,0.4,-212,0.4352078239608802
2022,3249,12,15,784,868,0.4444444444444444,-84,0.4745762711864407
2022,3250,18,11,1364,624,0.6206896551724138,740,0.6861167002012073
2022,3251,24,4,1589,238,0.8571428571428571,1351,0.8697318007662835
2022,3252,6,20,363,1116,0.23076923076923078,-753,0.24543610547667344
2022,3253,18,8,1154,441,0.6923076923076923,713,0.7235109717868339
2022,3254,9,18,526,974,0.3333333333333333,-448,0.3506666666666667
2022,3255,21,11,1616,673,0.65625,943,0.7059851463521188
2022,3256,19,11,1370,594,0.6333333333333333,776,0.6975560081466395
2022,3257,25,4,1851,242,0.8620689655172413,1609,0.8843764930721453
2022,3258,10,19,665,1046,0.3448275862068966,-381,0.38866160140268846
2022,3259,5,24,305,1254,0.1724137931034483,-949,0.19563822963438102
2022,3260,17,12,1077,619,0.5862068965517241,458,0.6350235849056604
2022,3261,25,5,1867,345,0.8333333333333334,1522,0.8440325497287523
2022,3262,11,16,706,801,0.4074074074074074,-95,0.4684804246848042
2022,3263,20,11,1246,577,0.6451612903225806,669,0.6834887547997806
2022,3264,21,11,1452,666,0.65625,786,0.6855524079320113
2022,3265,8,21,501,1027,0.27586206896551724,-526,0.32787958115183247
2022,3266,21,10,1500,531,0.6774193548387096,969,0.7385524372230429
2022,3267,13,13,859,727,0.5,132,0.5416141235813366
2022,3268,21,8,1766,498,0.7241379310344828,1268,0.7800353356890459
2022,3269,26,6,1927,362,0.8125,1565,0.8418523372651813
2022,3270,10,15,722,952,0.4,-230,0.43130227001194743
2022,3271,9,16,633,907,0.36,-274,0.41103896103896104
2022,3272,16,12,1055,690,0.5714285714285714,365,0.6045845272206304
2022,3273,23,6,1578,317,0.7931034482758621,1261,0.8327176781002639
2022,3274,20,12,1295,664,0.625,631,0.6610515569167943
2022,3275,8,21,617,1337,0.27586206896551724,-720,0.3157625383828045
2022,3276,22,6,1662,385,0.7857142857142857,1277,0.8119198827552516
2022,3277,15,15,1160,958,0.5,202,0.5476864966949953
2022,3278,14,17,1037,1133,0.45161290322580644,-96,0.47788018433179724
2022,3279,23,8,1650,431,0.7419354838709677,1219,0.7928880345987506
2022,3280,15,14,1157,906,0.5172413793103449,251,0.5608337372758119
2022,3281,18,12,1366,743,0.6,623,0.6477003319108582
2022,3282,21,8,1537,508,0.7241379310344828,1029,0.7515892420537897
2022,3283,23,7,1578,362,0.7666666666666667,1216,0.8134020618556701
2022,3284,14,16,869,907,0.4666666666666667,-38,0.48930180180180183
2022,3285,18,11,1304,650,0.6206896551724138,654,0.6673490276356192
2022,3286,20,12,1492,737,0.625,755,0.6693584567070435
2022,3288,16,8,1056,429,0.6666666666666666,627,0.7111111111111111
2022,3290,4,22,306,1350,0.15384615384615385,-1044,0.18478260869565216
2022,3291,14,12,944,682,0.5384615384615384,262,0.5805658056580566
2022,3292,23,7,1580,461,0.7666666666666667,1119,0.7741303282704557
2022,3293,20,9,1532,573,0.6896551724137931,959,0.727790973871734
2022,3294,14,16,926,913,0.4666666666666667,13,0.5035345296356716
2022,3295,9,18,649,1036,0.3333333333333333,-387,0.3851632047477745
2022,3296,14,15,1023,910,0.4827586206896552,113,0.5292291774443869
2022,3297,20,8,1405,441,0.7142857142857143,964,0.7611050920910076
2022,3298,10,21,600,1108,0.3225806451612903,-508,0.351288056206089
2022,3299,14,15,1099,871,0.4827586206896552,228,0.5578680203045685
2022,3300,3,20,232,1112,0.13043478260869565,-880,0.17261904761904762
2022,3301,29,3,2241,203,0.90625,2038,0.9169394435351882
2022,3303,6,19,376,1025,0.24,-649,0.26837972876516775
2022,3304,24,8,1933,580,0.75,1353,0.769200159172304
2022,3305,17,11,1179,673,0.6071428571428571,506,0.6366090712742981
2022,3306,6,21,359,1052,0.2222222222222222,-693,0.25442948263642806
2022,3307,23,9,1813,610,0.71875,1203,0.7482459760627321
2022,3308,8,19,538,1127,0.2962962962962963,-589,0.32312312312312313
2022,3309,4,18,279,910,0.18181818181818182,-631,0.23465096719932715
2022,3310,15,15,1130,966,0.5,164,0.5391221374045801
2022,3311,2,22,116,1290,0.08333333333333333,-1174,0.08250355618776671
2022,3312,15,15,928,773,0.5,155,0.5455614344503233
2022,3313,16,11,1082,549,0.5925925925925926,533,0.6633966891477621
2022,3314,23,6,1789,347,0.7931034482758621,1442,0.8375468164794008
2022,3315,13,15,940,908,0.4642857142857143,32,0.5086580086580087
2022,3316,10,17,739,927,0.37037037037037035,-188,0.44357743097238894
2022,3317,16,12,1113,722,0.5714285714285714,391,0.6065395095367847
2022,3318,14,15,946,849,0.4827586206896552,97,0.5270194986072423
2022,3319,17,14,1370,888,0.5483870967741935,482,0.6067316209034543
2022,3320,21,10,1498,609,0.6774193548387096,889,0.7109634551495017
2022,3321,17,12,1201,739,0.5862068965517241,462,0.6190721649484536
2022,3322,8,14,596,740,0.36363636363636365,-144,0.44610778443113774
2022,3323,22,8,1699,492,0.7333333333333333,1207,0.775445002282063
2022,3324,15,15,966,912,0.5,54,0.5143769968051118
2022,3325,14,14,1086,966,0.5,120,0.5292397660818714
2022,3326,23,6,1876,420,0.7931034482758621,1456,0.8170731707317073
2022,3328,24,8,2077,589,0.75,1488,0.7790697674418605
2022,3329,9,20,583,1089,0.3103448275862069,-506,0.34868421052631576
2022,3330,22,9,1497,471,0.7096774193548387,1026,0.760670731707317
2022,3331,14,15,1004,844,0.4827586206896552,160,0.5432900432900433
2022,3332,19,11,1442,683,0.6333333333333333,759,0.6785882352941176
2022,3333,14,13,987,723,0.5185185185185185,264,0.5771929824561404
2022,3334,5,23,371,1525,0.17857142857142858,-1154,0.19567510548523206
2022,3335,10,14,703,800,0.4166666666666667,-97,0.46773120425815035
2022,3336,11,18,881,1166,0.3793103448275862,-285,0.43038593063019054
2022,3337,8,17,510,979,0.32,-469,0.3425117528542646
2022,3338,11,19,786,1064,0.36666666666666664,-278,0.42486486486486486
2022,3339,17,10,1281,614,0.6296296296296297,667,0.6759894459102902
2022,3340,3,24,230,1335,0.1111111111111111,-1105,0.14696485623003194
2022,3341,10,17,671,998,0.37037037037037035,-327,0.40203714799281004
2022,3342,11,18,736,976,0.3793103448275862,-240,0.42990654205607476
2022,3343,23,4,1615,233,0.8518518518518519,1382,0.8739177489177489
2022,3344,11,19,705,1092,0.36666666666666664,-387,0.39232053422370616
2022,3345,16,14,1202,867,0.5333333333333333,335,0.5809569840502659
2022,3346,20,11,1462,636,0.6451612903225806,826,0.6968541468064824
2022,3347,5,23,326,1258,0.17857142857142858,-932,0.2058080808080808
2022,3348,22,6,1494,292,0.7857142857142857,1202,0.8365061590145577
2022,3349,13,13,940,781,0.5,159,0.5461940732132481
2022,3350,16,14,1246,869,0.5333333333333333,377,0.5891252955082742
2022,3351,9,21,572,1176,0.3,-604,0.32723112128146453
2022,3352,13,15,805,716,0.4642857142857143,89,0.5292570677186061
2022,3353,11,20,733,1078,0.3548387096774194,-345,0.40474875759249035
2022,3354,4,25,234,1228,0.13793103448275862,-994,0.1600547195622435
2022,3355,22,9,1775,507,0.7096774193548387,1268,0.7778264680105171
2022,3356,20,9,1347,478,0.6896551724137931,869,0.7380821917808219
2022,3357,8,17,531,920,0.32,-389,0.36595451412818747
2022,3358,12,16,847,938,0.42857142857142855,-91,0.4745098039215686
2022,3359,11,17,790,955,0.39285714285714285,-165,0.45272206303724927
2022,3360,16,14,1160,849,0.5333333333333333,311,0.5774016923842707
2022,3361,14,16,974,896,0.4666666666666667,78,0.520855614973262
2022,3362,17,15,1256,925,0.53125,331,0.5758826226501604
2022,3363,4,25,277,1465,0.13793103448275862,-1188,0.15901262916188288
2022,3364,14,12,957,578,0.5384615384615384,379,0.6234527687296417
2022,3365,14,15,1061,937,0.4827586206896552,124,0.531031031031031
2022,3367,19,8,1295,453,0.7037037037037037,842,0.7408466819221968
2022,3368,14,11,978,557,0.56,421,0.6371335504885993
2022,3369,4,23,280,1320,0.14814814814814814,-1040,0.175
2022,3370,9,19,622,1107,0.32142857142857145,-485,0.3597455176402545
2022,3371,19,12,1415,733,0.6129032258064516,682,0.6587523277467412
2022,3372,26,4,1912,262,0.8666666666666667,1650,0.8794848206071757
2022,3373,10,19,643,1038,0.3448275862068966,-395,0.3825104104699584
2022,3374,14,14,957,741,0.5,216,0.5636042402826855
2022,3375,5,18,330,1027,0.21739130434782608,-697,0.2431834929992631
2022,3376,29,2,2079,131,0.9354838709677419,1948,0.9407239819004525
2022,3377,26,5,1866,278,0.8387096774193549,1588,0.8703358208955224
2022,3378,24,8,1547,395,0.75,1152,0.7966014418125643
2022,3379,16,12,1103,751,0.5714285714285714,352,0.5949298813376483
2022,3380,12,17,837,876,0.41379310344827586,-39,0.4886164623467601
2022,3381,16,12,1206,700,0.5714285714285714,506,0.6327387198321092
2022,3382,11,16,674,878,0.4074074074074074,-204,0.43427835051546393
2022,3383,16,10,1082,580,0.6153846153846154,502,0.6510228640192539
2022,3384,8,22,558,1069,0.26666666666666666,-511,0.34296250768285186
2022,3385,12,19,977,1256,0.3870967741935484,-279,0.43752798925212716
2022,3386,13,17,864,884,0.43333333333333335,-20,0.494279176201373
2022,3387,9,18,582,1033,0.3333333333333333,-451,0.3603715170278638
2022,3388,15,15,1154,914,0.5,240,0.558027079303675
2022,3389,13,18,875,954,0.41935483870967744,-79,0.47840349917987973
2022,3390,28,3,2116,171,0.9032258064516129,1945,0.9252295583734149
2022,3391,18,12,1187,617,0.6,570,0.6579822616407982
2022,3392,23,5,1619,287,0.8214285714285714,1332,0.8494228751311648
2022,3393,11,18,935,1124,0.3793103448275862,-189,0.4541039339485187
2022,3394,16,10,1029,561,0.6153846153846154,468,0.6471698113207547
2022,3395,6,22,407,1282,0.21428571428571427,-875,0.24097098875074008
2022,3396,13,15,836,836,0.4642857142857143,0,0.5
2022,3397,23,8,1684,484,0.7419354838709677,1200,0.7767527675276753
2022,3398,11,19,783,1116,0.36666666666666664,-333,0.41232227488151657
2022,3399,18,10,1258,550,0.6428571428571429,708,0.6957964601769911
2022,3400,26,6,1946,378,0.8125,1568,0.8373493975903614
2022,3401,14,15,1075,936,0.4827586206896552,139,0.5345599204375933
2022,3402,12,14,853,839,0.46153846153846156,14,0.5041371158392435
2022,3403,11,19,823,1151,0.36666666666666664,-328,0.41691995947315097
2022,3404,12,18,743,926,0.4,-183,0.445176752546435
2022,3405,26,5,1924,307,0.8387096774193549,1617,0.8623935454952936
2022,3406,22,7,1656,436,0.7586206896551724,1220,0.7915869980879541
2022,3407,22,8,1757,559,0.7333333333333333,1198,0.7586355785837651
2022,3408,19,9,1419,573,0.6785714285714286,846,0.7123493975903614
2022,3409,15,10,1102,592,0.6,510,0.6505312868949232
2022,3410,14,19,948,1061,0.42424242424242425,-113,0.4718765555002489
2022,3411,11,15,879,899,0.4230769230769231,-20,0.49437570303712036
2022,3412,14,15,1040,896,0.4827586206896552,144,0.5371900826446281
2022,3413,13,13,832,748,0.5,84,0.5265822784810127
2022,3414,20,11,1366,665,0.6451612903225806,701,0.672575086164451
2022,3415,12,11,739,611,0.5217391304347826,128,0.5474074074074075
2022,3416,25,3,1540,159,0.8928571428571429,1381,0.9064155385520895
2022,3417,14,12,997,730,0.5384615384615384,267,0.5773016792125072
2022,3418,15,7,1038,384,0.6818181818181818,654,0.729957805907173
2022,3419,1,25,74,1403,0.038461538461538464,-1329,0.05010155721056195
2022,3420,2,23,108,1220,0.08,-1112,0.08132530120481928
2022,3421,8,22,531,1267,0.26666666666666666,-736,0.2953281423804227
2022,3422,8,19,487,969,0.2962962962962963,-482,0.33447802197802196
2022,3423,2,26,100,1407,0.07142857142857142,-1307,0.06635700066357
2022,3424,26,6,2018,400,0.8125,1618,0.8345740281224152
2022,3425,12,16,907,894,0.42857142857142855,13,0.5036091060521932
2022,3426,20,7,1470,419,0.7407407407407407,1051,0.7781895182636316
2022,3427,7,23,415,1203,0.23333333333333334,-788,0.2564894932014833
2022,3428,20,11,1626,731,0.6451612903225806,895,0.6898599915146373
2022,3429,10,19,765,1210,0.3448275862068966,-445,0.38734177215189874
2022,3430,14,15,956,857,0.4827586206896552,99,0.5273028130170987
2022,3431,14,15,1034,857,0.4827586206896552,177,0.5468006345848757
2022,3433,15,11,971,605,0.5769230769230769,366,0.6161167512690355
2022,3434,11,19,781,1021,0.36666666666666664,-240,0.43340732519422864
2022,3435,14,18,1002,1005,0.4375,-3,0.4992526158445441
2022,3436,20,11,1305,601,0.6451612903225806,704,0.6846799580272823
2022,3437,23,8,1594,439,0.7419354838709677,1155,0.7840629611411707
2022,3438,5,22,323,1163,0.18518518518518517,-840,0.2173620457604307
2022,3439,23,9,1767,489,0.71875,1278,0.7832446808510638
2022,3441,3,23,187,1117,0.11538461538461539,-930,0.14340490797546013
2022,3442,12,15,963,882,0.4444444444444444,81,0.5219512195121951
2022,3443,17,12,1307,713,0.5862068965517241,594,0.647029702970297
2022,3444,14,14,928,823,0.5,105,0.5299828669331811
2022,3447,17,11,1102,604,0.6071428571428571,498,0.6459554513481829
2022,3448,15,16,1090,928,0.4838709677419355,162,0.5401387512388504
2022,3449,7,16,461,831,0.30434782608695654,-370,0.3568111455108359
2022,3450,19,10,1250,512,0.6551724137931034,738,0.7094211123723042
2022,3451,11,20,767,1218,0.3548387096774194,-451,0.3863979848866499
2022,3452,15,15,1062,933,0.5,129,0.5323308270676692
2022,3453,19,7,1266,341,0.7307692307692307,925,0.7878033602986932
2022,3454,14,16,896,863,0.4666666666666667,33,0.5093803297328028
2022,3455,14,16,1035,887,0.4666666666666667,148,0.5385015608740895
2022,3456,9,20,577,1052,0.3103448275862069,-475,0.3542050337630448
2022,3457,5,22,322,1076,0.18518518518518517,-754,0.23032904148783978
2022,3458,8,21,502,1177,0.27586206896551724,-675,0.2989874925550923
2022,3459,14,13,998,718,0.5185185185185185,280,0.5815850815850816
2022,3460,3,19,212,1074,0.13636363636363635,-862,0.16485225505443235
2022,3461,13,12,890,656,0.52,234,0.5756791720569211
2022,3462,9,21,634,1236,0.3,-602,0.3390374331550802
2022,3463,16,11,1014,566,0.5925925925925926,448,0.6417721518987342
2022,3464,21,6,1400,344,0.7777777777777778,1056,0.8027522935779816
2022,3465,23,8,1832,520,0.7419354838709677,1312,0.7789115646258503
2022,3466,10,15,788,865,0.4,-77,0.4767090139140956
2022,3467,9,17,650,1018,0.34615384615384615,-368,0.38968824940047964
2022,3468,2,24,136,1379,0.07692307692307693,-1243,0.08976897689768977
2022,3469,6,19,462,1120,0.24,-658,0.2920353982300885
2022,3470,12,13,763,660,0.48,103,0.5361911454673226
2022,3471,12,14,842,710,0.46153846153846156,132,0.5425257731958762
2022,3472,6,21,383,1152,0.2222222222222222,-769,0.2495114006514658
2023,1101,9,17,709,1142,0.34615384615384615,-433,0.38303619665045924
2023,1102,14,18,1051,1091,0.4375,-40,0.4906629318394024
2023,1103,20,11,1579,720,0.6451612903225806,859,0.686820356676816
2023,1104,29,5,2448,346,0.8529411764705882,2102,0.8761632068718683
2023,1105,12,18,849,1190,0.4,-341,0.4163805787150564
2023,1106,7,23,489,1384,0.23333333333333334,-895,0.2610784837159637
2023,1107,6,23,479,1446,0.20689655172413793,-967,0.24883116883116882
2023,1108,18,13,1321,791,0.5806451612903226,530,0.6254734848484849
2023,1110,17,15,1157,936,0.53125,221,0.5527950310559007
2023,1111,13,16,907,996,0.4482758620689655,-89,0.4766158696794535
2023,1112,28,6,2376,435,0.8235294117647058,1941,0.8452508004268944
2023,1113,22,12,1636,755,0.6470588235294118,881,0.6842325386867419
2023,1114,8,21,669,1514,0.27586206896551724,-845,0.30645900137425564
2023,1115,6,21,427,1327,0.2222222222222222,-900,0.2434435575826682
2023,1116,20,13,1560,896,0.6060606060606061,664,0.6351791530944625
2023,1117,10,20,703,1208,0.3333333333333333,-505,0.36787022501308214
2023,1119,15,16,1112,1102,0.4838709677419355,10,0.5022583559168925
2023,1120,20,12,1512,815,0.625,697,0.649763644177052
2023,1122,6,22,433,1348,0.21428571428571427,-915,0.24312184166198764
2023,1123,18,12,1393,857,0.6,536,0.6191111111111111
2023,1124,22,10,1739,730,0.6875,1009,0.7043337383556095
2023,1125,20,11,1588,776,0.6451612903225806,812,0.6717428087986463
2023,1126,10,20,731,1287,0.3333333333333333,-556,0.3622398414271556
2023,1127,11,18,813,1147,0.3793103448275862,-334,0.4147959183673469
2023,1129,23,9,1722,572,0.71875,1150,0.7506538796861377
2023,1130,16,17,1127,1070,0.48484848484848486,57,0.512972234865726
2023,1131,14,17,990,1061,0.45161290322580644,-71,0.4826913700633837
2023,1132,9,20,754,1406,0.3103448275862069,-652,0.3490740740740741
2023,1133,24,9,1785,533,0.7272727272727273,1252,0.7700603968938741
2023,1135,14,13,1007,871,0.5185185185185185,136,0.5362087326943556
2023,1136,15,13,1252,884,0.5357142857142857,368,0.5861423220973783
2023,1137,11,20,809,1239,0.3548387096774194,-430,0.39501953125
2023,1138,13,17,1088,1173,0.43333333333333335,-85,0.48120300751879697
2023,1139,14,18,1090,998,0.4375,92,0.5220306513409961
2023,1140,17,15,1314,1057,0.53125,257,0.5541965415436525
2023,1141,8,21,589,1286,0.27586206896551724,-697,0.3141333333333333
2023,1142,6,25,435,1405,0.1935483870967742,-970,0.23641304347826086
2023,1143,3,29,245,1621,0.09375,-1376,0.13129689174705253
2023,1144,14,18,1048,1150,0.4375,-102,0.4767970882620564
2023,1145,9,20,658,1355,0.3103448275862069,-697,0.32687531048186785
2023,1146,8,22,672,1482,0.26666666666666666,-810,0.31197771587743733
2023,1148,10,22,746,1365,0.3125,-619,0.35338702036949315
2023,1149,8,21,664,1378,0.27586206896551724,-714,0.32517140058765914
2023,1150,18,14,1280,855,0.5625,425,0.5995316159250585
2023,1151,15,17,1219,1185,0.46875,34,0.507071547420965
2023,1152,7,20,520,1275,0.25925925925925924,-755,0.28969359331476324
2023,1153,20,12,1633,817,0.625,816,0.666530612244898
2023,1154,9,22,643,1406,0.2903225806451613,-763,0.31381161542215713
2023,1155,23,10,1827,649,0.696969696969697,1178,0.7378836833602584
2023,1156,20,12,1524,767,0.625,757,0.6652116979484941
2023,1157,8,20,638,1326,0.2857142857142857,-688,0.32484725050916496
2023,1158,30,3,2415,236,0.9090909090909091,2179,0.9109769898151641
2023,1159,25,8,1997,582,0.7575757575757576,1415,0.7743311360992633
2023,1160,17,16,1293,1018,0.5151515151515151,275,0.5594980527909996
2023,1161,14,18,1077,1199,0.4375,-122,0.47319859402460457
2023,1162,5,22,316,1448,0.18518518518518517,-1132,0.17913832199546487
2023,1163,25,8,2039,550,0.7575757575757576,1489,0.787562765546543
2023,1164,9,23,742,1562,0.28125,-820,0.3220486111111111
2023,1165,15,11,1280,810,0.5769230769230769,470,0.6124401913875598
2023,1166,21,12,1690,839,0.6363636363636364,851,0.6682483194938711
2023,1167,9,22,593,1244,0.2903225806451613,-651,0.32280892759934676
2023,1168,18,13,1308,810,0.5806451612903226,498,0.6175637393767706
2023,1169,5,25,363,1474,0.16666666666666666,-1111,0.19760479041916168
2023,1170,12,18,863,1121,0.4,-258,0.43497983870967744
2023,1171,8,18,626,1166,0.3076923076923077,-540,0.34933035714285715
2023,1172,15,16,1121,1028,0.4838709677419355,93,0.5216379711493718
2023,1173,22,12,1606,728,0.6470588235294118,878,0.68808911739503
2023,1174,16,16,1163,1057,0.5,106,0.5238738738738739
2023,1175,5,23,358,1408,0.17857142857142858,-1050,0.20271800679501698
2023,1176,13,17,1022,1128,0.43333333333333335,-106,0.4753488372093023
2023,1177,10,23,796,1553,0.30303030303030304,-757,0.3388676032354193
2023,1178,13,19,1065,1369,0.40625,-304,0.4375513557929334
2023,1179,26,7,2016,421,0.7878787878787878,1595,0.8272466146901929
2023,1180,16,15,1111,939,0.5161290322580645,172,0.5419512195121952
2023,1181,26,8,1956,510,0.7647058823529411,1446,0.7931873479318735
2023,1182,20,12,1606,788,0.625,818,0.670843776106934
2023,1183,7,22,539,1400,0.2413793103448276,-861,0.2779783393501805
2023,1184,17,13,1263,891,0.5666666666666667,372,0.5863509749303621
2023,1185,7,23,526,1638,0.23333333333333334,-1112,0.24306839186691312
2023,1186,21,10,1655,681,0.6774193548387096,974,0.7084760273972602
2023,1187,16,17,1213,1058,0.48484848484848486,155,0.5341259357111404
2023,1188,16,14,1203,993,0.5333333333333333,210,0.5478142076502732
2023,1189,6,24,426,1487,0.2,-1061,0.2226868792472556
2023,1190,10,20,759,1280,0.3333333333333333,-521,0.3722412947523296
2023,1191,5,27,348,1649,0.15625,-1301,0.1742613920881322
2023,1192,17,15,1367,1074,0.53125,293,0.5600163867267514
2023,1193,12,18,824,1102,0.4,-278,0.42782969885773625
2023,1194,29,3,2287,214,0.90625,2073,0.9144342263094762
2023,1195,16,15,1174,1001,0.5161290322580645,173,0.5397701149425287
2023,1196,16,16,1265,1037,0.5,228,0.549522154648132
2023,1197,5,22,342,1230,0.18518518518518517,-888,0.21755725190839695
2023,1198,12,18,931,1244,0.4,-313,0.42804597701149427
2023,1199,9,23,705,1514,0.28125,-809,0.3177106804867057
2023,1200,25,8,1903,473,0.7575757575757576,1430,0.8009259259259259
2023,1201,10,20,740,1165,0.3333333333333333,-425,0.3884514435695538
2023,1202,24,7,1980,512,0.7741935483870968,1468,0.7945425361155698
2023,1203,15,16,1261,1095,0.4838709677419355,166,0.5352292020373515
2023,1204,14,16,982,1030,0.4666666666666667,-48,0.48807157057654077
2023,1205,13,16,939,1017,0.4482758620689655,-78,0.48006134969325154
2023,1206,20,13,1446,822,0.6060606060606061,624,0.6375661375661376
2023,1207,7,25,563,1662,0.21875,-1099,0.25303370786516854
2023,1208,16,16,1123,1070,0.5,53,0.5120839033287734
2023,1209,7,21,523,1299,0.25,-776,0.2870472008781559
2023,1210,13,18,999,1130,0.41935483870967744,-131,0.46923438233912634
2023,1211,27,5,2428,340,0.84375,2088,0.8771676300578035
2023,1212,22,9,1580,513,0.7096774193548387,1067,0.754897276636407
2023,1213,21,11,1636,678,0.65625,958,0.7070008643042351
2023,1214,7,24,513,1581,0.22580645161290322,-1068,0.24498567335243554
2023,1216,2,23,147,1345,0.08,-1198,0.0985254691689008
2023,1217,12,14,894,876,0.46153846153846156,18,0.5050847457627119
2023,1218,21,11,1466,663,0.65625,803,0.688586190699859
2023,1219,12,17,935,1168,0.41379310344827586,-233,0.444602948169282
2023,1220,23,9,1800,570,0.71875,1230,0.759493670886076
2023,1221,8,22,567,1389,0.26666666666666666,-822,0.2898773006134969
2023,1222,31,3,2366,185,0.9117647058823529,2181,0.9274794198353586
2023,1223,7,22,611,1558,0.2413793103448276,-947,0.28169663439372983
2023,1224,19,12,1481,801,0.6129032258064516,680,0.6489921121822962
2023,1225,8,22,648,1440,0.26666666666666666,-792,0.3103448275862069
2023,1226,9,21,682,1373,0.3,-691,0.3318734793187348
2023,1227,11,20,805,1262,0.3548387096774194,-457,0.38945331398161587
2023,1228,20,12,1572,817,0.625,755,0.6580159062369192
2023,1229,11,21,797,1330,0.34375,-533,0.37470615890926184
2023,1230,9,19,664,1249,0.32142857142857145,-585,0.3470987976999477
2023,1231,22,11,1730,746,0.6666666666666666,984,0.6987075928917609
2023,1232,21,12,1755,840,0.6363636363636364,915,0.6763005780346821
2023,1233,27,7,2110,487,0.7941176470588235,1623,0.8124759337697343
2023,1234,19,13,1683,884,0.59375,799,0.6556291390728477
2023,1235,19,13,1411,779,0.59375,632,0.6442922374429224
2023,1236,15,15,1187,960,0.5,227,0.5528644620400559
2023,1237,3,27,211,1744,0.1,-1533,0.10792838874680306
2023,1238,14,19,975,1257,0.42424242424242425,-282,0.4368279569892473
2023,1239,10,16,667,920,0.38461538461538464,-253,0.42028985507246375
2023,1240,10,18,777,1103,0.35714285714285715,-326,0.41329787234042553
2023,1241,19,11,1558,771,0.6333333333333333,787,0.6689566337483899
2023,1242,27,7,2119,429,0.7941176470588235,1690,0.8316326530612245
2023,1243,23,9,1788,628,0.71875,1160,0.7400662251655629
2023,1244,23,8,1741,545,0.7419354838709677,1196,0.7615923009623797
2023,1245,26,6,2040,383,0.8125,1657,0.8419314898885679
2023,1246,21,11,1657,745,0.65625,912,0.6898417985012489
2023,1247,15,19,1147,1227,0.4411764705882353,-80,0.483150800336984
2023,1248,11,23,768,1352,0.3235294117647059,-584,0.3622641509433962
2023,1249,6,22,439,1413,0.21428571428571427,-974,0.23704103671706264
2023,1250,14,14,1011,892,0.5,119,0.5312664214398318
2023,1251,23,8,1740,523,0.7419354838709677,1217,0.7688908528501989
2023,1252,17,13,1317,924,0.5666666666666667,393,0.5876840696117804
2023,1253,15,16,1197,1146,0.4838709677419355,51,0.5108834827144686
2023,1254,1,26,74,1655,0.037037037037037035,-1581,0.042799305957200696
2023,1255,18,12,1376,753,0.6,623,0.6463128229215594
2023,1256,12,18,940,1166,0.4,-226,0.44634377967711303
2023,1257,4,28,306,1740,0.125,-1434,0.1495601173020528
2023,1258,18,12,1414,822,0.6,592,0.6323792486583184
2023,1259,11,20,850,1192,0.3548387096774194,-342,0.41625857002938293
2023,1260,10,21,733,1356,0.3225806451612903,-623,0.3508855911919579
2023,1261,14,19,1033,1198,0.42424242424242425,-165,0.46302106678619454
2023,1262,24,8,1897,543,0.75,1354,0.7774590163934426
2023,1263,11,17,798,1063,0.39285714285714285,-265,0.4288017195056421
2023,1264,11,18,766,1164,0.3793103448275862,-398,0.39689119170984455
2023,1265,13,20,874,1236,0.3939393939393939,-362,0.414218009478673
2023,1266,28,6,2270,448,0.8235294117647058,1822,0.8351729212656365
2023,1267,23,8,1942,575,0.7419354838709677,1367,0.7715534366309098
2023,1268,21,12,1622,700,0.6363636363636364,922,0.6985357450473729
2023,1269,15,16,1138,1025,0.4838709677419355,113,0.5261211280628756
2023,1270,10,23,753,1489,0.30303030303030304,-736,0.33586083853702053
2023,1271,14,13,1045,756,0.5185185185185185,289,0.5802332037756802
2023,1272,26,8,2061,652,0.7647058823529411,1409,0.7596756358274972
2023,1273,12,19,870,1180,0.3870967741935484,-310,0.424390243902439
2023,1274,25,7,2024,517,0.78125,1507,0.7965367965367965
2023,1275,9,20,724,1371,0.3103448275862069,-647,0.3455847255369928
2023,1276,17,15,1347,992,0.53125,355,0.5758871312526721
2023,1277,19,12,1379,798,0.6129032258064516,581,0.6334405144694534
2023,1278,9,22,616,1333,0.2903225806451613,-717,0.31605951770138535
2023,1279,12,21,899,1328,0.36363636363636365,-429,0.40368208352043106
2023,1280,21,12,1456,719,0.6363636363636364,737,0.6694252873563218
2023,1281,24,9,2067,556,0.7272727272727273,1511,0.7880289744567289
2023,1282,10,20,710,1181,0.3333333333333333,-471,0.37546271813855103
2023,1283,16,15,1131,885,0.5161290322580645,246,0.5610119047619048
2023,1284,7,26,540,1496,0.21212121212121213,-956,0.26522593320235754
2023,1285,16,14,1191,893,0.5333333333333333,298,0.5714971209213052
2023,1286,23,9,1714,559,0.71875,1155,0.7540695116586009
2023,1287,17,11,1189,670,0.6071428571428571,519,0.6395911780527165
2023,1288,11,16,869,1017,0.4074074074074074,-148,0.46076352067868503
2023,1290,5,27,383,1570,0.15625,-1187,0.19610855094726062
2023,1291,12,20,817,1224,0.375,-407,0.40029397354238117
2023,1292,17,14,1240,925,0.5483870967741935,315,0.5727482678983834
2023,1293,16,15,1216,948,0.5161290322580645,268,0.5619223659889094
2023,1294,12,19,963,1323,0.3870967741935484,-360,0.421259842519685
2023,1295,14,17,1069,1160,0.45161290322580644,-91,0.47958725886047554
2023,1296,12,18,980,1148,0.4,-168,0.4605263157894737
2023,1297,20,12,1412,738,0.625,674,0.6567441860465116
2023,1298,17,13,1220,839,0.5666666666666667,381,0.5925206410879067
2023,1299,10,19,738,1239,0.3448275862068966,-501,0.37329286798179057
2023,1300,14,12,1033,815,0.5384615384615384,218,0.558982683982684
2023,1301,23,10,1926,654,0.696969696969697,1272,0.7465116279069768
2023,1303,8,23,613,1475,0.25806451612903225,-862,0.2935823754789272
2023,1304,16,16,1203,972,0.5,231,0.5531034482758621
2023,1305,21,10,1552,674,0.6774193548387096,878,0.6972147349505841
2023,1306,13,15,942,867,0.4642857142857143,75,0.5207296849087893
2023,1307,21,11,1750,828,0.65625,922,0.6788207913110939
2023,1308,6,15,498,998,0.2857142857142857,-500,0.33288770053475936
2023,1309,10,20,831,1365,0.3333333333333333,-534,0.37841530054644806
2023,1310,15,15,1033,892,0.5,141,0.5366233766233767
2023,1311,12,15,927,1030,0.4444444444444444,-103,0.47368421052631576
2023,1312,6,23,446,1483,0.20689655172413793,-1037,0.23120787973043028
2023,1313,18,11,1400,729,0.6206896551724138,671,0.6575857209957726
2023,1314,20,13,1616,898,0.6060606060606061,718,0.6428003182179793
2023,1315,11,20,853,1336,0.3548387096774194,-483,0.38967565098218365
2023,1316,12,17,1024,1144,0.41379310344827586,-120,0.47232472324723246
2023,1317,24,7,1620,370,0.7741935483870968,1250,0.8140703517587939
2023,1318,10,20,718,1241,0.3333333333333333,-523,0.366513527309852
2023,1319,10,23,779,1615,0.30303030303030304,-836,0.3253968253968254
2023,1320,13,18,943,1196,0.41935483870967744,-253,0.44086021505376344
2023,1321,21,11,1496,669,0.65625,827,0.6909930715935335
2023,1322,21,11,1685,699,0.65625,986,0.7067953020134228
2023,1323,11,21,844,1383,0.34375,-539,0.37898518185900315
2023,1324,12,19,934,1321,0.3870967741935484,-387,0.41419068736141906
2023,1325,18,14,1498,991,0.5625,507,0.6018481317798312
2023,1326,16,19,1264,1274,0.45714285714285713,-10,0.4980299448384555
2023,1328,15,17,1085,1080,0.46875,5,0.5011547344110855
2023,1329,18,15,1310,949,0.5454545454545454,361,0.5799026117751217
2023,1330,18,12,1257,744,0.6,513,0.6281859070464768
2023,1331,26,4,2199,275,0.8666666666666667,1924,0.8888439773645918
2023,1332,19,14,1454,878,0.5757575757575758,576,0.6234991423670669
2023,1333,10,21,652,1224,0.3225806451612903,-572,0.34754797441364604
2023,1334,14,17,1149,1200,0.45161290322580644,-51,0.4891443167305236
2023,1335,16,13,1267,889,0.5517241379310345,378,0.5876623376623377
2023,1336,22,13,1697,834,0.6285714285714286,863,0.6704859739233504
2023,1337,7,22,616,1614,0.2413793103448276,-998,0.27623318385650225
2023,1338,22,11,1750,762,0.6666666666666666,988,0.696656050955414
2023,1339,12,19,1050,1327,0.3870967741935484,-277,0.44173327724021877
2023,1340,10,19,761,1375,0.3448275862068966,-614,0.3562734082397004
2023,1341,11,19,790,1189,0.36666666666666664,-399,0.3991915108640728
2023,1342,3,27,223,1632,0.1,-1409,0.12021563342318059
2023,1343,19,8,1447,577,0.7037037037037037,870,0.7149209486166008
2023,1344,21,11,1725,774,0.65625,951,0.6902761104441777
2023,1345,29,5,2164,321,0.8529411764705882,1843,0.8708249496981891
2023,1346,19,12,1423,826,0.6129032258064516,597,0.6327256558470431
2023,1347,17,14,1245,880,0.5483870967741935,365,0.5858823529411765
2023,1348,9,22,661,1385,0.2903225806451613,-724,0.323069403714565
2023,1349,15,15,1224,1020,0.5,204,0.5454545454545454
2023,1350,15,18,1088,1185,0.45454545454545453,-97,0.47866256049274086
2023,1351,15,14,1074,944,0.5172413793103449,130,0.5322101090188305
2023,1352,14,17,1045,1047,0.45161290322580644,-2,0.49952198852772467
2023,1353,19,14,1371,869,0.5757575757575758,502,0.6120535714285714
2023,1354,4,26,303,1860,0.13333333333333333,-1557,0.14008321775312066
2023,1355,18,13,1348,837,0.5806451612903226,511,0.6169336384439359
2023,1356,22,10,1502,579,0.6875,923,0.7217683805862566
2023,1357,15,17,1110,1122,0.46875,-12,0.49731182795698925
2023,1358,21,7,1469,450,0.75,1019,0.7655028660760813
2023,1359,18,10,1410,748,0.6428571428571429,662,0.6533827618164968
2023,1360,9,20,746,1466,0.3103448275862069,-720,0.337251356238698
2023,1361,26,6,1885,398,0.8125,1487,0.8256679807271134
2023,1362,19,14,1530,973,0.5757575757575758,557,0.6112664802237315
2023,1363,19,13,1376,762,0.59375,614,0.6435921421889617
2023,1364,25,7,1870,428,0.78125,1442,0.8137510879025239
2023,1365,22,9,1785,632,0.7096774193548387,1153,0.7385188249896566
2023,1367,14,15,1034,919,0.4827586206896552,115,0.5294418842805939
2023,1368,15,14,1193,997,0.5172413793103449,196,0.5447488584474885
2023,1369,17,16,1381,1167,0.5151515151515151,214,0.5419937205651492
2023,1370,18,12,1352,756,0.6,596,0.6413662239089184
2023,1371,16,15,1171,939,0.5161290322580645,232,0.5549763033175356
2023,1372,16,13,1262,886,0.5517241379310345,376,0.5875232774674115
2023,1373,17,15,1222,973,0.53125,249,0.5567198177676538
2023,1374,10,22,780,1468,0.3125,-688,0.3469750889679715
2023,1375,17,16,1282,1022,0.5151515151515151,260,0.5564236111111112
2023,1376,11,21,767,1292,0.34375,-525,0.37251092763477417
2023,1377,10,19,774,1196,0.3448275862068966,-422,0.3928934010152284
2023,1378,14,18,1087,1216,0.4375,-129,0.471993052540165
2023,1379,22,7,1660,452,0.7586206896551724,1208,0.7859848484848485
2023,1380,13,17,1002,1088,0.43333333333333335,-86,0.47942583732057414
2023,1381,18,12,1480,871,0.6,609,0.6295193534666099
2023,1382,14,18,1003,1133,0.4375,-130,0.4695692883895131
2023,1383,12,16,833,930,0.42857142857142855,-97,0.47249007373794666
2023,1384,11,18,880,1175,0.3793103448275862,-295,0.4282238442822384
2023,1385,18,15,1468,1084,0.5454545454545454,384,0.5752351097178683
2023,1386,16,17,1260,1128,0.48484848484848486,132,0.5276381909547738
2023,1387,20,12,1599,798,0.625,801,0.6670838548185232
2023,1388,25,7,1841,430,0.78125,1411,0.8106560986349626
2023,1389,13,18,900,988,0.41935483870967744,-88,0.4766949152542373
2023,1390,14,19,1086,1235,0.42424242424242425,-149,0.4679017664799655
2023,1391,15,13,1205,885,0.5357142857142857,320,0.5765550239234449
2023,1392,9,22,623,1285,0.2903225806451613,-662,0.32651991614255765
2023,1393,17,15,1333,1039,0.53125,294,0.561973018549747
2023,1394,19,10,1589,681,0.6551724137931034,908,0.7
2023,1395,21,12,1698,783,0.6363636363636364,915,0.6844014510278114
2023,1396,16,16,1124,1103,0.5,21,0.5047148630444545
2023,1397,23,10,1715,654,0.696969696969697,1061,0.7239341494301393
2023,1398,14,14,1131,983,0.5,148,0.5350047303689688
2023,1399,13,17,1008,1154,0.43333333333333335,-146,0.4662349676225717
2023,1400,26,8,2036,611,0.7647058823529411,1425,0.7691726482810729
2023,1401,25,9,1862,628,0.7352941176470589,1234,0.7477911646586345
2023,1402,14,18,962,1124,0.4375,-162,0.46116970278044106
2023,1403,16,16,1295,1052,0.5,243,0.5517682147422242
2023,1404,15,14,1222,993,0.5172413793103449,229,0.5516930022573363
2023,1405,26,7,2278,528,0.7878787878787878,1750,0.811831789023521
2023,1406,21,12,1546,822,0.6363636363636364,724,0.6528716216216216
2023,1407,17,13,1246,867,0.5666666666666667,379,0.5896829152863228
2023,1408,20,11,1728,750,0.6451612903225806,978,0.6973365617433414
2023,1409,5,25,387,1572,0.16666666666666666,-1185,0.19754977029096477
2023,1410,11,17,949,1158,0.39285714285714285,-209,0.4504034171808258
2023,1411,12,20,867,1307,0.375,-440,0.3988040478380865
2023,1412,24,9,1992,666,0.7272727272727273,1326,0.7494356659142212
2023,1413,16,14,1195,1000,0.5333333333333333,195,0.5444191343963554
2023,1414,21,11,1574,773,0.65625,801,0.6706433745206647
2023,1415,21,12,1556,801,0.6363636363636364,755,0.6601612218922359
2023,1416,18,14,1335,976,0.5625,359,0.5776720034617049
2023,1417,29,5,2193,320,0.8529411764705882,1873,0.8726621567847195
2023,1418,23,7,1785,482,0.7666666666666667,1303,0.7873842082046758
2023,1419,8,21,592,1248,0.27586206896551724,-656,0.3217391304347826
2023,1420,17,14,1356,930,0.5483870967741935,426,0.5931758530183727
2023,1421,25,7,1889,446,0.78125,1443,0.8089935760171306
2023,1422,18,12,1362,731,0.6,631,0.650740563784042
2023,1423,22,10,1566,579,0.6875,987,0.73006993006993
2023,1424,18,13,1330,920,0.5806451612903226,410,0.5911111111111111
2023,1425,22,10,1677,652,0.6875,1025,0.7200515242593388
2023,1426,8,21,559,1264,0.27586206896551724,-705,0.30663741086121776
2023,1427,8,22,633,1444,0.26666666666666666,-811,0.3047664901299952
2023,1428,17,15,1300,897,0.53125,403,0.591715976331361
2023,1429,25,8,2033,532,0.7575757575757576,1501,0.7925925925925926
2023,1430,22,8,1711,557,0.7333333333333333,1154,0.7544091710758377
2023,1431,12,18,866,1140,0.4,-274,0.4317048853439681
2023,1433,27,7,2002,427,0.7941176470588235,1575,0.8242074927953891
2023,1434,10,21,763,1347,0.3225806451612903,-584,0.36161137440758295
2023,1435,20,14,1561,904,0.5882352941176471,657,0.6332657200811359
2023,1436,22,10,1699,610,0.6875,1089,0.7358163707232568
2023,1437,17,16,1214,1095,0.5151515151515151,119,0.5257687310524036
2023,1438,25,7,1752,418,0.78125,1334,0.8073732718894009
2023,1439,19,14,1469,980,0.5757575757575758,489,0.5998366680277665
2023,1440,4,25,319,1587,0.13793103448275862,-1268,0.16736621196222456
2023,1441,15,15,1192,937,0.5,255,0.5598872710192578
2023,1442,13,14,1020,895,0.48148148148148145,125,0.5326370757180157
2023,1443,15,16,1138,1022,0.4838709677419355,116,0.5268518518518519
2023,1444,5,23,442,1470,0.17857142857142858,-1028,0.23117154811715482
2023,1447,13,13,856,739,0.5,117,0.5366771159874608
2023,1448,19,14,1529,999,0.5757575757575758,530,0.6048259493670886
2023,1449,16,16,1175,1038,0.5,137,0.5309534568459106
2023,1450,17,16,1247,1003,0.5151515151515151,244,0.5542222222222222
2023,1451,16,15,1138,916,0.5161290322580645,222,0.5540408958130477
2023,1452,19,14,1557,961,0.5757575757575758,596,0.6183478951548849
2023,1453,3,29,218,1680,0.09375,-1462,0.1148577449947313
2023,1454,18,11,1449,752,0.6206896551724138,697,0.6583371194911404
2023,1455,17,15,1278,994,0.53125,284,0.5625
2023,1456,11,20,780,1233,0.3548387096774194,-453,0.38748137108792846
2023,1457,13,17,1048,1135,0.43333333333333335,-87,0.4800732936326157
2023,1458,17,14,1153,860,0.5483870967741935,293,0.5727769498261301
2023,1459,14,16,1033,1136,0.4666666666666667,-103,0.4762563393268787
2023,1460,16,15,1351,1076,0.5161290322580645,275,0.5566543057272353
2023,1461,8,22,633,1409,0.26666666666666666,-776,0.3099902056807052
2023,1462,25,9,2153,615,0.7352941176470589,1538,0.7778179190751445
2023,1463,19,8,1473,530,0.7037037037037037,943,0.7353969046430354
2023,1464,22,9,1857,651,0.7096774193548387,1206,0.7404306220095693
2023,1465,15,16,1089,982,0.4838709677419355,107,0.5258329309512313
2023,1466,15,14,1179,926,0.5172413793103449,253,0.5600950118764846
2023,1467,16,16,1099,883,0.5,216,0.5544904137235116
2023,1468,12,18,835,1070,0.4,-235,0.43832020997375326
2023,1469,11,19,905,1311,0.36666666666666664,-406,0.4083935018050541
2023,1470,13,16,967,992,0.4482758620689655,-25,0.4936191934660541
2023,1471,8,20,600,1285,0.2857142857142857,-685,0.3183023872679045
2023,1472,17,14,1304,941,0.5483870967741935,363,0.5808463251670378
2023,1473,8,21,666,1295,0.27586206896551724,-629,0.33962264150943394
2023,1474,15,15,1189,1080,0.5,109,0.5240193918025562
2023,1475,13,16,1045,1154,0.4482758620689655,-109,0.4752160072760346
2023,1476,13,17,920,1064,0.43333333333333335,-144,0.4637096774193548
2023,1477,12,20,864,1397,0.375,-533,0.38213180008845643
2023,3101,12,15,876,1010,0.4444444444444444,-134,0.46447507953340406
2023,3102,11,18,805,1030,0.3793103448275862,-225,0.43869209809264303
2023,3103,15,13,1071,805,0.5357142857142857,266,0.5708955223880597
2023,3104,20,10,1472,624,0.6666666666666666,848,0.7022900763358778
2023,3105,14,15,877,770,0.4827586206896552,107,0.5324833029751063
2023,3106,15,15,1063,818,0.5,245,0.5651249335459861
2023,3107,22,11,1386,542,0.6666666666666666,844,0.7188796680497925
2023,3108,10,17,662,1009,0.37037037037037035,-347,0.3961699581089168
2023,3110,9,22,591,1214,0.2903225806451613,-623,0.32742382271468146
2023,3111,9,20,679,1228,0.3103448275862069,-549,0.35605663345568955
2023,3112,21,9,1673,558,0.7,1115,0.7498879426266248
2023,3113,8,20,600,1229,0.2857142857142857,-629,0.3280481137233461
2023,3114,21,10,1198,444,0.6774193548387096,754,0.7295980511571255
2023,3115,13,17,942,973,0.43333333333333335,-31,0.4919060052219321
2023,3116,21,12,1635,773,0.6363636363636364,862,0.6789867109634552
2023,3117,12,19,955,1172,0.3870967741935484,-217,0.44898918664786086
2023,3119,12,17,792,958,0.41379310344827586,-166,0.45257142857142857
2023,3120,15,14,1164,773,0.5172413793103449,391,0.6009292720702116
2023,3122,16,12,1045,599,0.5714285714285714,446,0.6356447688564477
2023,3123,24,8,1900,556,0.75,1344,0.7736156351791531
2023,3124,19,12,1442,790,0.6129032258064516,652,0.6460573476702509
2023,3125,23,11,1748,672,0.6764705882352942,1076,0.7223140495867768
2023,3126,11,18,745,1015,0.3793103448275862,-270,0.42329545454545453
2023,3127,11,17,762,936,0.39285714285714285,-174,0.44876325088339225
2023,3129,15,16,1026,932,0.4838709677419355,94,0.5240040858018387
2023,3130,16,17,1185,990,0.48484848484848486,195,0.5448275862068965
2023,3131,24,8,1736,470,0.75,1266,0.7869446962828649
2023,3132,26,6,2069,395,0.8125,1674,0.8396915584415584
2023,3133,3,28,210,1549,0.0967741935483871,-1339,0.11938601478112564
2023,3135,10,15,697,851,0.4,-154,0.4502583979328165
2023,3136,7,21,479,1150,0.25,-671,0.29404542664211175
2023,3137,13,17,808,900,0.43333333333333335,-92,0.47306791569086654
2023,3138,12,15,850,905,0.4444444444444444,-55,0.4843304843304843
2023,3139,11,19,764,1068,0.36666666666666664,-304,0.4170305676855895
2023,3140,15,16,1036,928,0.4838709677419355,108,0.5274949083503055
2023,3141,6,23,449,1424,0.20689655172413793,-975,0.2397223705285638
2023,3142,9,18,507,959,0.3333333333333333,-452,0.34583901773533426
2023,3143,13,17,993,1049,0.43333333333333335,-56,0.4862879529872674
2023,3144,14,15,843,777,0.4827586206896552,66,0.5203703703703704
2023,3145,9,21,638,1161,0.3,-523,0.3546414674819344
2023,3146,6,18,371,833,0.25,-462,0.3081395348837209
2023,3148,7,22,478,1169,0.2413793103448276,-691,0.29022465088038857
2023,3149,4,25,255,1265,0.13793103448275862,-1010,0.16776315789473684
2023,3150,12,19,849,1072,0.3870967741935484,-223,0.44195731389901094
2023,3151,18,12,1161,620,0.6,541,0.6518809657495789
2023,3152,4,21,287,1168,0.16,-881,0.1972508591065292
2023,3153,9,21,654,1140,0.3,-486,0.36454849498327757
2023,3155,17,15,1255,882,0.53125,373,0.5872718764623304
2023,3156,30,4,2296,237,0.8823529411764706,2059,0.9064350572443742
2023,3157,12,16,897,1016,0.42857142857142855,-119,0.46889702038682696
2023,3158,9,18,642,1098,0.3333333333333333,-456,0.3689655172413793
2023,3159,15,14,955,711,0.5172413793103449,244,0.5732292917166867
2023,3160,23,8,1683,450,0.7419354838709677,1233,0.7890295358649789
2023,3161,18,11,1342,727,0.6206896551724138,615,0.6486225229579508
2023,3162,23,5,1883,327,0.8214285714285714,1556,0.8520361990950226
2023,3163,29,5,2244,331,0.8529411764705882,1913,0.8714563106796116
2023,3164,8,22,480,1177,0.26666666666666666,-697,0.28968014484007243
2023,3165,9,17,578,911,0.34615384615384615,-333,0.38817998656816655
2023,3166,22,8,1638,496,0.7333333333333333,1142,0.767572633552015
2023,3167,8,23,458,1147,0.25806451612903225,-689,0.2853582554517134
2023,3168,14,16,967,871,0.4666666666666667,96,0.5261153427638737
2023,3169,7,24,478,1335,0.22580645161290322,-857,0.26365140650854935
2023,3170,25,7,1760,456,0.78125,1304,0.7942238267148014
2023,3171,2,26,139,1365,0.07142857142857142,-1226,0.09242021276595745
2023,3172,14,16,979,891,0.4666666666666667,88,0.5235294117647059
2023,3173,6,21,420,1312,0.2222222222222222,-892,0.24249422632794457
2023,3174,16,14,1153,826,0.5333333333333333,327,0.5826174835775644
2023,3175,5,19,299,818,0.20833333333333334,-519,0.26768128916741274
2023,3176,11,18,769,1095,0.3793103448275862,-326,0.4125536480686695
2023,3177,16,17,1338,1190,0.48484848484848486,148,0.5292721518987342
2023,3178,4,25,252,1340,0.13793103448275862,-1088,0.15829145728643215
2023,3179,22,9,1837,615,0.7096774193548387,1222,0.7491843393148451
2023,3180,21,9,1469,546,0.7,923,0.7290322580645161
2023,3181,25,6,1671,286,0.8064516129032258,1385,0.8538579458354625
2023,3182,18,12,1329,696,0.6,633,0.6562962962962963
2023,3183,20,8,1433,476,0.7142857142857143,957,0.750654793085385
2023,3184,15,14,1208,935,0.5172413793103449,273,0.5636957536164255
2023,3185,14,15,948,885,0.4827586206896552,63,0.5171849427168577
2023,3186,17,11,1201,709,0.6071428571428571,492,0.6287958115183246
2023,3187,23,9,1561,466,0.71875,1095,0.7701036013813517
2023,3188,9,22,657,1326,0.2903225806451613,-669,0.3313161875945537
2023,3189,9,21,580,1162,0.3,-582,0.33295063145809417
2023,3190,21,9,1382,464,0.7,918,0.7486457204767064
2023,3191,11,19,813,1071,0.36666666666666664,-258,0.4315286624203822
2023,3192,24,7,1630,400,0.7741935483870968,1230,0.8029556650246306
2023,3193,15,15,976,821,0.5,155,0.5431274346132443
2023,3194,10,18,711,1079,0.35714285714285715,-368,0.3972067039106145
2023,3195,30,3,2356,195,0.9090909090909091,2161,0.9235593884751078
2023,3196,16,14,1167,905,0.5333333333333333,262,0.5632239382239382
2023,3197,5,23,326,1309,0.17857142857142858,-983,0.19938837920489297
2023,3198,11,18,821,1154,0.3793103448275862,-333,0.4156962025316456
2023,3199,23,9,1949,614,0.71875,1335,0.7604369879047991
2023,3200,17,12,1278,806,0.5862068965517241,472,0.6132437619961613
2023,3201,8,22,480,1268,0.26666666666666666,-788,0.2745995423340961
2023,3202,8,19,537,1080,0.2962962962962963,-543,0.3320964749536178
2023,3203,17,13,1143,766,0.5666666666666667,377,0.5987427972760607
2023,3204,17,8,1345,579,0.68,766,0.6990644490644491
2023,3205,29,4,2274,266,0.8787878787878788,2008,0.8952755905511811
2023,3206,16,15,1054,822,0.5161290322580645,232,0.5618336886993603
2023,3207,13,17,863,893,0.43333333333333335,-30,0.49145785876993164
2023,3208,21,11,1473,675,0.65625,798,0.6857541899441341
2023,3209,10,21,659,1170,0.3225806451612903,-511,0.36030617823947514
2023,3210,13,17,868,960,0.43333333333333335,-92,0.474835886214442
2023,3211,28,4,2055,261,0.875,1794,0.8873056994818653
2023,3212,10,20,650,1033,0.3333333333333333,-383,0.38621509209744503
2023,3213,19,10,1363,651,0.6551724137931034,712,0.6767626613704072
2023,3214,11,18,714,1031,0.3793103448275862,-317,0.4091690544412607
2023,3217,17,11,1283,668,0.6071428571428571,615,0.6576114812916453
2023,3218,18,14,1155,784,0.5625,371,0.5956678700361011
2023,3219,15,14,1018,859,0.5172413793103449,159,0.5423548215237081
2023,3220,11,20,688,1100,0.3548387096774194,-412,0.38478747203579416
2023,3221,23,8,1461,451,0.7419354838709677,1010,0.7641213389121339
2023,3222,15,16,1013,995,0.4838709677419355,18,0.5044820717131474
2023,3223,8,18,524,921,0.3076923076923077,-397,0.36262975778546713
2023,3224,16,14,1049,748,0.5333333333333333,301,0.5837506956037841
2023,3225,13,17,990,1097,0.43333333333333335,-107,0.47436511739338766
2023,3226,9,19,551,998,0.32142857142857145,-447,0.35571336346029697
2023,3227,18,15,1095,804,0.5454545454545454,291,0.5766192733017378
2023,3228,22,9,1765,589,0.7096774193548387,1176,0.7497875955819882
2023,3229,23,8,1670,482,0.7419354838709677,1188,0.7760223048327137
2023,3230,11,14,710,708,0.44,2,0.5007052186177715
2023,3231,27,3,2206,238,0.9,1968,0.9026186579378068
2023,3232,11,19,779,1155,0.36666666666666664,-376,0.4027921406411582
2023,3233,26,6,1703,327,0.8125,1376,0.8389162561576354
2023,3234,26,6,2326,475,0.8125,1851,0.8304177079614423
2023,3235,22,9,1720,621,0.7096774193548387,1099,0.7347287483981204
2023,3236,13,19,920,1057,0.40625,-137,0.46535154274152757
2023,3237,17,13,1367,782,0.5666666666666667,585,0.636109818520242
2023,3238,21,9,1537,529,0.7,1008,0.7439496611810261
2023,3239,9,17,646,923,0.34615384615384615,-277,0.4117272147864882
2023,3240,14,14,899,800,0.5,99,0.5291347851677457
2023,3241,25,7,1784,435,0.78125,1349,0.8039657503379901
2023,3242,19,11,1483,699,0.6333333333333333,784,0.6796516956920257
2023,3243,17,16,1322,993,0.5151515151515151,329,0.5710583153347732
2023,3244,13,16,919,970,0.4482758620689655,-51,0.486500794070937
2023,3245,19,10,1340,656,0.6551724137931034,684,0.6713426853707415
2023,3246,12,19,925,1176,0.3870967741935484,-251,0.4402665397429795
2023,3247,17,13,1198,703,0.5666666666666667,495,0.6301946344029458
2023,3248,10,19,613,965,0.3448275862068966,-352,0.3884664131812421
2023,3249,17,12,1201,647,0.5862068965517241,554,0.6498917748917749
2023,3250,16,14,1169,921,0.5333333333333333,248,0.5593301435406699
2023,3251,22,8,1636,450,0.7333333333333333,1186,0.7842761265580057
2023,3252,17,12,1213,761,0.5862068965517241,452,0.6144883485309017
2023,3253,22,9,1414,500,0.7096774193548387,914,0.7387669801462905
2023,3254,7,22,486,1157,0.2413793103448276,-671,0.295800365185636
2023,3255,9,21,645,1153,0.3,-508,0.35873192436040047
2023,3256,18,12,1252,697,0.6,555,0.642380708055413
2023,3257,23,11,1775,699,0.6764705882352942,1076,0.7174616006467259
2023,3258,6,23,429,1195,0.20689655172413793,-766,0.2641625615763547
2023,3259,10,21,642,1077,0.3225806451612903,-435,0.37347294938917974
2023,3260,6,24,374,1300,0.2,-926,0.22341696535244923
2023,3261,28,2,2392,131,0.9333333333333333,2261,0.9480776852952834
2023,3262,5,22,320,1118,0.18518518518518517,-798,0.22253129346314326
2023,3263,16,14,1062,730,0.5333333333333333,332,0.5926339285714286
2023,3264,16,17,1036,938,0.48484848484848486,98,0.524822695035461
2023,3265,12,18,782,947,0.4,-165,0.45228455754771546
2023,3266,21,10,1478,537,0.6774193548387096,941,0.7334987593052109
2023,3267,15,14,933,866,0.5172413793103449,67,0.5186214563646471
2023,3268,25,6,2032,417,0.8064516129032258,1615,0.8297264189465088
2023,3269,26,6,1999,433,0.8125,1566,0.8219572368421053
2023,3270,10,19,727,1114,0.3448275862068966,-387,0.3948940793047257
2023,3271,7,20,485,1093,0.25925925925925924,-608,0.3073510773130545
2023,3272,20,10,1427,580,0.6666666666666666,847,0.7110114598903836
2023,3273,11,15,759,920,0.4230769230769231,-161,0.4520547945205479
2023,3274,19,12,1434,759,0.6129032258064516,675,0.6538987688098495
2023,3275,11,19,860,1245,0.36666666666666664,-385,0.4085510688836104
2023,3276,22,9,1694,619,0.7096774193548387,1075,0.7323821876351059
2023,3277,16,14,1361,986,0.5333333333333333,375,0.57988922028121
2023,3278,11,19,919,1223,0.36666666666666664,-304,0.4290382819794584
2023,3279,23,8,1668,479,0.7419354838709677,1189,0.7768979972054029
2023,3280,20,10,1559,587,0.6666666666666666,972,0.7264678471575023
2023,3281,17,13,1212,747,0.5666666666666667,465,0.6186830015313936
2023,3282,7,23,497,1365,0.23333333333333334,-868,0.2669172932330827
2023,3283,20,11,1438,677,0.6451612903225806,761,0.6799054373522458
2023,3284,17,15,1163,874,0.53125,289,0.5709376534118802
2023,3285,12,16,942,1008,0.42857142857142855,-66,0.48307692307692307
2023,3286,19,11,1371,679,0.6333333333333333,692,0.6687804878048781
2023,3287,9,20,610,1019,0.3103448275862069,-409,0.37446286065070594
2023,3288,14,11,928,519,0.56,409,0.6413268832066344
2023,3290,2,27,131,1472,0.06896551724137931,-1341,0.08172177167810356
2023,3291,11,19,723,971,0.36666666666666664,-248,0.4268004722550177
2023,3292,28,4,2107,257,0.875,1850,0.8912859560067682
2023,3293,14,16,999,1038,0.4666666666666667,-39,0.49042709867452133
2023,3294,11,18,775,950,0.3793103448275862,-175,0.4492753623188406
2023,3295,17,11,1313,678,0.6071428571428571,635,0.6594676042189854
2023,3296,16,14,1235,885,0.5333333333333333,350,0.5825471698113207
2023,3297,17,14,1261,854,0.5483870967741935,407,0.5962174940898345
2023,3298,1,29,63,1522,0.03333333333333333,-1459,0.03974763406940063
2023,3299,15,12,1030,712,0.5555555555555556,318,0.5912743972445464
2023,3300,12,16,815,994,0.42857142857142855,-179,0.45052515201768933
2023,3301,20,11,1520,683,0.6451612903225806,837,0.6899682251475261
2023,3303,13,17,939,1001,0.43333333333333335,-62,0.48402061855670103
2023,3304,16,14,1260,885,0.5333333333333333,375,0.5874125874125874
2023,3305,9,21,636,1284,0.3,-648,0.33125
2023,3306,6,21,372,1045,0.2222222222222222,-673,0.26252646436132676
2023,3307,19,12,1503,790,0.6129032258064516,713,0.6554731792411688
2023,3308,14,16,894,940,0.4666666666666667,-46,0.48745910577971646
2023,3309,8,20,558,1163,0.2857142857142857,-605,0.3242300987797792
2023,3310,18,12,1275,712,0.6,563,0.6416708605938601
2023,3311,4,24,288,1327,0.14285714285714285,-1039,0.178328173374613
2023,3312,13,16,810,945,0.4482758620689655,-135,0.46153846153846156
2023,3313,25,6,1565,304,0.8064516129032258,1261,0.8373461744248261
2023,3314,21,10,1533,612,0.6774193548387096,921,0.7146853146853147
2023,3315,16,11,1210,782,0.5925925925925926,428,0.607429718875502
2023,3316,5,20,359,1048,0.2,-689,0.25515280739161333
2023,3317,10,20,691,1179,0.3333333333333333,-488,0.3695187165775401
2023,3318,19,12,1383,661,0.6129032258064516,722,0.6766144814090019
2023,3319,20,13,1552,888,0.6060606060606061,664,0.6360655737704918
2023,3320,22,9,1685,631,0.7096774193548387,1054,0.7275474956822107
2023,3321,9,21,667,1244,0.3,-577,0.34903192046049186
2023,3322,8,18,550,975,0.3076923076923077,-425,0.36065573770491804
2023,3323,25,5,1967,277,0.8333333333333334,1690,0.8765597147950089
2023,3324,12,17,894,977,0.41379310344827586,-83,0.4778193479422769
2023,3325,6,23,430,1390,0.20689655172413793,-960,0.23626373626373626
2023,3326,25,7,2123,461,0.78125,1662,0.8215944272445821
2023,3328,25,6,2218,401,0.8064516129032258,1817,0.8468881252386407
2023,3329,21,11,1688,736,0.65625,952,0.6963696369636964
2023,3330,21,12,1476,689,0.6363636363636364,787,0.6817551963048499
2023,3331,11,19,954,1366,0.36666666666666664,-412,0.41120689655172415
2023,3332,17,14,1360,929,0.5483870967741935,431,0.5941459152468327
2023,3333,13,18,1008,1068,0.41935483870967744,-60,0.48554913294797686
2023,3334,14,17,1033,1089,0.45161290322580644,-56,0.4868049010367578
2023,3335,16,11,1112,579,0.5925925925925926,533,0.657599053814311
2023,3336,14,17,1055,1140,0.45161290322580644,-85,0.4806378132118451
2023,3337,10,19,694,1149,0.3448275862068966,-455,0.37655995659251223
2023,3338,10,20,728,1164,0.3333333333333333,-436,0.38477801268498946
2023,3339,21,8,1509,467,0.7241379310344828,1042,0.763663967611336
2023,3340,13,16,879,850,0.4482758620689655,29,0.5083863504916136
2023,3341,12,15,825,863,0.4444444444444444,-38,0.4887440758293839
2023,3342,11,17,771,963,0.39285714285714285,-192,0.444636678200692
2023,3343,23,5,1549,287,0.8214285714285714,1262,0.843681917211329
2023,3344,13,19,855,1087,0.40625,-232,0.44026776519052524
2023,3345,19,10,1417,633,0.6551724137931034,784,0.6912195121951219
2023,3346,21,9,1374,471,0.7,903,0.7447154471544716
2023,3347,12,17,811,1000,0.41379310344827586,-189,0.44781888459414687
2023,3348,24,6,1694,359,0.8,1335,0.8251339503166099
2023,3349,22,8,1663,506,0.7333333333333333,1157,0.7667127708621485
2023,3350,20,10,1496,573,0.6666666666666666,923,0.7230546157564041
2023,3351,10,21,674,1174,0.3225806451612903,-500,0.3647186147186147
2023,3352,9,19,559,992,0.32142857142857145,-433,0.36041263700838166
2023,3353,12,20,843,1178,0.375,-335,0.41712023750618504
2023,3354,3,27,188,1217,0.1,-1029,0.13380782918149467
2023,3355,28,5,2335,285,0.8484848484848485,2050,0.8912213740458015
2023,3356,12,19,1037,1238,0.3870967741935484,-201,0.45582417582417584
2023,3357,17,13,1158,711,0.5666666666666667,447,0.6195826645264848
2023,3358,11,17,787,1067,0.39285714285714285,-280,0.42448759439050704
2023,3359,10,17,704,990,0.37037037037037035,-286,0.4155844155844156
2023,3360,16,13,1052,741,0.5517241379310345,311,0.5867261572783046
2023,3361,21,10,1410,596,0.6774193548387096,814,0.7028913260219342
2023,3362,17,12,1267,684,0.5862068965517241,583,0.6494105586878524
2023,3363,6,25,408,1383,0.1935483870967742,-975,0.22780569514237856
2023,3364,19,12,1307,726,0.6129032258064516,581,0.6428922774225283
2023,3365,13,17,959,1153,0.43333333333333335,-194,0.4540719696969697
2023,3367,9,20,558,952,0.3103448275862069,-394,0.3695364238410596
2023,3368,19,9,1260,458,0.6785714285714286,802,0.7334109429569267
2023,3369,13,15,923,787,0.4642857142857143,136,0.539766081871345
2023,3370,6,24,403,1389,0.2,-986,0.22488839285714285
2023,3371,18,14,1381,918,0.5625,463,0.6006959547629404
2023,3372,24,6,1850,403,0.8,1447,0.821127385707945
2023,3373,19,13,1370,804,0.59375,566,0.6301747930082797
2023,3374,16,12,1094,676,0.5714285714285714,418,0.6180790960451977
2023,3375,6,23,381,1188,0.20689655172413793,-807,0.24282982791587
2023,3376,32,0,2606,0,1.0,2606,1.0
2023,3377,12,16,877,1011,0.42857142857142855,-134,0.4645127118644068
2023,3378,26,6,1900,373,0.8125,1527,0.8358996920369556
2023,3379,19,10,1309,539,0.6551724137931034,770,0.7083333333333334
2023,3380,16,14,1027,663,0.5333333333333333,364,0.6076923076923076
2023,3381,21,9,1473,558,0.7,915,0.725258493353028
2023,3382,6,26,350,1315,0.1875,-965,0.21021021021021022
2023,3383,10,19,649,993,0.3448275862068966,-344,0.39524969549330086
2023,3384,7,22,433,1075,0.2413793103448276,-642,0.28713527851458887
2023,3385,22,8,1535,429,0.7333333333333333,1106,0.7815682281059063
2023,3386,20,10,1374,626,0.6666666666666666,748,0.687
2023,3387,17,17,1308,1059,0.5,249,0.5525982256020279
2023,3388,13,18,924,1044,0.41935483870967744,-120,0.4695121951219512
2023,3390,28,5,2196,327,0.8484848484848485,1869,0.8703923900118906
2023,3391,11,20,670,1120,0.3548387096774194,-450,0.3743016759776536
2023,3392,18,13,1308,796,0.5806451612903226,512,0.6216730038022814
2023,3393,18,12,1452,759,0.6,693,0.6567164179104478
2023,3394,16,11,1078,580,0.5925925925925926,498,0.6501809408926418
2023,3395,8,23,536,1325,0.25806451612903225,-789,0.28801719505642126
2023,3396,11,18,787,1044,0.3793103448275862,-257,0.4298197706171491
2023,3397,23,11,1853,746,0.6764705882352942,1107,0.7129665255867641
2023,3398,8,18,586,1061,0.3076923076923077,-475,0.35579842137219186
2023,3399,20,9,1474,514,0.6896551724137931,960,0.7414486921529175
2023,3400,25,9,1916,577,0.7352941176470589,1339,0.7685519454472524
2023,3401,9,20,638,1013,0.3103448275862069,-375,0.38643246517262264
2023,3402,20,9,1383,501,0.6896551724137931,882,0.7340764331210191
2023,3403,18,14,1313,906,0.5625,407,0.5917079765660207
2023,3404,13,17,947,980,0.43333333333333335,-33,0.491437467566165
2023,3405,28,4,2113,242,0.875,1871,0.89723991507431
2023,3406,21,11,1485,659,0.65625,826,0.6926305970149254
2023,3407,16,13,1336,1049,0.5517241379310345,287,0.560167714884696
2023,3408,17,13,1262,724,0.5666666666666667,538,0.6354481369587109
2023,3409,17,13,1302,781,0.5666666666666667,521,0.6250600096015363
2023,3410,11,18,764,1049,0.3793103448275862,-285,0.4214009928295643
2023,3411,2,27,149,1601,0.06896551724137931,-1452,0.08514285714285715
2023,3412,12,17,914,1110,0.41379310344827586,-196,0.4515810276679842
2023,3413,14,14,987,759,0.5,228,0.5652920962199313
2023,3414,22,6,1390,322,0.7857142857142857,1068,0.8119158878504673
2023,3415,5,25,298,1237,0.16666666666666666,-939,0.19413680781758957
2023,3416,14,15,957,800,0.4827586206896552,157,0.5446784291405805
2023,3417,25,9,1806,582,0.7352941176470589,1224,0.7562814070351759
2023,3418,13,15,784,797,0.4642857142857143,-13,0.4958886780518659
2023,3419,4,23,292,1380,0.14814814814814814,-1088,0.17464114832535885
2023,3420,13,15,932,831,0.4642857142857143,101,0.5286443562110039
2023,3421,10,19,602,1008,0.3448275862068966,-406,0.3739130434782609
2023,3422,13,14,872,790,0.48148148148148145,82,0.5246690734055355
2023,3423,4,24,264,1214,0.14285714285714285,-950,0.17861975642760486
2023,3424,30,2,2339,130,0.9375,2209,0.947347104090725
2023,3425,21,9,1404,530,0.7,874,0.7259565667011375
2023,3426,13,17,1035,1149,0.43333333333333335,-114,0.4739010989010989
2023,3427,13,19,918,1155,0.40625,-237,0.44283646888567296
2023,3428,25,4,2162,259,0.8620689655172413,1903,0.8930194134655102
2023,3429,3,26,207,1467,0.10344827586206896,-1260,0.12365591397849462
2023,3430,4,24,251,1268,0.14285714285714285,-1017,0.1652402896642528
2023,3431,20,11,1435,695,0.6451612903225806,740,0.6737089201877934
2023,3433,7,22,424,1225,0.2413793103448276,-801,0.25712553062462096
2023,3434,7,23,502,1286,0.23333333333333334,-784,0.2807606263982103
2023,3435,12,19,933,1162,0.3870967741935484,-229,0.445346062052506
2023,3436,24,6,1509,332,0.8,1177,0.8196632265073329
2023,3437,28,6,2060,343,0.8235294117647058,1717,0.8572617561381606
2023,3438,15,15,1147,915,0.5,232,0.5562560620756547
2023,3439,27,4,2016,232,0.8709677419354839,1784,0.896797153024911
2023,3441,6,21,332,1108,0.2222222222222222,-776,0.23055555555555557
2023,3442,8,20,619,1236,0.2857142857142857,-617,0.3336927223719677
2023,3443,19,13,1373,867,0.59375,506,0.6129464285714286
2023,3444,11,17,812,918,0.39285714285714285,-106,0.46936416184971097
2023,3447,13,15,909,859,0.4642857142857143,50,0.5141402714932126
2023,3448,16,16,1057,841,0.5,216,0.5569020021074815
2023,3449,15,14,1033,753,0.5172413793103449,280,0.578387458006719
2023,3450,23,10,1634,582,0.696969696969697,1052,0.7373646209386282
2023,3451,6,25,377,1390,0.1935483870967742,-1013,0.21335597057159025
2023,3452,19,11,1335,648,0.6333333333333333,687,0.6732223903177005
2023,3453,27,5,1883,292,0.84375,1591,0.8657471264367816
2023,3454,11,19,727,1036,0.36666666666666664,-309,0.41236528644356213
2023,3455,18,14,1325,801,0.5625,524,0.6232361241768579
2023,3456,18,13,1326,730,0.5806451612903226,596,0.6449416342412452
2023,3457,7,22,427,1066,0.2413793103448276,-639,0.28600133958472873
2023,3458,11,20,840,1284,0.3548387096774194,-444,0.3954802259887006
2023,3459,19,9,1414,529,0.6785714285714286,885,0.7277406073082862
2023,3460,7,24,567,1451,0.22580645161290322,-884,0.28097125867195244
2023,3461,20,10,1369,586,0.6666666666666666,783,0.7002557544757033
2023,3462,7,23,506,1151,0.23333333333333334,-645,0.30537115268557635
2023,3463,13,14,848,759,0.48148148148148145,89,0.5276913503422527
2023,3464,17,11,1186,649,0.6071428571428571,537,0.6463215258855586
2023,3465,19,13,1465,887,0.59375,578,0.622874149659864
2023,3466,12,15,834,884,0.4444444444444444,-50,0.48544819557625146
2023,3467,14,16,965,859,0.4666666666666667,106,0.5290570175438597
2023,3468,7,22,479,1256,0.2413793103448276,-777,0.2760806916426513
2023,3469,17,12,1352,762,0.5862068965517241,590,0.6395458845789972
2023,3470,6,21,463,1199,0.2222222222222222,-736,0.2785800240673887
2023,3471,13,17,822,956,0.43333333333333335,-134,0.46231721034870643
2023,3472,13,17,913,987,0.43333333333333335,-74,0.4805263157894737
2023,3473,1,24,84,1282,0.04,-1198,0.06149341142020498
2023,3474,5,21,343,1142,0.19230769230769232,-799,0.23097643097643097
2023,3475,9,17,641,981,0.34615384615384615,-340,0.39519112207151663
2023,3476,8,20,532,1125,0.2857142857142857,-593,0.3210621605310803
2023,3477,13,19,952,1116,0.40625,-164,0.46034816247582205
1986,1159,0,22,0,1043,0.0,-1043,0.0
1987,1271,0,24,0,1596,0.0,-1596,0.0
1992,1341,0,26,0,1650,0.0,-1650,0.0
1993,1341,0,23,0,1751,0.0,-1751,0.0
1995,1142,0,26,0,1441,0.0,-1441,0.0
1996,1341,0,23,0,1723,0.0,-1723,0.0
1998,3152,0,21,0,1131,0.0,-1131,0.0
1999,1251,0,20,0,1387,0.0,-1387,0.0
2000,1212,0,28,0,2004,0.0,-2004,0.0
2000,1258,0,26,0,1597,0.0,-1597,0.0
2000,3147,0,28,0,1311,0.0,-1311,0.0
2001,3147,0,19,0,1015,0.0,-1015,0.0
2002,3170,0,27,0,1292,0.0,-1292,0.0
2004,3398,0,25,0,1205,0.0,-1205,0.0
2004,3459,0,28,0,1559,0.0,-1559,0.0
2005,1366,0,28,0,1623,0.0,-1623,0.0
2005,3147,0,25,0,1264,0.0,-1264,0.0
2006,3398,0,27,0,1520,0.0,-1520,0.0
2008,1312,0,29,0,1622,0.0,-1622,0.0
2008,3200,0,29,0,1500,0.0,-1500,0.0
2010,3223,0,24,0,1343,0.0,-1343,0.0
2010,3464,0,30,0,1457,0.0,-1457,0.0
2012,3223,0,27,0,1165,0.0,-1165,0.0
2013,1212,0,28,0,1391,0.0,-1391,0.0
2013,3421,0,28,0,1372,0.0,-1372,0.0
2013,3451,0,29,0,1533,0.0,-1533,0.0
2014,3309,0,29,0,1391,0.0,-1391,0.0
2015,1212,0,27,0,1380,0.0,-1380,0.0
2015,1363,0,28,0,1471,0.0,-1471,0.0
2017,3105,0,25,0,1187,0.0,-1187,0.0
2017,3152,0,29,0,1550,0.0,-1550,0.0
2019,3184,0,27,0,1421,0.0,-1421,0.0
2021,1152,0,9,0,499,0.0,-499,0.0
2021,3145,0,5,0,243,0.0,-243,0.0
2021,3152,0,14,0,685,0.0,-685,0.0
2021,3259,0,13,0,655,0.0,-655,0.0
2021,3374,0,6,0,334,0.0,-334,0.0
2021,3398,0,22,0,1107,0.0,-1107,0.0
2021,3438,0,5,0,258,0.0,-258,0.0
2021,3469,0,2,0,97,0.0,-97,0.0
2022,1175,0,25,0,1515,0.0,-1515,0.0
2022,1249,0,27,0,1644,0.0,-1644,0.0
2022,3175,0,24,0,1122,0.0,-1122,0.0
2022,3287,0,27,0,1398,0.0,-1398,0.0
2023,3216,0,26,0,1170,0.0,-1170,0.0
2023,3389,0,30,0,1507,0.0,-1507,0.0
